安全卫生	an'quan'wei'sheng	0
标准体系	biao'zhun'ti'xi	0
补充保险	bu'chong'bao'xian	0
操作流程	cao'zuo'liu'cheng	0
岗位分类	gang'wei'fen'lei	0
供给分析	gong'ji'fen'xi	0
供给与需求平衡	gong'ji'yu'xu'qiu'ping'heng	0
供求平衡	gong'qiu'ping'heng	0
工资集体协商	gong'zi'ji'ti'xie'shang	0
工资制度	gong'zi'zhi'du	0
工资制度设计	gong'zi'zhi'du'she'ji	0
工资制度调整	gong'zi'zhi'du'tiao'zheng	0
工作岗位分类	gong'zuo'gang'wei'fen'lei	0
构建	gou'jian	0
关键绩效指标	guan'jian'ji'xiao'zhi'biao	0
管理人员	guan'li'ren'yuan	0
国家职业技能鉴定	guo'jia'zhi'ye'ji'neng'jian'ding	0
国家职业资格	guo'jia'zhi'ye'zi'ge	0
基本程序	ji'ben'cheng'xu	0
技术路线	ji'shu'lu'xian	0
技术路线和方法	ji'shu'lu'xian'he'fang'fa	0
集体协商	ji'ti'xie'shang	0
绩效管理	ji'xiao'guan'li	0
绩效考评	ji'xiao'kao'ping	0
绩效考评标准	ji'xiao'kao'ping'biao'zhun	0
绩效考评指标	ji'xiao'kao'ping'zhi'biao	0
教学计划	jiao'xue'ji'hua	0
结构化面试	jie'gou'hua'mian'shi	0
结构预测	jie'gou'yu'ce	0
就业培训	jiu'ye'pei'xun	0
就业培训技术指导中心	jiu'ye'pei'xun'ji'shu'zhi'dao'zhong'xin	0
开发	kai'fa	0
考评方法	kao'ping'fang'fa	0
课程设计	ke'cheng'she'ji	0
宽带式工资结构	kuan'dai'shi'gong'zi'jie'gou	0
劳动安全卫生	lao'dong'an'quan'wei'sheng	0
劳动安全卫生管理	lao'dong'an'quan'wei'sheng'guan'li	0
劳动关系	lao'dong'guan'xi	0
劳动关系管理	lao'dong'guan'xi'guan'li	0
劳动者派遣	lao'dong'zhe'pai'qian	0
劳动者派遣管理	lao'dong'zhe'pai'qian'guan'li	0
劳动争议	lao'dong'zheng'yi	0
劳动争议处理	lao'dong'zheng'yi'chu'li	0
面试	mian'shi	0
培训	pei'xun	0
培训规划	pei'xun'gui'hua	0
培训课程	pei'xun'ke'cheng	0
培训评估	pei'xun'ping'gu	0
培训评估系统	pei'xun'ping'gu'xi'tong	0
培训设计	pei'xun'she'ji	0
培训效果	pei'xun'xiao'guo	0
培训资源	pei'xun'zi'yuan	0
配置	pei'zhi	0
评估	ping'gu	0
评估标准	ping'gu'biao'zhun	0
评估评估报告	ping'gu'ping'gu'bao'gao	0
评估系统	ping'gu'xi'tong	0
企业补充保险	qi'ye'bu'chong'bao'xian	0
企业劳动争议处理	qi'ye'lao'dong'zheng'yi'chu'li	0
群体决策法	qun'ti'jue'ce'fa	0
人力资源	ren'li'zi'yuan	0
人力资源供给	ren'li'zi'yuan'gong'ji	0
人力资源供给分析	ren'li'zi'yuan'gong'ji'fen'xi	0
人力资源供给预测	ren'li'zi'yuan'gong'ji'yu'ce	0
人力资源供给与需求平衡	ren'li'zi'yuan'gong'ji'yu'xu'qiu'ping'heng	0
人力资源供求平衡	ren'li'zi'yuan'gong'qiu'ping'heng	0
人力资源管理	ren'li'zi'yuan'guan'li	0
人力资源管理软件	ren'li'zi'yuan'guan'li'ruan'jian	0
人力资源管理师	ren'li'zi'yuan'guan'li'shi	0
人力资源管理员	ren'li'zi'yuan'guan'li'yuan	0
人力资源管理助师	ren'li'zi'yuan'guan'li'zhu'shi	0
人力资源规划	ren'li'zi'yuan'gui'hua	0
题目设计	ti'mu'she'ji	0
体系设计	ti'xi'she'ji	0
无领导小组讨论	wu'ling'dao'xiao'zu'tao'lun	0
薪酬	xin'chou	0
薪酬调查	xin'chou'diao'cha	0
薪酬管理	xin'chou'guan'li	0
薪酬计划	xin'chou'ji'hua	0
薪酬满意度	xin'chou'man'yi'du	0
薪酬满意度调查	xin'chou'man'yi'du'diao'cha	0
薪酬市场调查	xin'chou'shi'chang'diao'cha	0
需求平衡	xu'qiu'ping'heng	0
需求预测	xu'qiu'yu'ce	0
员工培训规划	yuan'gong'pei'xun'gui'hua	0
员工培训效果	yuan'gong'pei'xun'xiao'guo	0
员工素质测评	yuan'gong'su'zhi'ce'ping	0
员工薪酬计划	yuan'gong'xin'chou'ji'hua	0
员工薪酬满意度调查	yuan'gong'xin'chou'man'yi'du'diao'cha	0
招聘	zhao'pin	0
总量预测	zong'liang'yu'ce	0
组织结构	zu'zhi'jie'gou	0
组织结构变革	zu'zhi'jie'gou'bian'ge	0
组织结构设计	zu'zhi'jie'gou'she'ji	0
