爱和谊	ai'he'yi	0
爱和谊保险公司	ai'he'yi'bao'xian'gong'si	0
爱和谊财险	ai'he'yi'cai'xian	0
安邦	an'bang	0
安邦财产保险股份有限公司	an'bang'cai'chan'bao'xian'gu'fen'you'xian'gong'si	0
安诚	an'cheng	0
安诚财产保险股份有限公司	an'cheng'cai'chan'bao'xian'gu'fen'you'xian'gong'si	0
安华农业	an'hua'nong'ye	0
安华农业保险	an'hua'nong'ye'bao'xian	0
安华农业保险股份有限公司	an'hua'nong'ye'bao'xian'gu'fen'you'xian'gong'si	0
案均赔款	an'jun'pei'kuan	0
安联	an'lian	0
安联保险	an'lian'bao'xian	0
安联保险公司	an'lian'bao'xian'gong'si	0
安盟	an'meng	0
安全驾驶	an'quan'jia'shi	0
安全预防措施	an'quan'yu'fang'cuo'shi	0
安信农业保险股份有限公司	an'xin'nong'ye'bao'xian'gu'fen'you'xian'gong'si	0
半导体制造企业	ban'dao'ti'zhi'zao'qi'ye	0
办公室	ban'gong'shi	0
邦诚人寿	bang'cheng'ren'shou	0
保安服务	bao'an'fu'wu	0
报案号	bao'an'hao	0
保单	bao'dan	0
保单保费	bao'dan'bao'fei	0
保单复印件	bao'dan'fu'yin'jian	0
保单号	bao'dan'hao	0
保费	bao'fei	0
保费变化	bao'fei'bian'hua	0
保费清单	bao'fei'qing'dan	0
保费收入	bao'fei'shou'ru	0
保监会	bao'jian'hui	0
保监局	bao'jian'ju	0
保洁服务	bao'jie'fu'wu	0
保卡	bao'ka	0
保温	bao'wen	0
保险标的	bao'xian'biao'di	0
保险代理机构变更事项申请表	bao'xian'dai'li'ji'gou'bian'geng'shi'xiang'shen'qing'biao	0
保险代理机构管理规定	bao'xian'dai'li'ji'gou'guan'li'gui'ding	0
保险代理机构设立申请表	bao'xian'dai'li'ji'gou'she'li'shen'qing'biao	0
保险代理机构设立申请委托书	bao'xian'dai'li'ji'gou'she'li'shen'qing'wei'tuo'shu	0
保险代理人	bao'xian'dai'li'ren	0
保险代理手续费	bao'xian'dai'li'shou'xu'fei	0
保险单	bao'xian'dan	0
保险费	bao'xian'fei	0
保险公司	bao'xian'gong'si	0
保险行业协会	bao'xian'hang'ye'xie'hui	0
保险合同	bao'xian'he'tong	0
保险价值	bao'xian'jia'zhi	0
保险监督管理机构	bao'xian'jian'du'guan'li'ji'gou	0
保险金	bao'xian'jin	0
保险金额	bao'xian'jin'e	0
保险经纪机构变更事项申请表	bao'xian'jing'ji'ji'gou'bian'geng'shi'xiang'shen'qing'biao	0
保险经纪机构管理规定	bao'xian'jing'ji'ji'gou'guan'li'gui'ding	0
保险经纪机构设立申请表	bao'xian'jing'ji'ji'gou'she'li'shen'qing'biao	0
保险经纪机构设立申请委托书	bao'xian'jing'ji'ji'gou'she'li'shen'qing'wei'tuo'shu	0
保险经纪人	bao'xian'jing'ji'ren	0
保险利益	bao'xian'li'yi	0
保险凭证	bao'xian'ping'zheng	0
保险期间	bao'xian'qi'jian	0
保险期限	bao'xian'qi'xian	0
保险人	bao'xian'ren	0
保险市场	bao'xian'shi'chang	0
保险许可证管理办法	bao'xian'xu'ke'zheng'guan'li'ban'fa	0
保险业	bao'xian'ye	0
保险营销员管理规定	bao'xian'ying'xiao'yuan'guan'li'gui'ding	0
保险责任	bao'xian'ze'ren	0
保险中介机构	bao'xian'zhong'jie'ji'gou	0
报销	bao'xiao	0
保证保险	bao'zheng'bao'xian	0
被保险机动车行驶证	bei'bao'xian'ji'dong'che'xing'shi'zheng	0
被保险人	bei'bao'xian'ren	0
被保险人名称	bei'bao'xian'ren'ming'cheng	0
被动保护设施	bei'dong'bao'hu'she'shi	0
本年累计	ben'nian'lei'ji	0
泵车	beng'che	0
比例赔付	bi'li'pei'fu	0
变相打折	bian'xiang'da'zhe	0
变相优惠	bian'xiang'you'hui	0
标的	biao'di	0
标的物	biao'di'wu	0
标识	biao'zhi	0
殡葬服务	bin'zang'fu'wu	0
渤海	bo'hai	0
渤海财产保险股份有限公司	bo'hai'cai'chan'bao'xian'gu'fen'you'xian'gong'si	0
博物馆纪念馆	bo'wu'guan'ji'nian'guan	0
补偿原则	bu'chang'yuan'ze	0
补打	bu'da	0
不计免	bu'ji'mian	0
不计免赔	bu'ji'mian'pei	0
不计免赔险	bu'ji'mian'pei'xian	0
财产保险	cai'chan'bao'xian	0
财产保险合同	cai'chan'bao'xian'he'tong	0
财产保险危险单位	cai'chan'bao'xian'wei'xian'dan'wei	0
财产保险危险单位划分	cai'chan'bao'xian'wei'xian'dan'wei'hua'fen	0
财产损失保险	cai'chan'sun'shi'bao'xian	0
财产损失赔偿限额	cai'chan'sun'shi'pei'chang'xian'e	0
财产险	cai'chan'xian	0
财产综合险	cai'chan'zong'he'xian	0
彩色滤光片制造	cai'se'lv'guang'pian'zhi'zao	0
财务结清	cai'wu'jie'qing	0
财务联	cai'wu'lian	0
财险业竞争情报	cai'xian'ye'jing'zheng'qing'bao	0
餐饮业	can'yin'ye	0
仓栅式低速货车	cang'shan'shi'di'su'huo'che	0
侧三轮摩托车	ce'san'lun'mo'tuo'che	0
查勘	cha'kan	0
查勘定损	cha'kan'ding'sun	0
产品责任险	chan'pin'ze'ren'xian	0
长城人寿	chang'cheng'ren'shou	0
长城人寿保险股份有限公司	chang'cheng'ren'shou'bao'xian'gu'fen'you'xian'gong'si	0
长江养老保险股份有限公司	chang'jiang'yang'lao'bao'xian'gu'fen'you'xian'gong'si	0
厂牌车型	chang'pai'che'xing	0
长尾夹	chang'wei'jia	0
超限	chao'xian	0
超限超载	chao'xian'chao'zai	0
超载	chao'zai	0
车本	che'ben	0
车船税	che'chuan'shui	0
车队	che'dui	0
车架号	che'jia'hao	0
车均保费	che'jun'bao'fei	0
车辆类型	che'liang'lei'xing	0
车辆种类	che'liang'zhong'lei	0
车牌号	che'pai'hao	0
车牌号码	che'pai'hao'ma	0
车损附加险	che'sun'fu'jia'xian	0
车损险	che'sun'xian	0
车险	che'xian	0
车险业绩分析	che'xian'ye'ji'fen'xi	0
呈报	cheng'bao	0
承保	cheng'bao	0
承保笔数	cheng'bao'bi'shu	0
呈报表	cheng'bao'biao	0
承保车辆数	cheng'bao'che'liang'shu	0
呈报单	cheng'bao'dan	0
承保公司	cheng'bao'gong'si	0
承保公司代码	cheng'bao'gong'si'dai'ma	0
承保理赔	cheng'bao'li'pei	0
承保流程	cheng'bao'liu'cheng	0
承保年度制	cheng'bao'nian'du'zhi	0
承保清单	cheng'bao'qing'dan	0
承保数量	cheng'bao'shu'liang	0
承保意见	cheng'bao'yi'jian	0
承保章	cheng'bao'zhang	0
承保政策	cheng'bao'zheng'ce	0
城市环卫管理	cheng'shi'huan'wei'guan'li	0
承运人责任险	cheng'yun'ren'ze'ren'xian	0
初次登记日期	chu'ci'deng'ji'ri'qi	0
出单	chu'dan	0
出单员	chu'dan'yuan	0
初核	chu'he	0
出口信用	chu'kou'xin'yong	0
出险	chu'xian	0
出险次数	chu'xian'ci'shu	0
出险频度	chu'xian'pin'du	0
出险时间	chu'xian'shi'jian	0
出租企业	chu'zu'qi'ye	0
船舶保险	chuan'bo'bao'xian	0
大案	da'an	0
大地财产	da'di'cai'chan	0
大地财产保险公司	da'di'cai'chan'bao'xian'gong'si	0
大型轿车	da'xing'jiao'che	0
大型铰接客车	da'xing'jiao'jie'ke'che	0
大型警车	da'xing'jing'che	0
大型轮式拖拉机	da'xing'lun'shi'tuo'la'ji	0
大型普通客车	da'xing'pu'tong'ke'che	0
大型汽车号牌	da'xing'qi'che'hao'pai	0
大型企业	da'xing'qi'ye	0
大型双层客车	da'xing'shuang'ceng'ke'che	0
大型卧铺客车	da'xing'wo'pu'ke'che	0
大型越野客车	da'xing'yue'ye'ke'che	0
大型专项作业车	da'xing'zhuan'xiang'zuo'ye'che	0
大型专用客车	da'xing'zhuan'yong'ke'che	0
大众保险	da'zhong'bao'xian	0
大众保险股份有限公司	da'zhong'bao'xian'gu'fen'you'xian'gong'si	0
代理机构	dai'li'ji'gou	0
代理渠道	dai'li'qu'dao	0
代理人	dai'li'ren	0
代理业务	dai'li'ye'wu	0
代位请求赔偿的权利	dai'wei'qing'qiu'pei'chang'de'quan'li	0
代位求偿权	dai'wei'qiu'chang'quan	0
代位追偿	dai'wei'zhui'chang	0
单车保费	dan'che'bao'fei	0
蛋蛋车	dan'dan'che	0
单证	dan'zheng	0
单证管理	dan'zheng'guan'li	0
单证号	dan'zheng'hao	0
单证使用	dan'zheng'shi'yong	0
单证装订	dan'zheng'zhuang'ding	0
档案袋	dang'an'dai	0
档案盒	dang'an'he	0
档案夹	dang'an'jia	0
档案室	dang'an'shi	0
当期净保费	dang'qi'jing'bao'fei	0
当期已决赔款	dang'qi'yi'jue'pei'kuan	0
盗抢险	dao'qiang'xian	0
岛式	dao'shi	0
德康人寿	de'kang'ren'shou	0
第三方责任	di'san'fang'ze'ren	0
第三者	di'san'zhe	0
低速普通货车	di'su'pu'tong'huo'che	0
低速厢式货车	di'su'xiang'shi'huo'che	0
低速载货汽车	di'su'zai'huo'qi'che	0
低速自卸货车	di'su'zi'xie'huo'che	0
第一受益人	di'yi'shou'yi'ren	0
电动车	dian'dong'che	0
垫付	dian'fu	0
电器修理	dian'qi'xiu'li	0
电信业	dian'xin'ye	0
电压变化	dian'ya'bian'hua	0
鼎和财险	ding'he'cai'xian	0
定损	ding'sun	0
东方人寿保险股份有限公司	dong'fang'ren'shou'bao'xian'gu'fen'you'xian'gong'si	0
东京海上	dong'jing'hai'shang	0
东京海上火灾保险株式会社	dong'jing'hai'shang'huo'zai'bao'xian'zhu'shi'hui'she	0
东京海上日动	dong'jing'hai'shang'ri'dong	0
董事长	dong'shi'zhang	0
都邦	du'bang	0
都邦财产保险股份有限公司	du'bang'cai'chan'bao'xian'gu'fen'you'xian'gong'si	0
短期费率	duan'qi'fei'lv	0
短期健康保险	duan'qi'jian'kang'bao'xian	0
短期健康险	duan'qi'jian'kang'xian	0
墩式	dun'shi	0
二吨以下货车	er'dun'yi'xia'huo'che	0
二吨至十吨以下货车	er'dun'zhi'shi'dun'yi'xia'huo'che	0
二类单证	er'lei'dan'zheng	0
二十及二十座以上客车	er'shi'ji'er'shi'zuo'yi'shang'ke'che	0
发电机锅炉	fa'dian'ji'guo'lu	0
发动机号	fa'dong'ji'hao	0
法规	fa'gui	0
法国安盟保险公司	fa'guo'an'meng'bao'xian'gong'si	0
法律	fa'lv	0
法律服务	fa'lv'fu'wu	0
发票	fa'piao	0
发票联	fa'piao'lian	0
法人	fa'ren	0
法人代表	fa'ren'dai'biao	0
法院	fa'yuan	0
反洗钱	fan'xi'qian	0
反洗钱法	fan'xi'qian'fa	0
房地产业	fang'di'chan'ye	0
防护措施失效评估	fang'hu'cuo'shi'shi'xiao'ping'gu	0
防火窗	fang'huo'chuang	0
防火间距	fang'huo'jian'ju	0
防火卷帘	fang'huo'juan'lian	0
防火闸门	fang'huo'zha'men	0
非车险	fei'che'xian	0
非法人	fei'fa'ren	0
非机动车	fei'ji'dong'che	0
费率	fei'lv	0
费率浮动办法	fei'lv'fu'dong'ban'fa	0
费率系数	fei'lv'xi'shu	0
非水险	fei'shui'xian	0
非营业	fei'ying'ye	0
非营业货车	fei'ying'ye'huo'che	0
非营业机动车险版	fei'ying'ye'ji'dong'che'xian'ban	0
非营业机关	fei'ying'ye'ji'guan	0
非营业机关团体	fei'ying'ye'ji'guan'tuan'ti	0
非营业客车	fei'ying'ye'ke'che	0
非营业企业	fei'ying'ye'qi'ye	0
非营运	fei'ying'yun	0
分出保险	fen'chu'bao'xian	0
分入保险	fen'ru'bao'xian	0
分支机构	fen'zhi'ji'gou	0
风暴潮	feng'bao'chao	0
封皮	feng'pi	0
丰泰	feng'tai	0
丰泰保险有限公司	feng'tai'bao'xian'you'xian'gong'si	0
丰泰上海	feng'tai'shang'hai	0
风险	feng'xian	0
风险管理	feng'xian'guan'li	0
浮动办法	fu'dong'ban'fa	0
附加划痕险	fu'jia'hua'hen'xian	0
副驾驶员	fu'jia'shi'yuan	0
附加险	fu'jia'xian	0
妇幼保健活动	fu'you'bao'jian'huo'dong	0
副总经理	fu'zong'jing'li	0
港口工程	gang'kou'gong'cheng	0
高保额	gao'bao'e	0
高层建筑	gao'ceng'jian'zhu	0
高等教育	gao'deng'jiao'yu	0
高风险	gao'feng'xian	0
个人保险代理人	ge'ren'bao'xian'dai'li'ren	0
个人代理	ge'ren'dai'li	0
个人代理业务	ge'ren'dai'li'ye'wu	0
公安警车号牌	gong'an'jing'che'hao'pai	0
公安局消防局	gong'an'ju'xiao'fang'ju	0
公安民用号牌	gong'an'min'yong'hao'pai	0
共保	gong'bao	0
公车私户	gong'che'si'hu	0
工程保险	gong'cheng'bao'xian	0
公共管理和社会组织	gong'gong'guan'li'he'she'hui'zu'zhi	0
公共设施管理	gong'gong'she'shi'guan'li	0
公函	gong'han	0
工会	gong'hui	0
公交企业	gong'jiao'qi'ye	0
公司法	gong'si'fa	0
公章	gong'zhang	0
公众责任险	gong'zhong'ze'ren'xian	0
购车发票	gou'che'fa'piao	0
固定仪器	gu'ding'yi'qi	0
股东	gu'dong	0
股份有限公司	gu'fen'you'xian'gong'si	0
雇主责任险	gu'zhu'ze'ren'xian	0
挂车	gua'che	0
挂车号牌	gua'che'hao'pai	0
关键风险	guan'jian'feng'xian	0
罐式低速货车	guan'shi'di'su'huo'che	0
广播电视传输服务	guang'bo'dian'shi'chuan'shu'fu'wu	0
广播电视影像制作	guang'bo'dian'shi'ying'xiang'zhi'zuo	0
光大永明人寿保险有限公司	guang'da'yong'ming'ren'shou'bao'xian'you'xian'gong'si	0
广电日生人寿保险有限公司	guang'dian'ri'sheng'ren'shou'bao'xian'you'xian'gong'si	0
广告业	guang'gao'ye	0
国产玻璃	guo'chan'bo'li	0
国产车	guo'chan'che	0
过户	guo'hu	0
国际组织	guo'ji'zu'zhi	0
国家基本医疗保险标准	guo'jia'ji'ben'yi'liao'bao'xian'biao'zhun	0
国家及政府机关	guo'jia'ji'zheng'fu'ji'guan	0
国民经济行业分类	guo'min'jing'ji'hang'ye'fen'lei	0
国瑞人寿	guo'rui'ren'shou	0
国寿财	guo'shou'cai	0
国寿财产	guo'shou'cai'chan	0
国泰财险	guo'tai'cai'xian	0
国务院保险监督管理机构	guo'wu'yuan'bao'xian'jian'du'guan'li'ji'gou	0
国有独资公司	guo'you'du'zi'gong'si	0
国元农业	guo'yuan'nong'ye	0
海尔纽约人寿保险有限公司	hai'er'niu'yue'ren'shou'bao'xian'you'xian'gong'si	0
海康人寿保险有限公司	hai'kang'ren'shou'bao'xian'you'xian'gong'si	0
海上保险	hai'shang'bao'xian	0
海商法	hai'shang'fa	0
韩国三星火灾海上保险有限公司	han'guo'san'xing'huo'zai'hai'shang'bao'xian'you'xian'gong'si	0
函件	han'jian	0
行业协会	hang'ye'xie'hui	0
号牌号码	hao'pai'hao'ma	0
号牌种类	hao'pai'zhong'lei	0
号牌种类代码	hao'pai'zhong'lei'dai'ma	0
核保	he'bao	0
核保人	he'bao'ren	0
合伙企业	he'huo'qi'ye	0
核赔	he'pei	0
合同	he'tong	0
合同分保	he'tong'fen'bao	0
合众人寿保险股份有限公司	he'zhong'ren'shou'bao'xian'gu'fen'you'xian'gong'si	0
合资	he'zi	0
合作维修厂	he'zuo'wei'xiu'chang	0
恒安标准人寿保险有限公司	heng'an'biao'zhun'ren'shou'bao'xian'you'xian'gong'si	0
恒康天安	heng'kang'tian'an	0
恒康天安人寿保险有限公司	heng'kang'tian'an'ren'shou'bao'xian'you'xian'gong'si	0
恒泰人寿	heng'tai'ren'shou	0
红头文件	hong'tou'wen'jian	0
红章	hong'zhang	0
互联网服务	hu'lian'wang'fu'wu	0
互碰赔偿处理规则	hu'peng'pei'chang'chu'li'gui'ze	0
华安财产	hua'an'cai'chan	0
华安财产保险股份有限公司	hua'an'cai'chan'bao'xian'gu'fen'you'xian'gong'si	0
划痕险	hua'hen'xian	0
华农	hua'nong	0
华泰财产	hua'tai'cai'chan	0
华泰财产保险公司	hua'tai'cai'chan'bao'xian'gong'si	0
华泰财产保险股份有限公司	hua'tai'cai'chan'bao'xian'gu'fen'you'xian'gong'si	0
华泰资产管理有限公司	hua'tai'zi'chan'guan'li'you'xian'gong'si	0
华夏人寿保险股份有限公司	hua'xia'ren'shou'bao'xian'gu'fen'you'xian'gong'si	0
化学机械研磨	hua'xue'ji'xie'yan'mo	0
化学品供应及储存	hua'xue'pin'gong'ying'ji'chu'cun	0
化学气相沉积	hua'xue'qi'xiang'chen'ji	0
环境管理业	huan'jing'guan'li'ye	0
皇家太阳	huang'jia'tai'yang	0
皇家太阳联合保险公司	huang'jia'tai'yang'lian'he'bao'xian'gong'si	0
汇丰人寿	hui'feng'ren'shou	0
会议室	hui'yi'shi	0
混凝土	hun'ning'tu	0
货币单位	huo'bi'dan'wei	0
活动室	huo'dong'shi	0
或然性	huo'ran'xing	0
货物运输保险	huo'wu'yun'shu'bao'xian	0
货运企业	huo'yun'qi'ye	0
货运险	huo'yun'xian	0
火灾隔断设施	huo'zai'ge'duan'she'shi	0
火灾公众责任险	huo'zai'gong'zhong'ze'ren'xian	0
疾病防控活动	ji'bing'fang'kong'huo'dong	0
计财部	ji'cai'bu	0
机场	ji'chang	0
机动车交通事故责任强制保险	ji'dong'che'jiao'tong'shi'gu'ze'ren'qiang'zhi'bao'xian	0
机动车交通责任强制保险条例	ji'dong'che'jiao'tong'ze'ren'qiang'zhi'bao'xian'tiao'li	0
机动车辆保险	ji'dong'che'liang'bao'xian	0
机动车辆保险条款	ji'dong'che'liang'bao'xian'tiao'kuan	0
给付保险金	ji'fu'bao'xian'jin	0
机构代码	ji'gou'dai'ma	0
机关团体	ji'guan'tuan'ti	0
挤靠力	ji'kao'li	0
技术密集	ji'shu'mi'ji	0
计算机服务	ji'suan'ji'fu'wu	0
集装箱专用运输车	ji'zhuang'xiang'zhuan'yong'yun'shu'che	0
嘉禾人寿保险股份有限公司	jia'he'ren'shou'bao'xian'gu'fen'you'xian'gong'si	0
驾龄	jia'ling	0
驾驶人	jia'shi'ren	0
驾驶员	jia'shi'yuan	0
驾驶证	jia'shi'zheng	0
家庭财产保险	jia'ting'cai'chan'bao'xian	0
家庭自用	jia'ting'zi'yong	0
家庭自用车	jia'ting'zi'yong'che	0
家用机动车险版	jia'yong'ji'dong'che'xian'ban	0
驾员险	jia'yuan'xian	0
驾照	jia'zhao	0
简单赔付率	jian'dan'pei'fu'lv	0
剪刀	jian'dao	0
见费出单	jian'fei'chu'dan	0
间接损失	jian'jie'sun'shi	0
健康保险	jian'kang'bao'xian	0
健康险	jian'kang'xian	0
兼业代理	jian'ye'dai'li	0
兼业代理业务	jian'ye'dai'li'ye'wu	0
建筑安装工程	jian'zhu'an'zhuang'gong'cheng	0
建筑物高度	jian'zhu'wu'gao'du	0
轿车	jiao'che	0
缴费方式	jiao'fei'fang'shi	0
缴费清单	jiao'fei'qing'dan	0
交接线	jiao'jie'xian	0
教练摩托车号牌	jiao'lian'mo'tuo'che'hao'pai	0
教练汽车号牌	jiao'lian'qi'che'hao'pai	0
交强险	jiao'qiang'xian	0
交强险版	jiao'qiang'xian'ban	0
交强险保单	jiao'qiang'xian'bao'dan	0
交强险标识	jiao'qiang'xian'biao'zhi	0
交强险承保实务	jiao'qiang'xian'cheng'bao'shi'wu	0
交强险承保实务规程	jiao'qiang'xian'cheng'bao'shi'wu'gui'cheng	0
交强险责任限额	jiao'qiang'xian'ze'ren'xian'e	0
胶水	jiao'shui	0
交通事故处理程序规定	jiao'tong'shi'gu'chu'li'cheng'xu'gui'ding	0
交通事故人员创伤临床诊疗指南	jiao'tong'shi'gu'ren'yuan'chuang'shang'lin'chuang'zhen'liao'zhi'nan	0
交通运输和邮政业	jiao'tong'yun'shu'he'you'zheng'ye	0
接管期限	jie'guan'qi'xian	0
洁净室	jie'jing'shi	0
接受人	jie'shou'ren	0
截止日期	jie'zhi'ri'qi	0
进口玻璃	jin'kou'bo'li	0
进口车	jin'kou'che	0
金融服务业	jin'rong'fu'wu'ye	0
金融业	jin'rong'ye	0
金盛人寿保险有限公司	jin'sheng'ren'shou'bao'xian'you'xian'gong'si	0
净保费	jing'bao'fei	0
警备摩托车	jing'bei'mo'tuo'che	0
净费率	jing'fei'lv	0
经纪费率	jing'ji'fei'lv	0
经纪机构	jing'ji'ji'gou	0
经纪业务	jing'ji'ye'wu	0
精算	jing'suan	0
精算师	jing'suan'shi	0
境外摩托车号牌	jing'wai'mo'tuo'che'hao'pai	0
境外汽车号牌	jing'wai'qi'che'hao'pai	0
精友	jing'you	0
净折扣	jing'zhe'kou	0
旧车	jiu'che	0
就低不就高	jiu'di'bu'jiu'gao	0
就低原则	jiu'di'yuan'ze	0
就高不就低	jiu'gao'bu'jiu'di	0
就高原则	jiu'gao'yuan'ze	0
居民服务和其他服务业	ju'min'fu'wu'he'qi'ta'fu'wu'ye	0
巨灾风险	ju'zai'feng'xian	0
军队号牌	jun'dui'hao'pai	0
军警	jun'jing	0
可保利益	ke'bao'li'yi	0
客户	ke'hu	0
客户代码	ke'hu'dai'ma	0
科技交流和推广服务	ke'ji'jiao'liu'he'tui'guang'fu'wu	0
科隆再保险有限公司	ke'long'zai'bao'xian'you'xian'gong'si	0
科研技术服务业	ke'yan'ji'shu'fu'wu'ye	0
快餐服务	kuai'can'fu'wu	0
会计年度制	kuai'ji'nian'du'zhi	0
昆仑健康保险股份有限公司	kun'lun'jian'kang'bao'xian'gu'fen'you'xian'gong'si	0
拉杆夹	la'gan'jia	0
冷藏	leng'cang	0
利安人寿	li'an'ren'shou	0
利宝保险有限公司	li'bao'bao'xian'you'xian'gong'si	0
利宝互助	li'bao'hu'zhu	0
历年制	li'nian'zhi	0
历年制赔付率	li'nian'zhi'pei'fu'lv	0
理赔流程	li'pei'liu'cheng	0
理赔实务	li'pei'shi'wu	0
理算	li'suan	0
离子植入	li'zi'zhi'ru	0
联邦上海	lian'bang'shang'hai	0
联合收割机	lian'he'shou'ge'ji	0
联泰大都会人寿保险有限公司	lian'tai'da'du'hui'ren'shou'bao'xian'you'xian'gong'si	0
联系单	lian'xi'dan	0
两次灾害	liang'ci'zai'hai	0
疗养院	liao'yang'yuan	0
临分	lin'fen	0
临时分保	lin'shi'fen'bao	0
临时入境摩托车号牌	lin'shi'ru'jing'mo'tuo'che'hao'pai	0
临时入境汽车号牌	lin'shi'ru'jing'qi'che'hao'pai	0
临时行驶车号牌	lin'shi'xing'shi'che'hao'pai	0
领馆摩托车号牌	ling'guan'mo'tuo'che'hao'pai	0
领馆汽车号牌	ling'guan'qi'che'hao'pai	0
流水号	liu'shui'hao	0
六座以下客车	liu'zuo'yi'xia'ke'che	0
六座至二十座以下客车	liu'zuo'zhi'er'shi'zuo'yi'xia'ke'che	0
陆域	lu'yu	0
轮式平地机械	lun'shi'ping'di'ji'xie	0
轮式挖掘机械	lun'shi'wa'jue'ji'xie	0
轮式装载机械	lun'shi'zhuang'zai'ji'xie	0
律师责任险	lv'shi'ze'ren'xian	0
旅行社	lv'xing'she	0
旅行社责任险	lv'xing'she'ze'ren'xian	0
旅游饭店	lv'you'fan'dian	0
满期保费	man'qi'bao'fei	0
满期出险频度	man'qi'chu'xian'pin'du	0
满期赔付率	man'qi'pei'fu'lv	0
毛保费	mao'bao'fei	0
毛费率	mao'fei'lv	0
毛利率	mao'li'lv	0
美国联邦保险公司上海分公司	mei'guo'lian'bang'bao'xian'gong'si'shang'hai'fen'gong'si	0
美国联邦保险股份有限公司	mei'guo'lian'bang'bao'xian'gu'fen'you'xian'gong'si	0
美国友邦保险有限公司	mei'guo'you'bang'bao'xian'you'xian'gong'si	0
煤矿雇主责任险	mei'kuang'gu'zhu'ze'ren'xian	0
美亚	mei'ya	0
美亚保险公司	mei'ya'bao'xian'gong'si	0
面包车	mian'bao'che	0
灭失	mie'shi	0
民安	min'an	0
民事合同	min'shi'he'tong	0
摩托车	mo'tuo'che	0
摩托车号牌	mo'tuo'che'hao'pai	0
目标客户	mu'biao'ke'hu	0
慕尼黑再保险公司	mu'ni'hei'zai'bao'xian'gong'si	0
内部稽核	nei'bu'ji'he	0
内控	nei'kong	0
内控部	nei'kong'bu	0
内联单	nei'lian'dan	0
逆向选择	ni'xiang'xuan'ze	0
年龄	nian'ling	0
农业保险	nong'ye'bao'xian	0
农业险	nong'ye'xian	0
农业型拖拉机	nong'ye'xing'tuo'la'ji	0
农用车	nong'yong'che	0
农用运输车号牌	nong'yong'yun'shu'che'hao'pai	0
牌照号	pai'zhao'hao	0
赔偿处理	pei'chang'chu'li	0
赔付金额	pei'fu'jin'e	0
赔付率	pei'fu'lv	0
赔付时间	pei'fu'shi'jian	0
赔款支出	pei'kuan'zhi'chu	0
批单	pi'dan	0
批单保费	pi'dan'bao'fei	0
批单号	pi'dan'hao	0
批发和零售业	pi'fa'he'ling'shou'ye	0
批复	pi'fu	0
批改保费	pi'gai'bao'fei	0
批改变化	pi'gai'bian'hua	0
批改原因	pi'gai'yuan'yin	0
批退比例	pi'tui'bi'li	0
偏差率	pian'cha'lv	0
骗赔	pian'pei	0
平安财产	ping'an'cai'chan	0
平安财产保险公司	ping'an'cai'chan'bao'xian'gong'si	0
平安养老保险股份有限公司	ping'an'yang'lao'bao'xian'gu'fen'you'xian'gong'si	0
平均费率	ping'jun'fei'lv	0
普通二轮摩托车	pu'tong'er'lun'mo'tuo'che	0
普通正三轮摩托车	pu'tong'zheng'san'lun'mo'tuo'che	0
起保日期	qi'bao'ri'qi	0
企财险	qi'cai'xian	0
汽车摩托车维护和保养	qi'che'mo'tuo'che'wei'hu'he'bao'yang	0
期初未决赔款	qi'chu'wei'jue'pei'kuan	0
期初未满期保费	qi'chu'wei'man'qi'bao'fei	0
汽罐	qi'guan	0
期末未决赔款	qi'mo'wei'jue'pei'kuan	0
期末未满期保费	qi'mo'wei'man'qi'bao'fei	0
其它	qi'ta	0
其他车辆	qi'ta'che'liang	0
其它车型	qi'ta'che'xing	0
其他服务	qi'ta'fu'wu	0
其他寄递服务	qi'ta'ji'di'fu'wu	0
其他教育	qi'ta'jiao'yu	0
其他金融活动	qi'ta'jin'rong'huo'dong	0
其他居民服务	qi'ta'ju'min'fu'wu	0
其他客运企业	qi'ta'ke'yun'qi'ye	0
其他日用品维修	qi'ta'ri'yong'pin'wei'xiu	0
其他团体组织	qi'ta'tuan'ti'zu'zhi	0
其他卫生活动	qi'ta'wei'sheng'huo'dong	0
其他休闲娱乐	qi'ta'xiu'xian'yu'le	0
其他住宿服务	qi'ta'zhu'su'fu'wu	0
其他专业咨询	qi'ta'zhuan'ye'zi'xun	0
汽修厂	qi'xiu'chang	0
企业财产保险	qi'ye'cai'chan'bao'xian	0
企业法人	qi'ye'fa'ren	0
企业管理服务	qi'ye'guan'li'fu'wu	0
签单保费	qian'dan'bao'fei	0
签单日期	qian'dan'ri'qi	0
轻便二轮摩托车	qing'bian'er'lun'mo'tuo'che	0
轻便摩托车号牌	qing'bian'mo'tuo'che'hao'pai	0
轻便正三轮摩托车	qing'bian'zheng'san'lun'mo'tuo'che	0
轻型半挂牵引车	qing'xing'ban'gua'qian'yin'che	0
轻型封闭货车	qing'xing'feng'bi'huo'che	0
轻型罐式半挂车	qing'xing'guan'shi'ban'gua'che	0
轻型罐式货车	qing'xing'guan'shi'huo'che	0
轻型罐式全挂车	qing'xing'guan'shi'quan'gua'che	0
轻型集装箱车	qing'xing'ji'zhuang'xiang'che	0
轻型旅居全挂车	qing'xing'lv'ju'quan'gua'che	0
轻型平板半挂车	qing'xing'ping'ban'ban'gua'che	0
轻型平板货车	qing'xing'ping'ban'huo'che	0
轻型平板全挂车	qing'xing'ping'ban'quan'gua'che	0
轻型普通半挂车	qing'xing'pu'tong'ban'gua'che	0
轻型普通货车	qing'xing'pu'tong'huo'che	0
轻型普通全挂车	qing'xing'pu'tong'quan'gua'che	0
轻型全挂牵引车	qing'xing'quan'gua'qian'yin'che	0
轻型特殊结构货车	qing'xing'te'shu'jie'gou'huo'che	0
轻型厢式半挂车	qing'xing'xiang'shi'ban'gua'che	0
轻型厢式货车	qing'xing'xiang'shi'huo'che	0
轻型厢式全挂车	qing'xing'xiang'shi'quan'gua'che	0
轻型专项作业车	qing'xing'zhuan'xiang'zuo'ye'che	0
轻型专项作业全挂车	qing'xing'zhuan'xiang'zuo'ye'quan'gua'che	0
轻型自卸半挂车	qing'xing'zi'xie'ban'gua'che	0
轻型自卸货车	qing'xing'zi'xie'huo'che	0
轻型自卸全挂车	qing'xing'zi'xie'quan'gua'che	0
渠道	qu'dao	0
渠道实名制	qu'dao'shi'ming'zhi	0
渠道业务	qu'dao'ye'wu	0
权限	quan'xian	0
裙房	qun'fang	0
群众团体及社会团体	qun'zhong'tuan'ti'ji'she'hui'tuan'ti	0
燃油税	ran'you'shui	0
人保	ren'bao	0
人民政协和民主党派	ren'min'zheng'xie'he'min'zhu'dang'pai	0
人事部	ren'shi'bu	0
人寿保险	ren'shou'bao'xian	0
人为因素风险评估	ren'wei'yin'su'feng'xian'ping'gu	0
日本财产	ri'ben'cai'chan	0
日本财产保险公司大连分公司	ri'ben'cai'chan'bao'xian'gong'si'da'lian'fen'gong'si	0
如实告知义务	ru'shi'gao'zhi'yi'wu	0
软件业	ruan'jian'ye	0
瑞福德健康保险股份有限公司	rui'fu'de'jian'kang'bao'xian'gu'fen'you'xian'gong'si	0
瑞士再保险公司	rui'shi'zai'bao'xian'gong'si	0
瑞泰人寿保险有限公司	rui'tai'ren'shou'bao'xian'you'xian'gong'si	0
三井住友	san'jing'zhu'you	0
三井住友海上火灾保险公司	san'jing'zhu'you'hai'shang'huo'zai'bao'xian'gong'si	0
三类单证	san'lei'dan'zheng	0
三轮摩托车号牌	san'lun'mo'tuo'che'hao'pai	0
三轮农用运输车	san'lun'nong'yong'yun'shu'che	0
三星火灾	san'xing'huo'zai	0
三者险	san'zhe'xian	0
缮制	shan'zhi	0
上海安信	shang'hai'an'xin	0
上户	shang'hu	0
上年同期	shang'nian'tong'qi	0
商务服务	shang'wu'fu'wu	0
商业楼宇	shang'ye'lou'yu	0
商业三责附加险	shang'ye'san'ze'fu'jia'xian	0
商业三责险	shang'ye'san'ze'xian	0
商业险保单	shang'ye'xian'bao'dan	0
社会保障业	she'hui'bao'zhang'ye	0
社会福利业	she'hui'fu'li'ye	0
设立申请书	she'li'shen'qing'shu	0
社团	she'tuan	0
射幸合同	she'xing'he'tong	0
摄影扩印服务	she'ying'kuo'yin'fu'wu	0
身份证	shen'fen'zheng	0
审核意见	shen'he'yi'jian	0
审计	shen'ji	0
审计部	shen'ji'bu	0
审批	shen'pi	0
省级	sheng'ji	0
省级报纸	sheng'ji'bao'zhi	0
声明	sheng'ming	0
生命人寿保险股份有限公司	sheng'ming'ren'shou'bao'xian'gu'fen'you'xian'gong'si	0
十吨及十吨以上货车	shi'dun'ji'shi'dun'yi'shang'huo'che	0
使馆摩托车号牌	shi'guan'mo'tuo'che'hao'pai	0
使馆汽车号牌	shi'guan'qi'che'hao'pai	0
石化	shi'hua	0
石化企业	shi'hua'qi'ye	0
实际赔付率	shi'ji'pei'fu'lv	0
蚀刻	shi'ke	0
室内娱乐活动	shi'nei'yu'le'huo'dong	0
实收	shi'shou	0
实收保费	shi'shou'bao'fei	0
实务规程	shi'wu'gui'cheng	0
试验摩托车号牌	shi'yan'mo'tuo'che'hao'pai	0
试验汽车号牌	shi'yan'qi'che'hao'pai	0
事业单位	shi'ye'dan'wei	0
使用性质	shi'yong'xing'zhi	0
石油产品	shi'you'chan'pin	0
石油化工产品	shi'you'hua'gong'chan'pin	0
石油化学工业	shi'you'hua'xue'gong'ye	0
首创安泰人寿保险有限公司	shou'chuang'an'tai'ren'shou'bao'xian'you'xian'gong'si	0
手扶变形运输机	shou'fu'bian'xing'yun'shu'ji	0
手扶拖拉机	shou'fu'tuo'la'ji	0
受损保险标的	shou'sun'bao'xian'biao'di	0
手续费	shou'xu'fei	0
手续费率	shou'xu'fei'lv	0
手续费台帐	shou'xu'fei'tai'zhang	0
受益权	shou'yi'quan	0
受益人	shou'yi'ren	0
数据丢失	shu'ju'diu'shi	0
刷卡缴费	shua'ka'jiao'fei	0
双务合同	shuang'wu'he'tong	0
水利管理业	shui'li'guan'li'ye	0
水利环境和公司管理业	shui'li'huan'jing'he'gong'si'guan'li'ye	0
水幕系统	shui'mu'xi'tong	0
水上施工	shui'shang'shi'gong	0
水污染治理	shui'wu'ran'zhi'li	0
水险	shui'xian	0
顺岸式	shun'an'shi	0
私车	si'che	0
四轮农用罐式货车	si'lun'nong'yong'guan'shi'huo'che	0
四轮农用普通货车	si'lun'nong'yong'pu'tong'huo'che	0
四轮农用厢式货车	si'lun'nong'yong'xiang'shi'huo'che	0
四轮农用自卸货车	si'lun'nong'yong'zi'xie'huo'che	0
私人	si'ren	0
死亡或者伤残	si'wang'huo'zhe'shang'can	0
死亡伤残赔偿限额	si'wang'shang'can'pei'chang'xian'e	0
苏黎世	su'li'shi	0
诉讼	su'song	0
索赔申请书	suo'pei'shen'qing'shu	0
所属性质	suo'shu'xing'zhi	0
泰安	tai'an	0
太保	tai'bao	0
泰康人寿保险股份有限公司	tai'kang'ren'shou'bao'xian'gu'fen'you'xian'gong'si	0
太平保险	tai'ping'bao'xian	0
太平保险股份有限公司	tai'ping'bao'xian'gu'fen'you'xian'gong'si	0
太平保险有限公司	tai'ping'bao'xian'you'xian'gong'si	0
太平人寿保险有限公司	tai'ping'ren'shou'bao'xian'you'xian'gong'si	0
太平洋安泰人寿保险有限公司	tai'ping'yang'an'tai'ren'shou'bao'xian'you'xian'gong'si	0
太平洋财产	tai'ping'yang'cai'chan	0
太平洋财产保险公司	tai'ping'yang'cai'chan'bao'xian'gong'si	0
太平养老保险股份有限公司	tai'ping'yang'lao'bao'xian'gu'fen'you'xian'gong'si	0
特别约定	te'bie'yue'ding	0
特此声明	te'ci'sheng'ming	0
特殊风险保险	te'shu'feng'xian'bao'xian	0
特殊批改	te'shu'pi'gai	0
特约	te'yue	0
特种车	te'zhong'che	0
特种车二	te'zhong'che'er	0
特种车三	te'zhong'che'san	0
特种车四	te'zhong'che'si	0
特种车一	te'zhong'che'yi	0
提车保险车种	ti'che'bao'xian'che'zhong	0
体育场馆	ti'yu'chang'guan	0
体育组织	ti'yu'zu'zhi	0
天安	tian'an	0
天安保险	tian'an'bao'xian	0
天安保险股份有限公司	tian'an'bao'xian'gu'fen'you'xian'gong'si	0
天保人寿	tian'bao'ren'shou	0
天平车险	tian'ping'che'xian	0
天平汽车保险股份有限公司	tian'ping'qi'che'bao'xian'gu'fen'you'xian'gong'si	0
天然气	tian'ran'qi	0
停驶	ting'shi	0
同比增幅	tong'bi'zeng'fu	0
统计快报	tong'ji'kuai'bao	0
统计日期	tong'ji'ri'qi	0
同时投保	tong'shi'tou'bao	0
通讯或者网络中断	tong'xun'huo'zhe'wang'luo'zhong'duan	0
投保单	tou'bao'dan	0
投保流程	tou'bao'liu'cheng	0
投保人	tou'bao'ren	0
投标	tou'biao	0
投标文件	tou'biao'wen'jian	0
突堤式	tu'di'shi	0
图书馆和信息中心	tu'shu'guan'he'xin'xi'zhong'xin	0
团车	tuan'che	0
团体人员意外险	tuan'ti'ren'yuan'yi'wai'xian	0
团体险	tuan'ti'xian	0
团意险	tuan'yi'xian	0
拖拉机	tuo'la'ji	0
拖拉机号牌	tuo'la'ji'hao'pai	0
外国保险公司	wai'guo'bao'xian'gong'si	0
外籍摩托车号牌	wai'ji'mo'tuo'che'hao'pai	0
外籍汽车号牌	wai'ji'qi'che'hao'pai	0
外资独资保险公司	wai'zi'du'zi'bao'xian'gong'si	0
未核保	wei'he'bao	0
未决笔数	wei'jue'bi'shu	0
未决金额	wei'jue'jin'e	0
卫生社会保障和福利	wei'sheng'she'hui'bao'zhang'he'fu'li	0
危险单位	wei'xian'dan'wei	0
微型仓栅式货车	wei'xing'cang'shan'shi'huo'che	0
卫星传输服务	wei'xing'chuan'shu'fu'wu	0
微型封闭货车	wei'xing'feng'bi'huo'che	0
微型罐式货车	wei'xing'guan'shi'huo'che	0
微型轿车	wei'xing'jiao'che	0
微型普通货车	wei'xing'pu'tong'huo'che	0
微型普通客车	wei'xing'pu'tong'ke'che	0
微型特殊结构货车	wei'xing'te'shu'jie'gou'huo'che	0
微型厢式货车	wei'xing'xiang'shi'huo'che	0
微型越野客车	wei'xing'yue'ye'ke'che	0
微型专项作业车	wei'xing'zhuan'xiang'zuo'ye'che	0
微型自卸货车	wei'xing'zi'xie'huo'che	0
违约责任	wei'yue'ze'ren	0
文化体育和娱乐业	wen'hua'ti'yu'he'yu'le'ye	0
文件袋	wen'jian'dai	0
文件盒	wen'jian'he	0
文件架	wen'jian'jia	0
文物与文化保护	wen'wu'yu'wen'hua'bao'hu	0
文艺创作与表演	wen'yi'chuang'zuo'yu'biao'yan	0
无轨电车	wu'gui'dian'che	0
物价部门	wu'jia'bu'men	0
武警号牌	wu'jing'hao'pai	0
物理气相沉积	wu'li'qi'xiang'chen'ji	0
无民事行为能力	wu'min'shi'xing'wei'neng'li	0
无赔退费	wu'pei'tui'fei	0
无赔优待	wu'pei'you'dai	0
无责	wu'ze	0
无责代赔	wu'ze'dai'pei	0
无责任财产损失赔偿限额	wu'ze'ren'cai'chan'sun'shi'pei'chang'xian'e	0
无责任死亡伤残赔偿限额	wu'ze'ren'si'wang'shang'can'pei'chang'xian'e	0
无责任医疗费用赔偿限额	wu'ze'ren'yi'liao'fei'yong'pei'chang'xian'e	0
系缆力	xi'lan'li	0
洗染服务	xi'ran'fu'wu	0
系统	xi'tong	0
洗浴服务	xi'yu'fu'wu	0
下发	xia'fa	0
险别	xian'bie	0
现代财产	xian'dai'cai'chan	0
现代财产保险有限公司	xian'dai'cai'chan'bao'xian'you'xian'gong'si	0
现代财险	xian'dai'cai'xian	0
险种	xian'zhong	0
险种类别	xian'zhong'lei'bie	0
险种名称	xian'zhong'ming'cheng	0
香港民安保险有限公司	xiang'gang'min'an'bao'xian'you'xian'gong'si	0
相互给付	xiang'hu'ji'fu	0
消防水泵	xiao'fang'shui'beng	0
消防水源	xiao'fang'shui'yuan	0
销号	xiao'hao	0
小票	xiao'piao	0
小型仓栅式半挂车	xiao'xing'cang'shan'shi'ban'gua'che	0
小型仓栅式货车	xiao'xing'cang'shan'shi'huo'che	0
小型仓栅式全挂车	xiao'xing'cang'shan'shi'quan'gua'che	0
小型低平板半挂车	xiao'xing'di'ping'ban'ban'gua'che	0
小型轮式拖拉机	xiao'xing'lun'shi'tuo'la'ji	0
小型旅居半挂车	xiao'xing'lv'ju'ban'gua'che	0
小型旅居全挂车	xiao'xing'lv'ju'quan'gua'che	0
小型普通客车	xiao'xing'pu'tong'ke'che	0
小型汽车号牌	xiao'xing'qi'che'hao'pai	0
小型越野客车	xiao'xing'yue'ye'ke'che	0
小型专项作业半挂车	xiao'xing'zhuan'xiang'zuo'ye'ban'gua'che	0
小型专项作业车	xiao'xing'zhuan'xiang'zuo'ye'che	0
小型专项作业全挂车	xiao'xing'zhuan'xiang'zuo'ye'quan'gua'che	0
小型专用客车	xiao'xing'zhuan'yong'ke'che	0
校园方责任险	xiao'yuan'fang'ze'ren'xian	0
新车	xin'che	0
新车上户	xin'che'shang'hu	0
信诚人寿保险有限公司	xin'cheng'ren'shou'bao'xian'you'xian'gong'si	0
新光人寿	xin'guang'ren'shou	0
新华人寿保险股份有限公司	xin'hua'ren'shou'bao'xian'gu'fen'you'xian'gong'si	0
信诺人寿	xin'nuo'ren'shou	0
新闻出版业	xin'wen'chu'ban'ye	0
信息传输计算机服务和软件业	xin'xi'chuan'shu'ji'suan'ji'fu'wu'he'ruan'jian'ye	0
信用保险	xin'yong'bao'xian	0
行车证	xing'che'zheng	0
幸福人寿	xing'fu'ren'shou	0
幸福人寿保险股份有限公司	xing'fu'ren'shou'bao'xian'gu'fen'you'xian'gong'si	0
星级旅馆	xing'ji'lv'guan	0
行驶里程	xing'shi'li'cheng	0
行驶证	xing'shi'zheng	0
行驶证车主	xing'shi'zheng'che'zhu	0
行政部	xing'zheng'bu	0
行政事业部	xing'zheng'shi'ye'bu	0
修改	xiu'gai	0
休闲健身活动	xiu'xian'jian'shen'huo'dong	0
学前初等中等教育	xue'qian'chu'deng'zhong'deng'jiao'yu	0
验车	yan'che	0
验车记录	yan'che'ji'lu	0
验车情况	yan'che'qing'kuang	0
验车人	yan'che'ren	0
验车照片	yan'che'zhao'pian	0
研究与试验发展	yan'jiu'yu'shi'yan'fa'zhan	0
阳光财产保险股份有限公司	yang'guang'cai'chan'bao'xian'gu'fen'you'xian'gong'si	0
阳光财险	yang'guang'cai'xian	0
阳光农险	yang'guang'nong'xian	0
阳光农业相互保险公司	yang'guang'nong'ye'xiang'hu'bao'xian'gong'si	0
液罐	ye'guan	0
业管部	ye'guan'bu	0
液化气	ye'hua'qi	0
液晶显示器	ye'jing'xian'shi'qi	0
业务报表	ye'wu'bao'biao	0
业务结清	ye'wu'jie'qing	0
业务联	ye'wu'lian	0
业务系统	ye'wu'xi'tong	0
业务员	ye'wu'yuan	0
一般挂车	yi'ban'gua'che	0
一般旅馆	yi'ban'lv'guan	0
一般赔付率	yi'ban'pei'fu'lv	0
一般批改	yi'ban'pi'gai	0
一般企业	yi'ban'qi'ye	0
一次灾害	yi'ci'zai'hai	0
已核保	yi'he'bao	0
意见	yi'jian	0
已决案均赔款	yi'jue'an'jun'pei'kuan	0
已决笔数	yi'jue'bi'shu	0
已决金额	yi'jue'jin'e	0
一类单证	yi'lei'dan'zheng	0
医疗费用赔偿限额	yi'liao'fei'yong'pei'chang'xian'e	0
医疗责任保险	yi'liao'ze'ren'bao'xian	0
已满期保费	yi'man'qi'bao'fei	0
艺术表演场馆	yi'shu'biao'yan'chang'guan	0
意外伤害保险	yi'wai'shang'hai'bao'xian	0
意外险	yi'wai'xian	0
医院卫生院	yi'yuan'wei'sheng'yuan	0
已赚保费	yi'zhuan'bao'fei	0
已赚赔付率	yi'zhuan'pei'fu'lv	0
银行业	yin'hang'ye	0
饮料及冷饮服务	yin'liao'ji'leng'yin'fu'wu	0
印刷号	yin'shua'hao	0
印油	yin'you	0
印章	yin'zhang	0
英大泰和人寿保险股份有限公司	ying'da'tai'he'ren'shou'bao'xian'gu'fen'you'xian'gong'si	0
营管部	ying'guan'bu	0
应收	ying'shou	0
应收保费	ying'shou'bao'fei	0
营销服务部	ying'xiao'fu'wu'bu	0
营业部	ying'ye'bu	0
营业城市公交客车	ying'ye'cheng'shi'gong'jiao'ke'che	0
营业出租租赁客车	ying'ye'chu'zu'zu'lin'ke'che	0
营业费用率	ying'ye'fei'yong'lv	0
营业公路客运客车	ying'ye'gong'lu'ke'yun'ke'che	0
营业货车	ying'ye'huo'che	0
营业机动车险版	ying'ye'ji'dong'che'xian'ban	0
营业客车	ying'ye'ke'che	0
营业统计报表	ying'ye'tong'ji'bao'biao	0
营运	ying'yun	0
营运货车	ying'yun'huo'che	0
营运期	ying'yun'qi	0
永安财产	yong'an'cai'chan	0
永安财产保险股份有限公司	yong'an'cai'chan'bao'xian'gu'fen'you'xian'gong'si	0
永诚	yong'cheng	0
永诚财产保险股份有限公司	yong'cheng'cai'chan'bao'xian'gu'fen'you'xian'gong'si	0
有否死亡	you'fou'si'wang	0
油罐	you'guan	0
有轨电车	you'gui'dian'che	0
优惠系数	you'hui'xi'shu	0
有机化工原料	you'ji'hua'gong'yuan'liao	0
有价单证	you'jia'dan'zheng	0
有限责任公司	you'xian'ze'ren'gong'si	0
有责	you'ze	0
邮政业	you'zheng'ye	0
预约分保	yu'yue'fen'bao	0
原料芯片	yuan'liao'xin'pian	0
原章	yuan'zhang	0
约定驾驶人	yue'ding'jia'shi'ren	0
约定行驶区域	yue'ding'xing'shi'qu'yu	0
越野车	yue'ye'che	0
云广	yun'guang	0
运输服务业	yun'shu'fu'wu'ye	0
运输险	yun'shu'xian	0
运输型拖拉机	yun'shu'xing'tuo'la'ji	0
再保险	zai'bao'xian	0
再保险保障	zai'bao'xian'bao'zhang	0
再保险业务管理规定	zai'bao'xian'ye'wu'guan'li'gui'ding	0
责任保险	ze'ren'bao'xian	0
责任免除	ze'ren'mian'chu	0
责任险	ze'ren'xian	0
责任限额	ze'ren'xian'e	0
责任准备金	ze'ren'zhun'bei'jin	0
栈桥式	zhan'qiao'shi	0
展业费	zhan'ye'fei	0
招标	zhao'biao	0
招标文件	zhao'biao'wen'jian	0
招商信诺人寿保险有限公司	zhao'shang'xin'nuo'ren'shou'bao'xian'you'xian'gong'si	0
折旧率	zhe'jiu'lv	0
折扣	zhe'kou	0
折扣率	zhe'kou'lv	0
折扣系数	zhe'kou'xi'shu	0
折前保费	zhe'qian'bao'fei	0
正餐服务	zheng'can'fu'wu	0
整车	zheng'che	0
整车库	zheng'che'ku	0
正德人寿保险股份有限公司	zheng'de'ren'shou'bao'xian'gu'fen'you'xian'gong'si	0
政府	zheng'fu	0
政府机关	zheng'fu'ji'guan	0
证券业	zheng'quan'ye	0
正三轮载货摩托车	zheng'san'lun'zai'huo'mo'tuo'che	0
正三轮载客摩托车	zheng'san'lun'zai'ke'mo'tuo'che	0
争议处理	zheng'yi'chu'li	0
支公司	zhi'gong'si	0
直接业务	zhi'jie'ye'wu	0
知识产权服务	zhi'shi'chan'quan'fu'wu	0
直销	zhi'xiao	0
质押	zhi'ya	0
职业责任险	zhi'ye'ze'ren'xian	0
职业中介服务	zhi'ye'zhong'jie'fu'wu	0
中安财险	zhong'an'cai'xian	0
中保康联人寿保险有限公司	zhong'bao'kang'lian'ren'shou'bao'xian'you'xian'gong'si	0
中标项目	zhong'biao'xiang'mu	0
钟表珠宝维修	zhong'biao'zhu'bao'wei'xiu	0
仲裁	zhong'cai	0
仲裁机构	zhong'cai'ji'gou	0
中德安联人寿	zhong'de'an'lian'ren'shou	0
中德安联人寿保险有限公司	zhong'de'an'lian'ren'shou'bao'xian'you'xian'gong'si	0
中国保监会	zhong'guo'bao'jian'hui	0
中国保险监督管理委员会	zhong'guo'bao'xian'jian'du'guan'li'wei'yuan'hui	0
中国保险控股有限公司	zhong'guo'bao'xian'kong'gu'you'xian'gong'si	0
中国财产再保险股份有限公司	zhong'guo'cai'chan'zai'bao'xian'gu'fen'you'xian'gong'si	0
中国出口信用保险公司	zhong'guo'chu'kou'xin'yong'bao'xian'gong'si	0
中国大地财产保险股份有限公司	zhong'guo'da'di'cai'chan'bao'xian'gu'fen'you'xian'gong'si	0
中国共产党机关	zhong'guo'gong'chan'dang'ji'guan	0
中国平安保险集团股份有限公司	zhong'guo'ping'an'bao'xian'ji'tuan'gu'fen'you'xian'gong'si	0
中国平安财产保险股份有限公司	zhong'guo'ping'an'cai'chan'bao'xian'gu'fen'you'xian'gong'si	0
中国平安人寿保险股份有限公司	zhong'guo'ping'an'ren'shou'bao'xian'gu'fen'you'xian'gong'si	0
中国人保	zhong'guo'ren'bao	0
中国人保控股公司	zhong'guo'ren'bao'kong'gu'gong'si	0
中国人保资产管理有限公司	zhong'guo'ren'bao'zi'chan'guan'li'you'xian'gong'si	0
中国人民保险公司	zhong'guo'ren'min'bao'xian'gong'si	0
中国人民财产保险股份有限公司	zhong'guo'ren'min'cai'chan'bao'xian'gu'fen'you'xian'gong'si	0
中国人民健康保险股份有限公司	zhong'guo'ren'min'jian'kang'bao'xian'gu'fen'you'xian'gong'si	0
中国人民人寿保险股份有限公司	zhong'guo'ren'min'ren'shou'bao'xian'gu'fen'you'xian'gong'si	0
中国人寿保险股份有限公司	zhong'guo'ren'shou'bao'xian'gu'fen'you'xian'gong'si	0
中国人寿保险集团公司	zhong'guo'ren'shou'bao'xian'ji'tuan'gong'si	0
中国人寿财产保险公司	zhong'guo'ren'shou'cai'chan'bao'xian'gong'si	0
中国人寿财产保险股份有限公司	zhong'guo'ren'shou'cai'chan'bao'xian'gu'fen'you'xian'gong'si	0
中国人寿养老保险股份有限公司	zhong'guo'ren'shou'yang'lao'bao'xian'gu'fen'you'xian'gong'si	0
中国人寿再保险股份有限公司	zhong'guo'ren'shou'zai'bao'xian'gu'fen'you'xian'gong'si	0
中国人寿资产管理公司	zhong'guo'ren'shou'zi'chan'guan'li'gong'si	0
中国太平洋保险集团有限公司	zhong'guo'tai'ping'yang'bao'xian'ji'tuan'you'xian'gong'si	0
中国再保险集团公司	zhong'guo'zai'bao'xian'ji'tuan'gong'si	0
中航三星人寿保险有限公司	zhong'hang'san'xing'ren'shou'bao'xian'you'xian'gong'si	0
中宏人寿保险有限公司	zhong'hong'ren'shou'bao'xian'you'xian'gong'si	0
中华联合	zhong'hua'lian'he	0
中华联合财产保险公司	zhong'hua'lian'he'cai'chan'bao'xian'gong'si	0
中华人民共和国保险法	zhong'hua'ren'min'gong'he'guo'bao'xian'fa	0
中华人民共和国道路交通安全法	zhong'hua'ren'min'gong'he'guo'dao'lu'jiao'tong'an'quan'fa	0
中金财险	zhong'jin'cai'xian	0
中美大都会人寿保险有限公司	zhong'mei'da'du'hui'ren'shou'bao'xian'you'xian'gong'si	0
中外合资保险公司	zhong'wai'he'zi'bao'xian'gong'si	0
中心支公司	zhong'xin'zhi'gong'si	0
重型半挂牵引车	zhong'xing'ban'gua'qian'yin'che	0
中型半挂牵引车	zhong'xing'ban'gua'qian'yin'che	0
重型仓栅式半挂车	zhong'xing'cang'shan'shi'ban'gua'che	0
中型仓栅式半挂车	zhong'xing'cang'shan'shi'ban'gua'che	0
重型仓栅式货车	zhong'xing'cang'shan'shi'huo'che	0
中型仓栅式货车	zhong'xing'cang'shan'shi'huo'che	0
重型仓栅式全挂车	zhong'xing'cang'shan'shi'quan'gua'che	0
中型仓栅式全挂车	zhong'xing'cang'shan'shi'quan'gua'che	0
重型低平板半挂车	zhong'xing'di'ping'ban'ban'gua'che	0
中型低平板半挂车	zhong'xing'di'ping'ban'ban'gua'che	0
重型封闭货车	zhong'xing'feng'bi'huo'che	0
中型封闭货车	zhong'xing'feng'bi'huo'che	0
重型罐式半挂车	zhong'xing'guan'shi'ban'gua'che	0
中型罐式半挂车	zhong'xing'guan'shi'ban'gua'che	0
重型罐式货车	zhong'xing'guan'shi'huo'che	0
中型罐式货车	zhong'xing'guan'shi'huo'che	0
重型罐式全挂车	zhong'xing'guan'shi'quan'gua'che	0
中型罐式全挂车	zhong'xing'guan'shi'quan'gua'che	0
重型集装箱半挂车	zhong'xing'ji'zhuang'xiang'ban'gua'che	0
中型集装箱半挂车	zhong'xing'ji'zhuang'xiang'ban'gua'che	0
重型集装箱车	zhong'xing'ji'zhuang'xiang'che	0
中型集装箱车	zhong'xing'ji'zhuang'xiang'che	0
重型集装箱全挂车	zhong'xing'ji'zhuang'xiang'quan'gua'che	0
中型集装箱全挂车	zhong'xing'ji'zhuang'xiang'quan'gua'che	0
中型轿车	zhong'xing'jiao'che	0
中型铰接客车	zhong'xing'jiao'jie'ke'che	0
中型轮式拖拉机	zhong'xing'lun'shi'tuo'la'ji	0
重型旅居半挂车	zhong'xing'lv'ju'ban'gua'che	0
中型旅居半挂车	zhong'xing'lv'ju'ban'gua'che	0
重型旅居全挂车	zhong'xing'lv'ju'quan'gua'che	0
重型平板半挂车	zhong'xing'ping'ban'ban'gua'che	0
中型平板半挂车	zhong'xing'ping'ban'ban'gua'che	0
重型平板货车	zhong'xing'ping'ban'huo'che	0
中型平板货车	zhong'xing'ping'ban'huo'che	0
重型平板全挂车	zhong'xing'ping'ban'quan'gua'che	0
中型平板全挂车	zhong'xing'ping'ban'quan'gua'che	0
重型普通半挂车	zhong'xing'pu'tong'ban'gua'che	0
中型普通半挂车	zhong'xing'pu'tong'ban'gua'che	0
重型普通货车	zhong'xing'pu'tong'huo'che	0
中型普通货车	zhong'xing'pu'tong'huo'che	0
中型普通客车	zhong'xing'pu'tong'ke'che	0
重型普通全挂车	zhong'xing'pu'tong'quan'gua'che	0
中型普通全挂车	zhong'xing'pu'tong'quan'gua'che	0
重型全挂牵引车	zhong'xing'quan'gua'qian'yin'che	0
中型全挂牵引车	zhong'xing'quan'gua'qian'yin'che	0
中型双层客车	zhong'xing'shuang'ceng'ke'che	0
重型特殊结构半挂车	zhong'xing'te'shu'jie'gou'ban'gua'che	0
中型特殊结构半挂车	zhong'xing'te'shu'jie'gou'ban'gua'che	0
重型特殊结构货车	zhong'xing'te'shu'jie'gou'huo'che	0
中型特殊结构货车	zhong'xing'te'shu'jie'gou'huo'che	0
中型卧铺客车	zhong'xing'wo'pu'ke'che	0
重型厢式半挂车	zhong'xing'xiang'shi'ban'gua'che	0
中型厢式半挂车	zhong'xing'xiang'shi'ban'gua'che	0
重型厢式货车	zhong'xing'xiang'shi'huo'che	0
中型厢式货车	zhong'xing'xiang'shi'huo'che	0
重型厢式全挂车	zhong'xing'xiang'shi'quan'gua'che	0
中型厢式全挂车	zhong'xing'xiang'shi'quan'gua'che	0
中型越野客车	zhong'xing'yue'ye'ke'che	0
重型专项作业半挂车	zhong'xing'zhuan'xiang'zuo'ye'ban'gua'che	0
中型专项作业半挂车	zhong'xing'zhuan'xiang'zuo'ye'ban'gua'che	0
重型专项作业车	zhong'xing'zhuan'xiang'zuo'ye'che	0
中型专项作业车	zhong'xing'zhuan'xiang'zuo'ye'che	0
重型专项作业全挂车	zhong'xing'zhuan'xiang'zuo'ye'quan'gua'che	0
中型专用客车	zhong'xing'zhuan'yong'ke'che	0
重型自卸半挂车	zhong'xing'zi'xie'ban'gua'che	0
中型自卸半挂车	zhong'xing'zi'xie'ban'gua'che	0
重型自卸货车	zhong'xing'zi'xie'huo'che	0
中型自卸货车	zhong'xing'zi'xie'huo'che	0
重型自卸全挂车	zhong'xing'zi'xie'quan'gua'che	0
中型自卸全挂车	zhong'xing'zi'xie'quan'gua'che	0
中意财产	zhong'yi'cai'chan	0
中意财产保险有限公司	zhong'yi'cai'chan'bao'xian'you'xian'gong'si	0
中意人寿保险有限公司	zhong'yi'ren'shou'bao'xian'you'xian'gong'si	0
中银保险	zhong'yin'bao'xian	0
中银保险有限公司	zhong'yin'bao'xian'you'xian'gong'si	0
中英人寿保险有限公司	zhong'ying'ren'shou'bao'xian'you'xian'gong'si	0
中再资产管理股份有限公司	zhong'zai'zi'chan'guan'li'gu'fen'you'xian'gong'si	0
注册会计师责任险	zhu'ce'kuai'ji'shi'ze'ren'xian	0
助动车	zhu'dong'che	0
住宿和餐饮服务业	zhu'su'he'can'yin'fu'wu'ye	0
住宿和餐饮业	zhu'su'he'can'yin'ye	0
住宿业	zhu'su'ye	0
转让	zhuan'rang	0
专业代理	zhuan'ye'dai'li	0
专业代理业务	zhuan'ye'dai'li'ye'wu	0
专业工作	zhuan'ye'gong'zuo	0
专业技术服务	zhuan'ye'ji'shu'fu'wu	0
专业仪器	zhuan'ye'yi'qi	0
专用机械	zhuan'yong'ji'xie	0
装订	zhuang'ding	0
装潢家具维修	zhuang'huang'jia'ju'wei'xiu	0
撞击力	zhuang'ji'li	0
追偿	zhui'chang	0
资本金	zi'ben'jin	0
资本密集	zi'ben'mi'ji	0
自动核保	zi'dong'he'bao	0
自动水喷淋系统	zi'dong'shui'pen'lin'xi'tong	0
自留风险	zi'liu'feng'xian	0
自然保护	zi'ran'bao'hu	0
自行车	zi'xing'che	0
咨询与调查	zi'xun'yu'diao'cha	0
总保费	zong'bao'fei	0
综合费用率	zong'he'fei'yong'lv	0
综合赔付率	zong'he'pei'fu'lv	0
宗教组织	zong'jiao'zu'zhi	0
总经理室	zong'jing'li'shi	0
租赁企业	zu'lin'qi'ye	0
租赁商务服务业	zu'lin'shang'wu'fu'wu'ye	0
租赁业	zu'lin'ye	0
组织机构代码证	zu'zhi'ji'gou'dai'ma'zheng	0
组织人事部	zu'zhi'ren'shi'bu	0
最大补偿原则	zui'da'bu'chang'yuan'ze	0
最大诚信原则	zui'da'cheng'xin'yuan'ze	0
作废	zuo'fei	0
作废声明	zuo'fei'sheng'ming	0
