阿比西尼亚猫	a'bi'xi'ni'ya'mao	0
埃及猫	ai'ji'mao	0
安哥拉猫	an'ge'la'mao	0
奥西猫	ao'xi'mao	0
巴厘岛猫	ba'li'dao'mao	0
巴密兹猫	ba'mi'zi'mao	0
豹猫	bao'mao	0
北美洲短毛猫	bei'mei'zhou'duan'mao'mao	0
彼得秃猫	bi'de'tu'mao	0
伯曼猫	bo'man'mao	0
波斯猫	bo'si'mao	0
布履阑珊猫	bu'lv'lan'shan'mao	0
布偶猫	bu'ou'mao	0
布娃娃猫	bu'wa'wa'mao	0
长毛反耳猫	chang'mao'fan'er'mao	0
长毛猫	chang'mao'mao	0
长毛暹罗猫	chang'mao'xian'luo'mao	0
蛋黄巧克力猫	dan'huang'qiao'ke'li'mao	0
得文卷毛猫	de'wen'juan'mao'mao	0
蒂凡尼猫	di'fan'ni'mao	0
东方长毛猫	dong'fang'chang'mao'mao	0
东方短毛猫	dong'fang'duan'mao'mao	0
东奇尼猫	dong'qi'ni'mao	0
短毛猫	duan'mao'mao	0
短尾猫	duan'wei'mao	0
顿斯科伊猫	dun'si'ke'yi'mao	0
俄国蓝猫	e'guo'lan'mao	0
俄罗斯蓝猫	e'luo'si'lan'mao	0
凡稀卷耳猫	fan'xi'juan'er'mao	0
非纯种猫	fei'chun'zhong'mao	0
高地折耳猫	gao'di'zhe'er'mao	0
哈瓦那猫	ha'wa'na'mao	0
哈瓦那棕色猫	ha'wa'na'zong'se'mao	0
虎斑猫	hu'ban'mao	0
荒漠猫	huang'mo'mao	0
加菲猫	jia'fei'mao	0
加拿大无毛猫	jia'na'da'wu'mao'mao	0
加州闪亮猫	jia'zhou'shan'liang'mao	0
金吉拉	jin'ji'la	0
卷耳猫	juan'er'mao	0
卷毛猫	juan'mao'mao	0
卡尔特猫	ka'er'te'mao	0
卡特尔猫	ka'te'er'mao	0
康沃尔帝王猫	kang'wo'er'di'wang'mao	0
克拉特猫	ke'la'te'mao	0
柯拉特猫	ke'la'te'mao	0
科来特猫	ke'lai'te'mao	0
柯尼斯卷毛猫	ke'ni'si'juan'mao'mao	0
库里瑞短尾猫	ku'li'rui'duan'wei'mao	0
拉邦猫	la'bang'mao	0
拉格多尔猫	la'ge'duo'er'mao	0
力克斯猫	li'ke'si'mao	0
马恩岛猫	ma'en'dao'mao	0
曼岛猫	man'dao'mao	0
曼克斯猫	man'ke'si'mao	0
曼切堪猫	man'qie'kan'mao	0
美国短毛猫	mei'guo'duan'mao'mao	0
美国短尾猫	mei'guo'duan'wei'mao	0
美国刚毛猫	mei'guo'gang'mao'mao	0
美国卷耳短毛猫	mei'guo'juan'er'duan'mao'mao	0
美国卷耳猫	mei'guo'juan'er'mao	0
美国硬毛猫	mei'guo'ying'mao'mao	0
孟加拉猫	meng'jia'la'mao	0
孟买猫	meng'mai'mao	0
缅甸猫	mian'dian'mao	0
缅因库恩猫	mian'yin'ku'en'mao	0
缅因猫	mian'yin'mao	0
模特猫	mo'te'mao	0
内华达猫	nei'hua'da'mao	0
泥盆雷库斯猫	ni'pen'lei'ku'si'mao	0
挪威猫	nuo'wei'mao	0
挪威森林猫	nuo'wei'sen'lin'mao	0
欧斯亚史烈斯猫	ou'si'ya'shi'lie'si'mao	0
欧西猫	ou'xi'mao	0
欧洲短毛猫	ou'zhou'duan'mao'mao	0
日本短尾猫	ri'ben'duan'wei'mao	0
日本截尾猫	ri'ben'jie'wei'mao	0
塞尔凯克卷毛猫	sai'er'kai'ke'juan'mao'mao	0
塞舌尔猫	sai'she'er'mao	0
沙特尔猫	sha'te'er'mao	0
山东狮子猫	shan'dong'shi'zi'mao	0
狮子猫	shi'zi'mao	0
四川简州猫	si'chuan'jian'zhou'mao	0
斯芬克斯猫	si'fen'ke'si'mao	0
苏格兰折耳猫	su'ge'lan'zhe'er'mao	0
索马里猫	suo'ma'li'mao	0
泰国猫	tai'guo'mao	0
土耳其安哥拉猫	tu'er'qi'an'ge'la'mao	0
土耳其梵科迪斯猫	tu'er'qi'fan'ke'di'si'mao	0
土耳其梵猫	tu'er'qi'fan'mao	0
外来种猫	wai'lai'zhong'mao	0
韦尔斯猫	wei'er'si'mao	0
西伯利亚森林猫	xi'bo'li'ya'sen'lin'mao	0
西卡克雷库斯猫	xi'ka'ke'lei'ku'si'mao	0
喜马拉雅猫	xi'ma'la'ya'mao	0
希姆利克猫	xi'mu'li'ke'mao	0
夏尔特猫	xia'er'te'mao	0
暹罗猫	xian'luo'mao	0
小弯耳猫	xiao'wan'er'mao	0
新加坡猫	xin'jia'po'mao	0
雪鞋猫	xue'xie'mao	0
椰子猫	ye'zi'mao	0
异国短毛猫	yi'guo'duan'mao'mao	0
英国短毛猫	ying'guo'duan'mao'mao	0
越南猫	yue'nan'mao	0
云猫	yun'mao	0
杂种长毛猫	za'zhong'chang'mao'mao	0
爪哇猫	zhao'wa'mao	0
折耳猫	zhe'er'mao	0
摺耳猫	zhe'er'mao	0
重点色波斯猫	zhong'dian'se'bo'si'mao	0
中国狸花猫	zhong'guo'li'hua'mao	0
棕榈猫	zong'lv'mao	0
