安徽海螺集团有限责任公司	an'hui'hai'luo'ji'tuan'you'xian'ze'ren'gong'si	0
安徽建工集团有限公司	an'hui'jian'gong'ji'tuan'you'xian'gong'si	0
安徽江淮汽车集团有限公司	an'hui'jiang'huai'qi'che'ji'tuan'you'xian'gong'si	0
安徽省徽商集团有限公司	an'hui'sheng'hui'shang'ji'tuan'you'xian'gong'si	0
鞍山钢铁集团公司	an'shan'gang'tie'ji'tuan'gong'si	0
安阳钢铁集团有限责任公司	an'yang'gang'tie'ji'tuan'you'xian'ze'ren'gong'si	0
奥克斯集团有限公司	ao'ke'si'ji'tuan'you'xian'gong'si	0
百联集团有限公司	bai'lian'ji'tuan'you'xian'gong'si	0
百兴集团有限公司	bai'xing'ji'tuan'you'xian'gong'si	0
宝钢集团有限公司	bao'gang'ji'tuan'you'xian'gong'si	0
宝胜集团有限公司	bao'sheng'ji'tuan'you'xian'gong'si	0
包头钢铁集团有限责任公司	bao'tou'gang'tie'ji'tuan'you'xian'ze'ren'gong'si	0
北大方正集团有限公司	bei'da'fang'zheng'ji'tuan'you'xian'gong'si	0
北方重工集团有限公司	bei'fang'zhong'gong'ji'tuan'you'xian'gong'si	0
北京城建集团有限责任公司	bei'jing'cheng'jian'ji'tuan'you'xian'ze'ren'gong'si	0
北京建工集团有限责任公司	bei'jing'jian'gong'ji'tuan'you'xian'ze'ren'gong'si	0
北京建龙重工集团有限公司	bei'jing'jian'long'zhong'gong'ji'tuan'you'xian'gong'si	0
北京金隅集团有限责任公司	bei'jing'jin'yu'ji'tuan'you'xian'ze'ren'gong'si	0
北京控股集团有限公司	bei'jing'kong'gu'ji'tuan'you'xian'gong'si	0
北京汽车工业控股有限责任公司	bei'jing'qi'che'gong'ye'kong'gu'you'xian'ze'ren'gong'si	0
北京首都创业集团有限公司	bei'jing'shou'du'chuang'ye'ji'tuan'you'xian'gong'si	0
北京索爱普天移动通信有限公司	bei'jing'suo'ai'pu'tian'yi'dong'tong'xin'you'xian'gong'si	0
北京铁路局	bei'jing'tie'lu'ju	0
北京外企服务集团有限责任公司	bei'jing'wai'qi'fu'wu'ji'tuan'you'xian'ze'ren'gong'si	0
北京燕京啤酒集团公司	bei'jing'yan'jing'pi'jiu'ji'tuan'gong'si	0
北京医药集团有限责任公司	bei'jing'yi'yao'ji'tuan'you'xian'ze'ren'gong'si	0
北京银行	bei'jing'yin'hang	0
北京住总集团有限责任公司	bei'jing'zhu'zong'ji'tuan'you'xian'ze'ren'gong'si	0
北台钢铁集团有限责任公司	bei'tai'gang'tie'ji'tuan'you'xian'ze'ren'gong'si	0
本溪钢铁集团有限责任公司	ben'xi'gang'tie'ji'tuan'you'xian'ze'ren'gong'si	0
比亚迪股份有限公司	bi'ya'di'gu'fen'you'xian'gong'si	0
滨化集团公司	bin'hua'ji'tuan'gong'si	0
长城电器集团有限公司	chang'cheng'dian'qi'ji'tuan'you'xian'gong'si	0
长城汽车股份有限公司	chang'cheng'qi'che'gu'fen'you'xian'gong'si	0
长治钢铁集团有限公司	chang'zhi'gang'tie'ji'tuan'you'xian'gong'si	0
成都建筑工程集团总公司	cheng'du'jian'zhu'gong'cheng'ji'tuan'zong'gong'si	0
成都铁路局	cheng'du'tie'lu'ju	0
重庆钢铁集团有限责任公司	chong'qing'gang'tie'ji'tuan'you'xian'ze'ren'gong'si	0
重庆化医控股集团公司	chong'qing'hua'yi'kong'gu'ji'tuan'gong'si	0
重庆建工集团有限责任公司	chong'qing'jian'gong'ji'tuan'you'xian'ze'ren'gong'si	0
重庆轻纺控股集团公司	chong'qing'qing'fang'kong'gu'ji'tuan'gong'si	0
重庆商社集团有限公司	chong'qing'shang'she'ji'tuan'you'xian'gong'si	0
重庆市能源投资集团公司	chong'qing'shi'neng'yuan'tou'zi'ji'tuan'gong'si	0
传化集团有限公司	chuan'hua'ji'tuan'you'xian'gong'si	0
大连冰山集团有限公司	da'lian'bing'shan'ji'tuan'you'xian'gong'si	0
大连大商集团有限公司	da'lian'da'shang'ji'tuan'you'xian'gong'si	0
大连机床集团有限责任公司	da'lian'ji'chuang'ji'tuan'you'xian'ze'ren'gong'si	0
大连西太平洋石油化工有限公司	da'lian'xi'tai'ping'yang'shi'you'hua'gong'you'xian'gong'si	0
大连重工起重集团有限公司	da'lian'zhong'gong'qi'zhong'ji'tuan'you'xian'gong'si	0
大同煤矿集团有限责任公司	da'tong'mei'kuang'ji'tuan'you'xian'ze'ren'gong'si	0
大冶有色金属公司	da'ye'you'se'jin'shu'gong'si	0
戴尔中国有限公司	dai'er'zhong'guo'you'xian'gong'si	0
德力西电气股份有限公司	de'li'xi'dian'qi'gu'fen'you'xian'gong'si	0
德力西集团有限公司	de'li'xi'ji'tuan'you'xian'gong'si	0
德龙钢铁有限公司	de'long'gang'tie'you'xian'gong'si	0
登封电厂集团有限公司	deng'feng'dian'chang'ji'tuan'you'xian'gong'si	0
东北特殊钢集团有限责任公司	dong'bei'te'shu'gang'ji'tuan'you'xian'ze'ren'gong'si	0
东方国际集团有限公司	dong'fang'guo'ji'ji'tuan'you'xian'gong'si	0
东风汽车公司	dong'feng'qi'che'gong'si	0
东营方圆有色金属有限公司	dong'ying'fang'yuan'you'se'jin'shu'you'xian'gong'si	0
盾安控股集团有限公司	dun'an'kong'gu'ji'tuan'you'xian'gong'si	0
法尔胜集团公司	fa'er'sheng'ji'tuan'gong'si	0
肥城矿业集团有限责任公司	fei'cheng'kuang'ye'ji'tuan'you'xian'ze'ren'gong'si	0
飞思卡尔半导体中国有限公司	fei'si'ka'er'ban'dao'ti'zhong'guo'you'xian'gong'si	0
丰立集团有限公司	feng'li'ji'tuan'you'xian'gong'si	0
福建省三钢集团有限责任公司	fu'jian'sheng'san'gang'ji'tuan'you'xian'ze'ren'gong'si	0
福田雷沃国际重工股份有限公司	fu'tian'lei'wo'guo'ji'zhong'gong'gu'fen'you'xian'gong'si	0
广东发展银行股份有限公司	guang'dong'fa'zhan'yin'hang'gu'fen'you'xian'gong'si	0
广东格兰仕集团有限公司	guang'dong'ge'lan'shi'ji'tuan'you'xian'gong'si	0
广东省广新外贸集团有限公司	guang'dong'sheng'guang'xin'wai'mao'ji'tuan'you'xian'gong'si	0
广东省建筑工程集团有限公司	guang'dong'sheng'jian'zhu'gong'cheng'ji'tuan'you'xian'gong'si	0
广东省交通集团有限公司	guang'dong'sheng'jiao'tong'ji'tuan'you'xian'gong'si	0
广东省粤电集团有限公司	guang'dong'sheng'yue'dian'ji'tuan'you'xian'gong'si	0
广东物资集团公司	guang'dong'wu'zi'ji'tuan'gong'si	0
光明食品集团有限公司	guang'ming'shi'pin'ji'tuan'you'xian'gong'si	0
广厦控股创业投资有限公司	guang'sha'kong'gu'chuang'ye'tou'zi'you'xian'gong'si	0
广西建工集团有限责任公司	guang'xi'jian'gong'ji'tuan'you'xian'ze'ren'gong'si	0
广西柳州钢铁集团公司	guang'xi'liu'zhou'gang'tie'ji'tuan'gong'si	0
广西投资集团有限公司	guang'xi'tou'zi'ji'tuan'you'xian'gong'si	0
广西玉柴机器集团有限公司	guang'xi'yu'chai'ji'qi'ji'tuan'you'xian'gong'si	0
广州汽车工业集团有限公司	guang'zhou'qi'che'gong'ye'ji'tuan'you'xian'gong'si	0
广州市建筑集团有限公司	guang'zhou'shi'jian'zhu'ji'tuan'you'xian'gong'si	0
广州铁路集团公司	guang'zhou'tie'lu'ji'tuan'gong'si	0
广州万宝集团有限公司	guang'zhou'wan'bao'ji'tuan'you'xian'gong'si	0
广州医药集团有限公司	guang'zhou'yi'yao'ji'tuan'you'xian'gong'si	0
贵州中烟工业有限责任公司	gui'zhou'zhong'yan'gong'ye'you'xian'ze'ren'gong'si	0
国家电网公司	guo'jia'dian'wang'gong'si	0
国家开发投资公司	guo'jia'kai'fa'tou'zi'gong'si	0
国美电器控股有限公司	guo'mei'dian'qi'kong'gu'you'xian'gong'si	0
哈尔滨电气集团公司	ha'er'bin'dian'qi'ji'tuan'gong'si	0
哈尔滨铁路局	ha'er'bin'tie'lu'ju	0
哈药集团有限公司	ha'yao'ji'tuan'you'xian'gong'si	0
海城市西洋耐火材料有限公司	hai'cheng'shi'xi'yang'nai'huo'cai'liao'you'xian'gong'si	0
海尔集团公司	hai'er'ji'tuan'gong'si	0
海航集团有限公司	hai'hang'ji'tuan'you'xian'gong'si	0
海澜集团有限公司	hai'lan'ji'tuan'you'xian'gong'si	0
海力士恒忆半导体有限公司	hai'li'shi'heng'yi'ban'dao'ti'you'xian'gong'si	0
海亮集团有限公司	hai'liang'ji'tuan'you'xian'gong'si	0
海鑫钢铁集团有限公司	hai'xin'gang'tie'ji'tuan'you'xian'gong'si	0
海信集团有限公司	hai'xin'ji'tuan'you'xian'gong'si	0
杭州钢铁集团公司	hang'zhou'gang'tie'ji'tuan'gong'si	0
杭州汽轮动力集团有限公司	hang'zhou'qi'lun'dong'li'ji'tuan'you'xian'gong'si	0
杭州娃哈哈集团有限公司	hang'zhou'wa'ha'ha'ji'tuan'you'xian'gong'si	0
杭州橡胶集团公司	hang'zhou'xiang'jiao'ji'tuan'gong'si	0
河北钢铁集团有限公司	he'bei'gang'tie'ji'tuan'you'xian'gong'si	0
河北津西钢铁股份有限公司	he'bei'jin'xi'gang'tie'gu'fen'you'xian'gong'si	0
河北敬业集团	he'bei'jing'ye'ji'tuan	0
河北普阳钢铁有限公司	he'bei'pu'yang'gang'tie'you'xian'gong'si	0
河北文丰钢铁有限公司	he'bei'wen'feng'gang'tie'you'xian'gong'si	0
合肥百货大楼集团股份有限公司	he'fei'bai'huo'da'lou'ji'tuan'gu'fen'you'xian'gong'si	0
河南济源钢铁集团有限公司	he'nan'ji'yuan'gang'tie'ji'tuan'you'xian'gong'si	0
河南煤业化工集团有限公司	he'nan'mei'ye'hua'gong'ji'tuan'you'xian'gong'si	0
河南神火集团有限公司	he'nan'shen'huo'ji'tuan'you'xian'gong'si	0
河南豫光金铅集团有限责任公司	he'nan'yu'guang'jin'qian'ji'tuan'you'xian'ze'ren'gong'si	0
河南豫联能源集团有限责任公司	he'nan'yu'lian'neng'yuan'ji'tuan'you'xian'ze'ren'gong'si	0
河南中烟工业公司	he'nan'zhong'yan'gong'ye'gong'si	0
恒丰银行	heng'feng'yin'hang	0
恒力集团有限公司	heng'li'ji'tuan'you'xian'gong'si	0
亨通集团有限公司	heng'tong'ji'tuan'you'xian'gong'si	0
红豆集团有限公司	hong'dou'ji'tuan'you'xian'gong'si	0
红塔烟草集团有限责任公司	hong'ta'yan'cao'ji'tuan'you'xian'ze'ren'gong'si	0
红云红河烟草集团有限责任公司	hong'yun'hong'he'yan'cao'ji'tuan'you'xian'ze'ren'gong'si	0
湖北宜化集团有限责任公司	hu'bei'yi'hua'ji'tuan'you'xian'ze'ren'gong'si	0
湖北中烟工业有限责任公司	hu'bei'zhong'yan'gong'ye'you'xian'ze'ren'gong'si	0
呼和浩特铁路局	hu'he'hao'te'tie'lu'ju	0
湖南华菱钢铁集团有限责任公司	hu'nan'hua'ling'gang'tie'ji'tuan'you'xian'ze'ren'gong'si	0
湖南省建筑工程集团总公司	hu'nan'sheng'jian'zhu'gong'cheng'ji'tuan'zong'gong'si	0
湖南有色金属控股集团有限公司	hu'nan'you'se'jin'shu'kong'gu'ji'tuan'you'xian'gong'si	0
湖南中烟工业有限责任公司	hu'nan'zhong'yan'gong'ye'you'xian'ze'ren'gong'si	0
华晨汽车集团控股有限公司	hua'chen'qi'che'ji'tuan'kong'gu'you'xian'gong'si	0
华芳集团有限公司	hua'fang'ji'tuan'you'xian'gong'si	0
华侨城集团公司	hua'qiao'cheng'ji'tuan'gong'si	0
华润集团有限公司	hua'run'ji'tuan'you'xian'gong'si	0
华盛江泉集团有限公司	hua'sheng'jiang'quan'ji'tuan'you'xian'gong'si	0
华泰集团有限公司	hua'tai'ji'tuan'you'xian'gong'si	0
华为技术有限公司	hua'wei'ji'shu'you'xian'gong'si	0
华夏银行股份有限公司	hua'xia'yin'hang'gu'fen'you'xian'gong'si	0
淮北矿业集团有限责任公司	huai'bei'kuang'ye'ji'tuan'you'xian'ze'ren'gong'si	0
淮南矿业集团有限责任公司	huai'nan'kuang'ye'ji'tuan'you'xian'ze'ren'gong'si	0
惠州市德赛集团有限公司	hui'zhou'shi'de'sai'ji'tuan'you'xian'gong'si	0
吉林粮食集团有限公司	ji'lin'liang'shi'ji'tuan'you'xian'gong'si	0
吉林亚泰集团股份有限公司	ji'lin'ya'tai'ji'tuan'gu'fen'you'xian'gong'si	0
济南铁路局	ji'nan'tie'lu'ju	0
冀中能源集团有限责任公司	ji'zhong'neng'yuan'ji'tuan'you'xian'ze'ren'gong'si	0
江铃汽车集团公司	jiang'ling'qi'che'ji'tuan'gong'si	0
江门市大长江集团有限公司	jiang'men'shi'da'chang'jiang'ji'tuan'you'xian'gong'si	0
江苏高力集团有限公司	jiang'su'gao'li'ji'tuan'you'xian'gong'si	0
江苏国泰国际集团有限公司	jiang'su'guo'tai'guo'ji'ji'tuan'you'xian'gong'si	0
江苏华西集团公司	jiang'su'hua'xi'ji'tuan'gong'si	0
江苏金辉集团公司	jiang'su'jin'hui'ji'tuan'gong'si	0
江苏金浦集团有限公司	jiang'su'jin'pu'ji'tuan'you'xian'gong'si	0
江苏开元国际集团有限公司	jiang'su'kai'yuan'guo'ji'ji'tuan'you'xian'gong'si	0
江苏南通二建集团有限公司	jiang'su'nan'tong'er'jian'ji'tuan'you'xian'gong'si	0
江苏南通三建集团有限公司	jiang'su'nan'tong'san'jian'ji'tuan'you'xian'gong'si	0
江苏三房巷集团有限公司	jiang'su'san'fang'xiang'ji'tuan'you'xian'gong'si	0
江苏沙钢集团有限公司	jiang'su'sha'gang'ji'tuan'you'xian'gong'si	0
江苏申特钢铁有限公司	jiang'su'shen'te'gang'tie'you'xian'gong'si	0
江苏舜天国际集团有限公司	jiang'su'shun'tian'guo'ji'ji'tuan'you'xian'gong'si	0
江苏苏宁电器集团有限公司	jiang'su'su'ning'dian'qi'ji'tuan'you'xian'gong'si	0
江苏新长江实业集团有限公司	jiang'su'xin'chang'jiang'shi'ye'ji'tuan'you'xian'gong'si	0
江苏阳光集团有限公司	jiang'su'yang'guang'ji'tuan'you'xian'gong'si	0
江苏扬子江船业集团公司	jiang'su'yang'zi'jiang'chuan'ye'ji'tuan'gong'si	0
江苏雨润食品产业集团有限公司	jiang'su'yu'run'shi'pin'chan'ye'ji'tuan'you'xian'gong'si	0
江苏悦达集团有限公司	jiang'su'yue'da'ji'tuan'you'xian'gong'si	0
江西赛维太阳能高科技有限公司	jiang'xi'sai'wei'tai'yang'neng'gao'ke'ji'you'xian'gong'si	0
江西省冶金集团公司	jiang'xi'sheng'ye'jin'ji'tuan'gong'si	0
江西铜业集团公司	jiang'xi'tong'ye'ji'tuan'gong'si	0
江阴澄星实业集团有限公司	jiang'yin'cheng'xing'shi'ye'ji'tuan'you'xian'gong'si	0
江阴市西城钢铁有限公司	jiang'yin'shi'xi'cheng'gang'tie'you'xian'gong'si	0
交通银行股份有限公司	jiao'tong'yin'hang'gu'fen'you'xian'gong'si	0
金川集团有限公司	jin'chuan'ji'tuan'you'xian'gong'si	0
金东纸业江苏股份有限公司	jin'dong'zhi'ye'jiang'su'gu'fen'you'xian'gong'si	0
金龙精密铜管集团股份有限公司	jin'long'jing'mi'tong'guan'ji'tuan'gu'fen'you'xian'gong'si	0
金龙控股集团有限公司	jin'long'kong'gu'ji'tuan'you'xian'gong'si	0
晶龙实业集团有限公司	jing'long'shi'ye'ji'tuan'you'xian'gong'si	0
酒泉钢铁集团有限责任公司	jiu'quan'gang'tie'ji'tuan'you'xian'ze'ren'gong'si	0
九州通医药集团股份有限公司	jiu'zhou'tong'yi'yao'ji'tuan'gu'fen'you'xian'gong'si	0
巨化集团公司	ju'hua'ji'tuan'gong'si	0
开滦集团有限责任公司	kai'luan'ji'tuan'you'xian'ze'ren'gong'si	0
昆明钢铁控股有限公司	kun'ming'gang'tie'kong'gu'you'xian'gong'si	0
昆明铁路局	kun'ming'tie'lu'ju	0
兰州铁路局	lan'zhou'tie'lu'ju	0
乐金显示南京有限公司	le'jin'xian'shi'nan'jing'you'xian'gong'si	0
冷水江钢铁有限责任公司	leng'shui'jiang'gang'tie'you'xian'ze'ren'gong'si	0
力帆实业集团股份有限公司	li'fan'shi'ye'ji'tuan'gu'fen'you'xian'gong'si	0
利华益集团股份有限公司	li'hua'yi'ji'tuan'gu'fen'you'xian'gong'si	0
利群集团股份有限公司	li'qun'ji'tuan'gu'fen'you'xian'gong'si	0
联想控股有限公司	lian'xiang'kong'gu'you'xian'gong'si	0
辽宁忠旺集团有限公司	liao'ning'zhong'wang'ji'tuan'you'xian'gong'si	0
临沂新程金锣肉制品有限公司	lin'yi'xin'cheng'jin'luo'rou'zhi'pin'you'xian'gong'si	0
隆鑫控股有限公司	long'xin'kong'gu'you'xian'gong'si	0
洛阳新安电力集团有限公司	luo'yang'xin'an'dian'li'ji'tuan'you'xian'gong'si	0
马钢集团控股有限公司	ma'gang'ji'tuan'kong'gu'you'xian'gong'si	0
美的集团有限公司	mei'di'ji'tuan'you'xian'gong'si	0
美锦能源集团有限公司	mei'jin'neng'yuan'ji'tuan'you'xian'gong'si	0
摩托罗拉中国电子有限公司	mo'tuo'luo'la'zhong'guo'dian'zi'you'xian'gong'si	0
南昌长力钢铁股份有限公司	nan'chang'chang'li'gang'tie'gu'fen'you'xian'gong'si	0
南昌铁路局	nan'chang'tie'lu'ju	0
南金兆集团有限公司	nan'jin'zhao'ji'tuan'you'xian'gong'si	0
南京钢铁集团有限公司	nan'jing'gang'tie'ji'tuan'you'xian'gong'si	0
南京物资实业集团总公司	nan'jing'wu'zi'shi'ye'ji'tuan'zong'gong'si	0
南京医药产业集团有限责任公司	nan'jing'yi'yao'chan'ye'ji'tuan'you'xian'ze'ren'gong'si	0
南宁铁路局	nan'ning'tie'lu'ju	0
南山集团公司	nan'shan'ji'tuan'gong'si	0
内蒙古电力集团有限责任公司	nei'meng'gu'dian'li'ji'tuan'you'xian'ze'ren'gong'si	0
内蒙古伊泰集团有限公司	nei'meng'gu'yi'tai'ji'tuan'you'xian'gong'si	0
宁波富邦控股集团有限公司	ning'bo'fu'bang'kong'gu'ji'tuan'you'xian'gong'si	0
宁波金田投资控股有限公司	ning'bo'jin'tian'tou'zi'kong'gu'you'xian'gong'si	0
攀枝花钢铁集团公司	pan'zhi'hua'gang'tie'ji'tuan'gong'si	0
庞大汽贸集团股份有限公司	pang'da'qi'mao'ji'tuan'gu'fen'you'xian'gong'si	0
萍乡钢铁有限责任公司	ping'xiang'gang'tie'you'xian'ze'ren'gong'si	0
奇瑞汽车股份有限公司	qi'rui'qi'che'gu'fen'you'xian'gong'si	0
青岛钢铁控股集团有限责任公司	qing'dao'gang'tie'kong'gu'ji'tuan'you'xian'ze'ren'gong'si	0
青岛啤酒股份有限公司	qing'dao'pi'jiu'gu'fen'you'xian'gong'si	0
青建集团股份公司	qing'jian'ji'tuan'gu'fen'gong'si	0
群康科技深圳有限公司	qun'kang'ke'ji'shen'zhen'you'xian'gong'si	0
仁宝资讯工业昆山有限公司	ren'bao'zi'xun'gong'ye'kun'shan'you'xian'gong'si	0
人民电器集团上海有限公司	ren'min'dian'qi'ji'tuan'shang'hai'you'xian'gong'si	0
人民电器集团有限公司	ren'min'dian'qi'ji'tuan'you'xian'gong'si	0
日照钢铁控股集团有限公司	ri'zhao'gang'tie'kong'gu'ji'tuan'you'xian'gong'si	0
三胞集团有限公司	san'bao'ji'tuan'you'xian'gong'si	0
三河汇福粮油集团有限公司	san'he'hui'fu'liang'you'ji'tuan'you'xian'gong'si	0
三角集团有限公司	san'jiao'ji'tuan'you'xian'gong'si	0
三一集团有限公司	san'yi'ji'tuan'you'xian'gong'si	0
山东博汇集团有限公司	shan'dong'bo'hui'ji'tuan'you'xian'gong'si	0
山东晨鸣纸业集团股份有限公司	shan'dong'chen'ming'zhi'ye'ji'tuan'gu'fen'you'xian'gong'si	0
山东大王集团有限公司	shan'dong'da'wang'ji'tuan'you'xian'gong'si	0
山东东明石化集团有限公司	shan'dong'dong'ming'shi'hua'ji'tuan'you'xian'gong'si	0
山东钢铁集团有限公司	shan'dong'gang'tie'ji'tuan'you'xian'gong'si	0
山东高速集团有限公司	shan'dong'gao'su'ji'tuan'you'xian'gong'si	0
山东海化集团有限公司	shan'dong'hai'hua'ji'tuan'you'xian'gong'si	0
山东黄金集团有限公司	shan'dong'huang'jin'ji'tuan'you'xian'gong'si	0
山东金诚石化集团有限公司	shan'dong'jin'cheng'shi'hua'ji'tuan'you'xian'gong'si	0
山东科达集团有限公司	shan'dong'ke'da'ji'tuan'you'xian'gong'si	0
山东鲁北企业集团总公司	shan'dong'lu'bei'qi'ye'ji'tuan'zong'gong'si	0
山东企业	shan'dong'qi'ye	0
山东如意科技集团有限公司	shan'dong'ru'yi'ke'ji'ji'tuan'you'xian'gong'si	0
山东省农村信用社联合社	shan'dong'sheng'nong'cun'xin'yong'she'lian'he'she	0
山东省商业集团总公司	shan'dong'sheng'shang'ye'ji'tuan'zong'gong'si	0
山东时风集团有限责任公司	shan'dong'shi'feng'ji'tuan'you'xian'ze'ren'gong'si	0
山东石横特钢集团有限公司	shan'dong'shi'heng'te'gang'ji'tuan'you'xian'gong'si	0
山东泰山钢铁集团有限公司	shan'dong'tai'shan'gang'tie'ji'tuan'you'xian'gong'si	0
山东威海上互电器有限公司	shan'dong'wei'hai'shang'hu'dian'qi'you'xian'gong'si	0
山东魏桥创业集团有限公司	shan'dong'wei'qiao'chuang'ye'ji'tuan'you'xian'gong'si	0
山东招金集团有限公司	shan'dong'zhao'jin'ji'tuan'you'xian'gong'si	0
山东中烟工业公司	shan'dong'zhong'yan'gong'ye'gong'si	0
山东淄博傅山企业集团有限公司	shan'dong'zi'bo'fu'shan'qi'ye'ji'tuan'you'xian'gong'si	0
杉杉投资控股有限公司	shan'shan'tou'zi'kong'gu'you'xian'gong'si	0
陕西东岭工贸集团股份有限公司	shan'xi'dong'ling'gong'mao'ji'tuan'gu'fen'you'xian'gong'si	0
陕西建工集团总公司	shan'xi'jian'gong'ji'tuan'zong'gong'si	0
山西焦煤集团有限责任公司	shan'xi'jiao'mei'ji'tuan'you'xian'ze'ren'gong'si	0
陕西龙门钢铁集团有限责任公司	shan'xi'long'men'gang'tie'ji'tuan'you'xian'ze'ren'gong'si	0
山西潞安矿业集团有限责任公司	shan'xi'lu'an'kuang'ye'ji'tuan'you'xian'ze'ren'gong'si	0
山西煤炭进出口集团有限公司	shan'xi'mei'tan'jin'chu'kou'ji'tuan'you'xian'gong'si	0
山西煤炭运销集团有限公司	shan'xi'mei'tan'yun'xiao'ji'tuan'you'xian'gong'si	0
陕西煤业化工集团有限责任公司	shan'xi'mei'ye'hua'gong'ji'tuan'you'xian'ze'ren'gong'si	0
陕西汽车集团有限责任公司	shan'xi'qi'che'ji'tuan'you'xian'ze'ren'gong'si	0
陕西延长石油集团有限责任公司	shan'xi'yan'chang'shi'you'ji'tuan'you'xian'ze'ren'gong'si	0
尚德电力控股有限公司	shang'de'dian'li'kong'gu'you'xian'gong'si	0
上海宝临电气集团有限公司	shang'hai'bao'lin'dian'qi'ji'tuan'you'xian'gong'si	0
上海宝临防爆电器有限公司	shang'hai'bao'lin'fang'bao'dian'qi'you'xian'gong'si	0
上海城建集团公司	shang'hai'cheng'jian'ji'tuan'gong'si	0
上海电气集团总公司	shang'hai'dian'qi'ji'tuan'zong'gong'si	0
上海纺织控股集团公司	shang'hai'fang'zhi'kong'gu'ji'tuan'gong'si	0
上海复星高科技集团有限公司	shang'hai'fu'xing'gao'ke'ji'ji'tuan'you'xian'gong'si	0
上海国际港务集团股份有限公司	shang'hai'guo'ji'gang'wu'ji'tuan'gu'fen'you'xian'gong'si	0
上海航空股份有限公司	shang'hai'hang'kong'gu'fen'you'xian'gong'si	0
上海华谊集团公司	shang'hai'hua'yi'ji'tuan'gong'si	0
上海建工集团总公司	shang'hai'jian'gong'ji'tuan'zong'gong'si	0
上海良友集团有限公司	shang'hai'liang'you'ji'tuan'you'xian'gong'si	0
上海绿地集团有限公司	shang'hai'lv'di'ji'tuan'you'xian'gong'si	0
上海耐吉输配电设备有限公司	shang'hai'nai'ji'shu'pei'dian'she'bei'you'xian'gong'si	0
上海汽车工业集团总公司	shang'hai'qi'che'gong'ye'ji'tuan'zong'gong'si	0
上海企业	shang'hai'qi'ye	0
上海人民电器厂	shang'hai'ren'min'dian'qi'chang	0
上海人民企业集团	shang'hai'ren'min'qi'ye'ji'tuan	0
上海人民企业集团新疆公司	shang'hai'ren'min'qi'ye'ji'tuan'xin'jiang'gong'si	0
上海人民企业集团有限公司	shang'hai'ren'min'qi'ye'ji'tuan'you'xian'gong'si	0
上海如高电力设备有限公司	shang'hai'ru'gao'dian'li'she'bei'you'xian'gong'si	0
上海申工变压器有限公司	shang'hai'shen'gong'bian'ya'qi'you'xian'gong'si	0
上海胜华电缆厂有限公司	shang'hai'sheng'hua'dian'lan'chang'you'xian'gong'si	0
上海胜华电缆集团有限公司	shang'hai'sheng'hua'dian'lan'ji'tuan'you'xian'gong'si	0
上海世博集团有限公司	shang'hai'shi'bo'ji'tuan'you'xian'gong'si	0
上海铁路局	shang'hai'tie'lu'ju	0
上海外高桥造船有限公司	shang'hai'wai'gao'qiao'zao'chuan'you'xian'gong'si	0
上海烟草集团公司	shang'hai'yan'cao'ji'tuan'gong'si	0
上海一开电气集团有限公司	shang'hai'yi'kai'dian'qi'ji'tuan'you'xian'gong'si	0
上海医药集团有限公司	shang'hai'yi'yao'ji'tuan'you'xian'gong'si	0
神华集团有限责任公司	shen'hua'ji'tuan'you'xian'ze'ren'gong'si	0
申能集团有限公司	shen'neng'ji'tuan'you'xian'gong'si	0
沈阳机床集团有限责任公司	shen'yang'ji'chuang'ji'tuan'you'xian'ze'ren'gong'si	0
沈阳铁路局	shen'yang'tie'lu'ju	0
沈阳远大企业集团有限公司	shen'yang'yuan'da'qi'ye'ji'tuan'you'xian'gong'si	0
深圳创维电子有限公司	shen'zhen'chuang'wei'dian'zi'you'xian'gong'si	0
深圳发展银行	shen'zhen'fa'zhan'yin'hang	0
深圳航空有限责任公司	shen'zhen'hang'kong'you'xian'ze'ren'gong'si	0
深圳华强集团有限公司	shen'zhen'hua'qiang'ji'tuan'you'xian'gong'si	0
深圳能源集团股份有限公司	shen'zhen'neng'yuan'ji'tuan'gu'fen'you'xian'gong'si	0
深圳市天音通信发展有限公司	shen'zhen'shi'tian'yin'tong'xin'fa'zhan'you'xian'gong'si	0
盛虹集团有限公司	sheng'hong'ji'tuan'you'xian'gong'si	0
世纪金源投资集团有限公司	shi'ji'jin'yuan'tou'zi'ji'tuan'you'xian'gong'si	0
首钢总公司	shou'gang'zong'gong'si	0
双星集团有限责任公司	shuang'xing'ji'tuan'you'xian'ze'ren'gong'si	0
水城钢铁集团有限责任公司	shui'cheng'gang'tie'ji'tuan'you'xian'ze'ren'gong'si	0
四川长虹电子集团有限公司	si'chuan'chang'hong'dian'zi'ji'tuan'you'xian'gong'si	0
四川宏达集团有限公司	si'chuan'hong'da'ji'tuan'you'xian'gong'si	0
四川华西集团有限公司	si'chuan'hua'xi'ji'tuan'you'xian'gong'si	0
四川省川威集团有限公司	si'chuan'sheng'chuan'wei'ji'tuan'you'xian'gong'si	0
四川省宜宾五粮液集团有限公司	si'chuan'sheng'yi'bin'wu'liang'ye'ji'tuan'you'xian'gong'si	0
四平红嘴集团总公司	si'ping'hong'zui'ji'tuan'zong'gong'si	0
苏州创元投资发展集团有限公司	su'zhou'chuang'yuan'tou'zi'fa'zhan'ji'tuan'you'xian'gong'si	0
太极集团有限公司	tai'ji'ji'tuan'you'xian'gong'si	0
泰康人寿保险股份有限公司	tai'kang'ren'shou'bao'xian'gu'fen'you'xian'gong'si	0
太平人寿保险有限公司	tai'ping'ren'shou'bao'xian'you'xian'gong'si	0
太原钢铁集团有限公司	tai'yuan'gang'tie'ji'tuan'you'xian'gong'si	0
太原铁路局	tai'yuan'tie'lu'ju	0
唐山港陆钢铁有限公司	tang'shan'gang'lu'gang'tie'you'xian'gong'si	0
唐山国丰钢铁有限公司	tang'shan'guo'feng'gang'tie'you'xian'gong'si	0
唐山瑞丰钢铁集团有限公司	tang'shan'rui'feng'gang'tie'ji'tuan'you'xian'gong'si	0
特变电工股份有限公司	te'bian'dian'gong'gu'fen'you'xian'gong'si	0
天津百利机电控股集团有限公司	tian'jin'bai'li'ji'dian'kong'gu'ji'tuan'you'xian'gong'si	0
天津渤海化工集团公司	tian'jin'bo'hai'hua'gong'ji'tuan'gong'si	0
天津城建集团有限公司	tian'jin'cheng'jian'ji'tuan'you'xian'gong'si	0
天津纺织集团控股有限公司	tian'jin'fang'zhi'ji'tuan'kong'gu'you'xian'gong'si	0
天津钢管集团股份有限公司	tian'jin'gang'guan'ji'tuan'gu'fen'you'xian'gong'si	0
天津港集团有限公司	tian'jin'gang'ji'tuan'you'xian'gong'si	0
天津汽车工业集团有限公司	tian'jin'qi'che'gong'ye'ji'tuan'you'xian'gong'si	0
天津荣程联合钢铁集团有限公司	tian'jin'rong'cheng'lian'he'gang'tie'ji'tuan'you'xian'gong'si	0
天津三星电子显示器有限公司	tian'jin'san'xing'dian'zi'xian'shi'qi'you'xian'gong'si	0
天津三星通信技术有限公司	tian'jin'san'xing'tong'xin'ji'shu'you'xian'gong'si	0
天津市二轻集团控股有限公司	tian'jin'shi'er'qing'ji'tuan'kong'gu'you'xian'gong'si	0
天津市津能投资公司	tian'jin'shi'jin'neng'tou'zi'gong'si	0
天津市物资集团总公司	tian'jin'shi'wu'zi'ji'tuan'zong'gong'si	0
天津市一轻集团控股有限公司	tian'jin'shi'yi'qing'ji'tuan'kong'gu'you'xian'gong'si	0
天津市医药集团有限公司	tian'jin'shi'yi'yao'ji'tuan'you'xian'gong'si	0
天津天钢集团有限公司	tian'jin'tian'gang'ji'tuan'you'xian'gong'si	0
天津天狮集团有限公司	tian'jin'tian'shi'ji'tuan'you'xian'gong'si	0
天津天铁冶金集团有限公司	tian'jin'tian'tie'ye'jin'ji'tuan'you'xian'gong'si	0
天津冶金集团有限公司	tian'jin'ye'jin'ji'tuan'you'xian'gong'si	0
天津一商集团有限公司	tian'jin'yi'shang'ji'tuan'you'xian'gong'si	0
天津友发钢管集团有限公司	tian'jin'you'fa'gang'guan'ji'tuan'you'xian'gong'si	0
天正集团有限公司	tian'zheng'ji'tuan'you'xian'gong'si	0
铁法煤业集团有限责任公司	tie'fa'mei'ye'ji'tuan'you'xian'ze'ren'gong'si	0
同方股份有限公司	tong'fang'gu'fen'you'xian'gong'si	0
通化钢铁集团股份有限公司	tong'hua'gang'tie'ji'tuan'gu'fen'you'xian'gong'si	0
桐昆集团股份有限公司	tong'kun'ji'tuan'gu'fen'you'xian'gong'si	0
铜陵有色金属集团控股有限公司	tong'ling'you'se'jin'shu'ji'tuan'kong'gu'you'xian'gong'si	0
通威集团有限公司	tong'wei'ji'tuan'you'xian'gong'si	0
万达控股集团有限公司	wan'da'kong'gu'ji'tuan'you'xian'gong'si	0
万科企业股份有限公司	wan'ke'qi'ye'gu'fen'you'xian'gong'si	0
万向集团公司	wan'xiang'ji'tuan'gong'si	0
潍柴控股集团有限公司	wei'chai'kong'gu'ji'tuan'you'xian'gong'si	0
维维集团股份有限公司	wei'wei'ji'tuan'gu'fen'you'xian'gong'si	0
武汉钢铁集团公司	wu'han'gang'tie'ji'tuan'gong'si	0
武汉铁路局	wu'han'tie'lu'ju	0
武汉武商集团股份有限公司	wu'han'wu'shang'ji'tuan'gu'fen'you'xian'gong'si	0
武汉中百集团股份有限公司	wu'han'zhong'bai'ji'tuan'gu'fen'you'xian'gong'si	0
乌鲁木齐明园物业管理中心	wu'lu'mu'qi'ming'yuan'wu'ye'guan'li'zhong'xin	0
物美控股集团有限公司	wu'mei'kong'gu'ji'tuan'you'xian'gong'si	0
无锡产业发展集团有限公司	wu'xi'chan'ye'fa'zhan'ji'tuan'you'xian'gong'si	0
无锡威孚高科技股份有限公司	wu'xi'wei'fu'gao'ke'ji'gu'fen'you'xian'gong'si	0
西安电力机械制造公司	xi'an'dian'li'ji'xie'zhi'zao'gong'si	0
西安铁路局	xi'an'tie'lu'ju	0
西部矿业集团有限公司	xi'bu'kuang'ye'ji'tuan'you'xian'gong'si	0
西王集团有限公司	xi'wang'ji'tuan'you'xian'gong'si	0
西子联合控股有限公司	xi'zi'lian'he'kong'gu'you'xian'gong'si	0
厦门国贸集团股份有限公司	xia'men'guo'mao'ji'tuan'gu'fen'you'xian'gong'si	0
厦门机电集团有限公司	xia'men'ji'dian'ji'tuan'you'xian'gong'si	0
厦门建发集团有限公司	xia'men'jian'fa'ji'tuan'you'xian'gong'si	0
厦门象屿集团有限公司	xia'men'xiang'yu'ji'tuan'you'xian'gong'si	0
新华锦集团	xin'hua'jin'ji'tuan	0
新华联合冶金投资集团有限公司	xin'hua'lian'he'ye'jin'tou'zi'ji'tuan'you'xian'gong'si	0
新华联控股有限公司	xin'hua'lian'kong'gu'you'xian'gong'si	0
新华人寿保险股份有限公司	xin'hua'ren'shou'bao'xian'gu'fen'you'xian'gong'si	0
新疆宏泰矿业股份有限公司	xin'jiang'hong'tai'kuang'ye'gu'fen'you'xian'gong'si	0
新疆宏泰矿业有限责任公司	xin'jiang'hong'tai'kuang'ye'you'xian'ze'ren'gong'si	0
新疆金宝矿业有限公司	xin'jiang'jin'bao'kuang'ye'you'xian'gong'si	0
新疆金宝矿业有限责任公司	xin'jiang'jin'bao'kuang'ye'you'xian'ze'ren'gong'si	0
新疆金龙电气成套设备有限公司	xin'jiang'jin'long'dian'qi'cheng'tao'she'bei'you'xian'gong'si	0
新疆企业	xin'jiang'qi'ye	0
新疆石油工程建设有限责任公司	xin'jiang'shi'you'gong'cheng'jian'she'you'xian'ze'ren'gong'si	0
新疆维吾尔自治区石油管理局	xin'jiang'wei'wu'er'zi'zhi'qu'shi'you'guan'li'ju	0
新疆销售分公司	xin'jiang'xiao'shou'fen'gong'si	0
新疆新华能开关有限公司	xin'jiang'xin'hua'neng'kai'guan'you'xian'gong'si	0
新疆新能物资集团有限责任公司	xin'jiang'xin'neng'wu'zi'ji'tuan'you'xian'ze'ren'gong'si	0
新疆耀然电力成套设备有限公司	xin'jiang'yao'ran'dian'li'cheng'tao'she'bei'you'xian'gong'si	0
新疆油建国际公司	xin'jiang'you'jian'guo'ji'gong'si	0
新疆有限公司	xin'jiang'you'xian'gong'si	0
新汶矿业集团有限责任公司	xin'wen'kuang'ye'ji'tuan'you'xian'ze'ren'gong'si	0
新希望集团有限公司	xin'xi'wang'ji'tuan'you'xian'gong'si	0
新兴铸管集团有限公司	xin'xing'zhu'guan'ji'tuan'you'xian'gong'si	0
新余钢铁有限责任公司	xin'yu'gang'tie'you'xian'ze'ren'gong'si	0
邢台钢铁有限责任公司	xing'tai'gang'tie'you'xian'ze'ren'gong'si	0
兴业银行股份有限公司	xing'ye'yin'hang'gu'fen'you'xian'gong'si	0
旭阳煤化工集团有限公司	xu'yang'mei'hua'gong'ji'tuan'you'xian'gong'si	0
徐州工程机械集团有限公司	xu'zhou'gong'cheng'ji'xie'ji'tuan'you'xian'gong'si	0
徐州矿务集团有限公司	xu'zhou'kuang'wu'ji'tuan'you'xian'gong'si	0
亚邦化工集团有限公司	ya'bang'hua'gong'ji'tuan'you'xian'gong'si	0
雅戈尔集团股份有限公司	ya'ge'er'ji'tuan'gu'fen'you'xian'gong'si	0
兖矿集团有限公司	yan'kuang'ji'tuan'you'xian'gong'si	0
阳泉煤业集团有限责任公司	yang'quan'mei'ye'ji'tuan'you'xian'ze'ren'gong'si	0
扬子江药业集团有限公司	yang'zi'jiang'yao'ye'ji'tuan'you'xian'gong'si	0
益海嘉里投资有限公司	yi'hai'jia'li'tou'zi'you'xian'gong'si	0
义马煤业集团股份有限公司	yi'ma'mei'ye'ji'tuan'gu'fen'you'xian'gong'si	0
远东控股集团有限公司	yuan'dong'kong'gu'ji'tuan'you'xian'gong'si	0
乐清市新特电工变压器有限公司	yue'qing'shi'xin'te'dian'gong'bian'ya'qi'you'xian'gong'si	0
云南建工集团总公司	yun'nan'jian'gong'ji'tuan'zong'gong'si	0
云南煤化工集团有限公司	yun'nan'mei'hua'gong'ji'tuan'you'xian'gong'si	0
云南锡业集团控股有限责任公司	yun'nan'xi'ye'ji'tuan'kong'gu'you'xian'ze'ren'gong'si	0
云南冶金集团股份有限公司	yun'nan'ye'jin'ji'tuan'gu'fen'you'xian'gong'si	0
云天化集团有限责任公司	yun'tian'hua'ji'tuan'you'xian'ze'ren'gong'si	0
枣庄矿业集团有限责任公司	zao'zhuang'kuang'ye'ji'tuan'you'xian'ze'ren'gong'si	0
招商银行股份有限公司	zhao'shang'yin'hang'gu'fen'you'xian'gong'si	0
浙江宝业建设集团有限公司	zhe'jiang'bao'ye'jian'she'ji'tuan'you'xian'gong'si	0
浙江恒逸集团有限公司	zhe'jiang'heng'yi'ji'tuan'you'xian'gong'si	0
浙江吉利控股集团有限公司	zhe'jiang'ji'li'kong'gu'ji'tuan'you'xian'gong'si	0
浙江企业	zhe'jiang'qi'ye	0
浙江荣盛控股集团有限公司	zhe'jiang'rong'sheng'kong'gu'ji'tuan'you'xian'gong'si	0
浙江申工变压器制造有限公司	zhe'jiang'shen'gong'bian'ya'qi'zhi'zao'you'xian'gong'si	0
浙江省国际贸易集团有限公司	zhe'jiang'sheng'guo'ji'mao'yi'ji'tuan'you'xian'gong'si	0
浙江省建设投资集团有限公司	zhe'jiang'sheng'jian'she'tou'zi'ji'tuan'you'xian'gong'si	0
浙江省交通投资集团有限公司	zhe'jiang'sheng'jiao'tong'tou'zi'ji'tuan'you'xian'gong'si	0
浙江省能源集团有限公司	zhe'jiang'sheng'neng'yuan'ji'tuan'you'xian'gong'si	0
浙江省商业集团有限公司	zhe'jiang'sheng'shang'ye'ji'tuan'you'xian'gong'si	0
浙江省物产集团公司	zhe'jiang'sheng'wu'chan'ji'tuan'gong'si	0
浙江省兴合集团公司	zhe'jiang'sheng'xing'he'ji'tuan'gong'si	0
浙江新航电气有限公司	zhe'jiang'xin'hang'dian'qi'you'xian'gong'si	0
浙江星鑫防爆电器有限公司	zhe'jiang'xing'xin'fang'bao'dian'qi'you'xian'gong'si	0
浙江远大进出口有限公司	zhe'jiang'yuan'da'jin'chu'kou'you'xian'gong'si	0
浙江正泰电器股份有限公司	zhe'jiang'zheng'tai'dian'qi'gu'fen'you'xian'gong'si	0
浙江中成控股集团有限公司	zhe'jiang'zhong'cheng'kong'gu'ji'tuan'you'xian'gong'si	0
浙江中烟工业有限责任公司	zhe'jiang'zhong'yan'gong'ye'you'xian'ze'ren'gong'si	0
正泰电气股份有限公司	zheng'tai'dian'qi'gu'fen'you'xian'gong'si	0
正太集团有限公司	zheng'tai'ji'tuan'you'xian'gong'si	0
正泰集团有限公司	zheng'tai'ji'tuan'you'xian'gong'si	0
正威国际集团有限公司	zheng'wei'guo'ji'ji'tuan'you'xian'gong'si	0
郑州煤炭工业集团有限责任公司	zheng'zhou'mei'tan'gong'ye'ji'tuan'you'xian'ze'ren'gong'si	0
郑州铁路局	zheng'zhou'tie'lu'ju	0
郑州宇通集团有限公司	zheng'zhou'yu'tong'ji'tuan'you'xian'gong'si	0
中储发展股份有限公司	zhong'chu'fa'zhan'gu'fen'you'xian'gong'si	0
中国北方机车车辆工业集团公司	zhong'guo'bei'fang'ji'che'che'liang'gong'ye'ji'tuan'gong'si	0
中国兵器装备集团公司	zhong'guo'bing'qi'zhuang'bei'ji'tuan'gong'si	0
中国长江三峡工程开发总公司	zhong'guo'chang'jiang'san'xia'gong'cheng'kai'fa'zong'gong'si	0
中国诚通控股集团有限公司	zhong'guo'cheng'tong'kong'gu'ji'tuan'you'xian'gong'si	0
中国船舶重工集团公司	zhong'guo'chuan'bo'zhong'gong'ji'tuan'gong'si	0
中国大唐集团公司	zhong'guo'da'tang'ji'tuan'gong'si	0
中国第一汽车集团公司	zhong'guo'di'yi'qi'che'ji'tuan'gong'si	0
中国电力投资集团公司	zhong'guo'dian'li'tou'zi'ji'tuan'gong'si	0
中国电信集团公司	zhong'guo'dian'xin'ji'tuan'gong'si	0
中国电子信息产业集团公司	zhong'guo'dian'zi'xin'xi'chan'ye'ji'tuan'gong'si	0
中国东方电气集团有限公司	zhong'guo'dong'fang'dian'qi'ji'tuan'you'xian'gong'si	0
中国东方航空股份有限公司	zhong'guo'dong'fang'hang'kong'gu'fen'you'xian'gong'si	0
中国港中旅集团公司	zhong'guo'gang'zhong'lv'ji'tuan'gong'si	0
中国葛洲坝集团公司	zhong'guo'ge'zhou'ba'ji'tuan'gong'si	0
中国工商银行股份有限公司	zhong'guo'gong'shang'yin'hang'gu'fen'you'xian'gong'si	0
中国广东核电集团有限公司	zhong'guo'guang'dong'he'dian'ji'tuan'you'xian'gong'si	0
中国贵州茅台酒厂有限责任公司	zhong'guo'gui'zhou'mao'tai'jiu'chang'you'xian'ze'ren'gong'si	0
中国国电集团公司	zhong'guo'guo'dian'ji'tuan'gong'si	0
中国国际技术智力合作公司	zhong'guo'guo'ji'ji'shu'zhi'li'he'zuo'gong'si	0
中国海洋石油总公司	zhong'guo'hai'yang'shi'you'zong'gong'si	0
中国海运集团总公司	zhong'guo'hai'yun'ji'tuan'zong'gong'si	0
中国航空工业集团公司	zhong'guo'hang'kong'gong'ye'ji'tuan'gong'si	0
中国航空集团公司	zhong'guo'hang'kong'ji'tuan'gong'si	0
中国航空油料集团公司	zhong'guo'hang'kong'you'liao'ji'tuan'gong'si	0
中国航天科工集团公司	zhong'guo'hang'tian'ke'gong'ji'tuan'gong'si	0
中国核工业集团公司	zhong'guo'he'gong'ye'ji'tuan'gong'si	0
中国恒天集团有限公司	zhong'guo'heng'tian'ji'tuan'you'xian'gong'si	0
中国华电集团公司	zhong'guo'hua'dian'ji'tuan'gong'si	0
中国化工集团公司	zhong'guo'hua'gong'ji'tuan'gong'si	0
中国华能集团公司	zhong'guo'hua'neng'ji'tuan'gong'si	0
中国黄金集团公司	zhong'guo'huang'jin'ji'tuan'gong'si	0
中国机械工业集团有限公司	zhong'guo'ji'xie'gong'ye'ji'tuan'you'xian'gong'si	0
中国建设银行股份有限公司	zhong'guo'jian'she'yin'hang'gu'fen'you'xian'gong'si	0
中国建筑材料集团公司	zhong'guo'jian'zhu'cai'liao'ji'tuan'gong'si	0
中国建筑工程总公司	zhong'guo'jian'zhu'gong'cheng'zong'gong'si	0
中国交通建设集团有限公司	zhong'guo'jiao'tong'jian'she'ji'tuan'you'xian'gong'si	0
中国联合网络通信集团有限公司	zhong'guo'lian'he'wang'luo'tong'xin'ji'tuan'you'xian'gong'si	0
中国铝业公司	zhong'guo'lv'ye'gong'si	0
中国煤炭科工集团有限公司	zhong'guo'mei'tan'ke'gong'ji'tuan'you'xian'gong'si	0
中国民生银行股份有限公司	zhong'guo'min'sheng'yin'hang'gu'fen'you'xian'gong'si	0
中国南方电网有限责任公司	zhong'guo'nan'fang'dian'wang'you'xian'ze'ren'gong'si	0
中国南方航空集团公司	zhong'guo'nan'fang'hang'kong'ji'tuan'gong'si	0
中国南方机车车辆工业集团公司	zhong'guo'nan'fang'ji'che'che'liang'gong'ye'ji'tuan'gong'si	0
中国农业生产资料集团公司	zhong'guo'nong'ye'sheng'chan'zi'liao'ji'tuan'gong'si	0
中国农业银行股份有限公司	zhong'guo'nong'ye'yin'hang'gu'fen'you'xian'gong'si	0
中国平安保险集团股份有限公司	zhong'guo'ping'an'bao'xian'ji'tuan'gu'fen'you'xian'gong'si	0
中国人民保险集团公司	zhong'guo'ren'min'bao'xian'ji'tuan'gong'si	0
中国人寿保险集团公司	zhong'guo'ren'shou'bao'xian'ji'tuan'gong'si	0
中国石油化工集团公司	zhong'guo'shi'you'hua'gong'ji'tuan'gong'si	0
中国石油天然气集团公司	zhong'guo'shi'you'tian'ran'qi'ji'tuan'gong'si	0
中国石油天然气运输公司	zhong'guo'shi'you'tian'ran'qi'yun'shu'gong'si	0
中国水利水电建设集团公司	zhong'guo'shui'li'shui'dian'jian'she'ji'tuan'gong'si	0
中国铁建股份有限公司	zhong'guo'tie'jian'gu'fen'you'xian'gong'si	0
中国铁路物资总公司	zhong'guo'tie'lu'wu'zi'zong'gong'si	0
中国外运长航集团有限公司	zhong'guo'wai'yun'chang'hang'ji'tuan'you'xian'gong'si	0
中国五百强企业	zhong'guo'wu'bai'qiang'qi'ye	0
中国五矿集团公司	zhong'guo'wu'kuang'ji'tuan'gong'si	0
中国盐业总公司	zhong'guo'yan'ye'zong'gong'si	0
中国冶金科工集团公司	zhong'guo'ye'jin'ke'gong'ji'tuan'gong'si	0
中国移动通信集团公司	zhong'guo'yi'dong'tong'xin'ji'tuan'gong'si	0
中国医药集团总公司	zhong'guo'yi'yao'ji'tuan'zong'gong'si	0
中国银行股份有限公司	zhong'guo'yin'hang'gu'fen'you'xian'gong'si	0
中国有色矿业集团有限公司	zhong'guo'you'se'kuang'ye'ji'tuan'you'xian'gong'si	0
中国邮政集团公司	zhong'guo'you'zheng'ji'tuan'gong'si	0
中国远洋运输集团总公司	zhong'guo'yuan'yang'yun'shu'ji'tuan'zong'gong'si	0
中国中材集团公司	zhong'guo'zhong'cai'ji'tuan'gong'si	0
中国中纺集团公司	zhong'guo'zhong'fang'ji'tuan'gong'si	0
中国中钢集团公司	zhong'guo'zhong'gang'ji'tuan'gong'si	0
中国中化集团公司	zhong'guo'zhong'hua'ji'tuan'gong'si	0
中国中煤能源集团有限公司	zhong'guo'zhong'mei'neng'yuan'ji'tuan'you'xian'gong'si	0
中国中铁股份有限公司	zhong'guo'zhong'tie'gu'fen'you'xian'gong'si	0
中国中信集团公司	zhong'guo'zhong'xin'ji'tuan'gong'si	0
中国重型汽车集团有限公司	zhong'guo'zhong'xing'qi'che'ji'tuan'you'xian'gong'si	0
中粮集团有限公司	zhong'liang'ji'tuan'you'xian'gong'si	0
中天发展控股集团有限公司	zhong'tian'fa'zhan'kong'gu'ji'tuan'you'xian'gong'si	0
中天钢铁集团有限公司	zhong'tian'gang'tie'ji'tuan'you'xian'gong'si	0
中兴通讯股份有限公司	zhong'xing'tong'xun'gu'fen'you'xian'gong'si	0
珠海格力电器股份有限公司	zhu'hai'ge'li'dian'qi'gu'fen'you'xian'gong'si	0
珠海振戎公司	zhu'hai'zhen'rong'gong'si	0
淄博矿业集团有限责任公司	zi'bo'kuang'ye'ji'tuan'you'xian'ze'ren'gong'si	0
紫金矿业集团股份有限公司	zi'jin'kuang'ye'ji'tuan'gu'fen'you'xian'gong'si	0
宗申产业集团有限公司	zong'shen'chan'ye'ji'tuan'you'xian'gong'si	0
