埃里克森的人格发遽理论	ai'li'ke'sen'de'ren'ge'fa'ju'li'lun	0
艾萨克斯的自我发展理论	ai'sa'ke'si'de'zi'wo'fa'zhan'li'lun	0
艾森克的人格理论	ai'sen'ke'de'ren'ge'li'lun	0
奥尔波特的人格理论	ao'er'bo'te'de'ren'ge'li'lun	0
巴甫洛夫的气质类型学说	ba'fu'luo'fu'de'qi'zhi'lei'xing'xue'shuo	0
巴甫洛夫的情绪理论	ba'fu'luo'fu'de'qing'xu'li'lun	0
被动攻击性人格	bei'dong'gong'ji'xing'ren'ge	0
边缘性人格	bian'yuan'xing'ren'ge	0
独立人格	du'li'ren'ge	0
多重人格	duo'chong'ren'ge	0
多拉德和米勒的人格理论	duo'la'de'he'mi'le'de'ren'ge'li'lun	0
反社会人格	fan'she'hui'ren'ge	0
防御机制	fang'yu'ji'zhi	0
非指导性精神分析	fei'zhi'dao'xing'jing'shen'fen'xi	0
非遵奉人格	fei'zun'feng'ren'ge	0
分裂型人格	fen'lie'xing'ren'ge	0
分析心理学	fen'xi'xin'li'xue	0
冯特的情感三度说	feng'te'de'qing'gan'san'du'shuo	0
弗洛伊德的人格理论	fu'luo'yi'de'de'ren'ge'li'lun	0
个人构念理论	ge'ren'gou'nian'li'lun	0
个体心理学	ge'ti'xin'li'xue	0
环性人格	huan'xing'ren'ge	0
回避型人格	hui'bi'xing'ren'ge	0
霍妮的理论	huo'ni'de'li'lun	0
积贮格栅技术	ji'zhu'ge'shan'ji'shu	0
健康人格	jian'kang'ren'ge	0
紧张与人格	jin'zhang'yu'ren'ge	0
精神分裂样人格	jing'shen'fen'lie'yang'ren'ge	0
精神分析的自我发展理论	jing'shen'fen'xi'de'zi'wo'fa'zhan'li'lun	0
精神宣泄	jing'shen'xuan'xie	0
精神综合	jing'shen'zong'he	0
卡特尔的人格理论	ka'te'er'de'ren'ge'li'lun	0
卡特尔人格因素问卷	ka'te'er'ren'ge'yin'su'wen'juan	0
坎农巴德的情绪理论	kan'nong'ba'de'de'qing'xu'li'lun	0
里比多	li'bi'duo	0
两性现象	liang'xing'xian'xiang	0
列昂捷夫的活动意识和个性理论	lie'ang'jie'fu'de'huo'dong'yi'shi'he'ge'xing'li'lun	0
卢文格的自我发展理论	lu'wen'ge'de'zi'wo'fa'zhan'li'lun	0
罗杰斯的人格理论	luo'jie'si'de'ren'ge'li'lun	0
罗森茨韦格图片挫折研究	luo'sen'ci'wei'ge'tu'pian'cuo'zhe'yan'jiu	0
马斯洛的人格理论	ma'si'luo'de'ren'ge'li'lun	0
迈尔斯布里格斯类型指标	mai'er'si'bu'li'ge'si'lei'xing'zhi'biao	0
米尔林学派的神经类型说	mi'er'lin'xue'pai'de'shen'jing'lei'xing'shuo	0
民族特性	min'zu'te'xing	0
默里的需要压力理论	mo'li'de'xu'yao'ya'li'li'lun	0
能和外能	neng'he'wai'neng	0
帕克的自我发展理论	pa'ke'de'zi'wo'fa'zhan'li'lun	0
偏执性人格	pian'zhi'xing'ren'ge	0
气候与个性	qi'hou'yu'ge'xing	0
气质	qi'zhi	0
气质的实验判定法	qi'zhi'de'shi'yan'pan'ding'fa	0
气质定位	qi'zhi'ding'wei	0
气质调节理论	qi'zhi'tiao'jie'li'lun	0
气质与人格	qi'zhi'yu'ren'ge	0
前精神分析的自我发展理论	qian'jing'shen'fen'xi'de'zi'wo'fa'zhan'li'lun	0
迁怒	qian'nu	0
强迫性人格	qiang'po'xing'ren'ge	0
去个性化	qu'ge'xing'hua	0
权威人格	quan'wei'ren'ge	0
人格变化	ren'ge'bian'hua	0
人格的层次	ren'ge'de'ceng'ci	0
人格调查表	ren'ge'diao'cha'biao	0
人格发展释义	ren'ge'fa'zhan'shi'yi	0
人格解体	ren'ge'jie'ti	0
人格类型	ren'ge'lei'xing	0
人格理论	ren'ge'li'lun	0
人格面具	ren'ge'mian'ju	0
人格评价	ren'ge'ping'jia	0
人格特质	ren'ge'te'zhi	0
人格与疾病	ren'ge'yu'ji'bing	0
人格与职业兴趣	ren'ge'yu'zhi'ye'xing'qu	0
人格障碍	ren'ge'zhang'ai	0
人格整全	ren'ge'zheng'quan	0
塞尔门的自我发展理论	sai'er'men'de'zi'wo'fa'zhan'li'lun	0
沙利文的人际理论	sha'li'wen'de'ren'ji'li'lun	0
沙利文的自我发展理论	sha'li'wen'de'zi'wo'fa'zhan'li'lun	0
身体意象	shen'ti'yi'xiang	0
生活风格	sheng'huo'feng'ge	0
斯金纳的人格理论	si'jin'na'de'ren'ge'li'lun	0
私人文献档案	si'ren'wen'xian'dang'an	0
逃避自由	tao'bi'zi'you	0
特质理论	te'zhi'li'lun	0
体型	ti'xing	0
同一性危机	tong'yi'xing'wei'ji	0
同一性形成	tong'yi'xing'xing'cheng	0
外倾性和内倾性	wai'qing'xing'he'nei'qing'xing	0
未成熟人格	wei'cheng'shu'ren'ge	0
无意识动机	wu'yi'shi'dong'ji	0
戏剧人格	xi'ju'ren'ge	0
新巴甫洛夫神经类型说	xin'ba'fu'luo'fu'shen'jing'lei'xing'shuo	0
新精神分析的自我发展理论	xin'jing'shen'fen'xi'de'zi'wo'fa'zhan'li'lun	0
型人格	xing'ren'ge	0
依赖性人格	yi'lai'xing'ren'ge	0
移情	yi'qing	0
因素分析人格问卷	yin'su'fen'xi'ren'ge'wen'juan	0
应激	ying'ji	0
诱因	you'yin	0
躁狂抑郁性人格	zao'kuang'yi'yu'xing'ren'ge	0
詹姆斯兰格情绪理论	zhan'mu'si'lan'ge'qing'xu'li'lun	0
自卑感	zi'bei'gan	0
自卑与超越	zi'bei'yu'chao'yue	0
自恋人格	zi'lian'ren'ge	0
自我动机	zi'wo'dong'ji	0
自我发展的序列说和类型说	zi'wo'fa'zhan'de'xu'lie'shuo'he'lei'xing'shuo	0
自我概念	zi'wo'gai'nian	0
自我镜像观念	zi'wo'jing'xiang'guan'nian	0
自我控制	zi'wo'kong'zhi	0
自我评价	zi'wo'ping'jia	0
最佳作用	zui'jia'zuo'yong	0
遵奉人格	zun'feng'ren'ge	0
