鞍山公务员成绩查询	an'shan'gong'wu'yuan'cheng'ji'cha'xun	0
鞍山公务员结构化面试	an'shan'gong'wu'yuan'jie'gou'hua'mian'shi	0
鞍山公务员考试成绩	an'shan'gong'wu'yuan'kao'shi'cheng'ji	0
鞍山公务员考试面试	an'shan'gong'wu'yuan'kao'shi'mian'shi	0
鞍山公务员考试面试班	an'shan'gong'wu'yuan'kao'shi'mian'shi'ban	0
鞍山公务员考试名单	an'shan'gong'wu'yuan'kao'shi'ming'dan	0
鞍山公务员科信教育	an'shan'gong'wu'yuan'ke'xin'jiao'yu	0
鞍山公务员面试	an'shan'gong'wu'yuan'mian'shi	0
鞍山公务员面试班	an'shan'gong'wu'yuan'mian'shi'ban	0
鞍山公务员面试辅导	an'shan'gong'wu'yuan'mian'shi'fu'dao	0
鞍山公务员面试辅导班	an'shan'gong'wu'yuan'mian'shi'fu'dao'ban	0
鞍山公务员面试考试	an'shan'gong'wu'yuan'mian'shi'kao'shi	0
鞍山公务员面试名单	an'shan'gong'wu'yuan'mian'shi'ming'dan	0
鞍山公务员面试培训	an'shan'gong'wu'yuan'mian'shi'pei'xun	0
鞍山公务员面试培训班	an'shan'gong'wu'yuan'mian'shi'pei'xun'ban	0
鞍山公务员面试资格	an'shan'gong'wu'yuan'mian'shi'zi'ge	0
鞍山公务员招录面试	an'shan'gong'wu'yuan'zhao'lu'mian'shi	0
鞍山面试资格审查时间	an'shan'mian'shi'zi'ge'shen'cha'shi'jian	0
鞍山人力资源局	an'shan'ren'li'zi'yuan'ju	0
鞍山人力资源网	an'shan'ren'li'zi'yuan'wang	0
鞍山人事考试网	an'shan'ren'shi'kao'shi'wang	0
鞍山省考面试班	an'shan'sheng'kao'mian'shi'ban	0
鞍山省考面试辅导	an'shan'sheng'kao'mian'shi'fu'dao	0
鞍山省考面试辅导班	an'shan'sheng'kao'mian'shi'fu'dao'ban	0
鞍山省考面试培训	an'shan'sheng'kao'mian'shi'pei'xun	0
鞍山省考面试培训班	an'shan'sheng'kao'mian'shi'pei'xun'ban	0
鞍山市公务员考试面试	an'shan'shi'gong'wu'yuan'kao'shi'mian'shi	0
鞍山市公务员面试	an'shan'shi'gong'wu'yuan'mian'shi	0
鞍山市公务员面试班	an'shan'shi'gong'wu'yuan'mian'shi'ban	0
鞍山市公务员面试考试	an'shan'shi'gong'wu'yuan'mian'shi'kao'shi	0
鞍山市公务员招录面试	an'shan'shi'gong'wu'yuan'zhao'lu'mian'shi	0
鞍山市人力资源局	an'shan'shi'ren'li'zi'yuan'ju	0
本溪公务员成绩查询	ben'xi'gong'wu'yuan'cheng'ji'cha'xun	0
本溪公务员结构化面试	ben'xi'gong'wu'yuan'jie'gou'hua'mian'shi	0
本溪公务员考试成绩	ben'xi'gong'wu'yuan'kao'shi'cheng'ji	0
本溪公务员考试面试	ben'xi'gong'wu'yuan'kao'shi'mian'shi	0
本溪公务员考试面试班	ben'xi'gong'wu'yuan'kao'shi'mian'shi'ban	0
本溪公务员考试名单	ben'xi'gong'wu'yuan'kao'shi'ming'dan	0
本溪公务员科信教育	ben'xi'gong'wu'yuan'ke'xin'jiao'yu	0
本溪公务员面试	ben'xi'gong'wu'yuan'mian'shi	0
本溪公务员面试班	ben'xi'gong'wu'yuan'mian'shi'ban	0
本溪公务员面试辅导	ben'xi'gong'wu'yuan'mian'shi'fu'dao	0
本溪公务员面试辅导班	ben'xi'gong'wu'yuan'mian'shi'fu'dao'ban	0
本溪公务员面试考试	ben'xi'gong'wu'yuan'mian'shi'kao'shi	0
本溪公务员面试名单	ben'xi'gong'wu'yuan'mian'shi'ming'dan	0
本溪公务员面试培训	ben'xi'gong'wu'yuan'mian'shi'pei'xun	0
本溪公务员面试培训班	ben'xi'gong'wu'yuan'mian'shi'pei'xun'ban	0
本溪公务员面试资格	ben'xi'gong'wu'yuan'mian'shi'zi'ge	0
本溪公务员招录面试	ben'xi'gong'wu'yuan'zhao'lu'mian'shi	0
本溪人才网	ben'xi'ren'cai'wang	0
本溪人力资源局	ben'xi'ren'li'zi'yuan'ju	0
本溪人力资源网	ben'xi'ren'li'zi'yuan'wang	0
本溪人事考试网	ben'xi'ren'shi'kao'shi'wang	0
本溪省考面试班	ben'xi'sheng'kao'mian'shi'ban	0
本溪省考面试辅导	ben'xi'sheng'kao'mian'shi'fu'dao	0
本溪省考面试辅导班	ben'xi'sheng'kao'mian'shi'fu'dao'ban	0
本溪省考面试培训	ben'xi'sheng'kao'mian'shi'pei'xun	0
本溪省考面试培训班	ben'xi'sheng'kao'mian'shi'pei'xun'ban	0
本溪市公务员考试面试	ben'xi'shi'gong'wu'yuan'kao'shi'mian'shi	0
本溪市公务员面试	ben'xi'shi'gong'wu'yuan'mian'shi	0
本溪市公务员面试班	ben'xi'shi'gong'wu'yuan'mian'shi'ban	0
本溪市公务员面试考试	ben'xi'shi'gong'wu'yuan'mian'shi'kao'shi	0
本溪市公务员招录面试	ben'xi'shi'gong'wu'yuan'zhao'lu'mian'shi	0
本溪市人力资源局	ben'xi'shi'ren'li'zi'yuan'ju	0
本溪政府网	ben'xi'zheng'fu'wang	0
朝阳市公务员考试面试	chao'yang'shi'gong'wu'yuan'kao'shi'mian'shi	0
朝阳市公务员面试	chao'yang'shi'gong'wu'yuan'mian'shi	0
朝阳市公务员面试班	chao'yang'shi'gong'wu'yuan'mian'shi'ban	0
朝阳市公务员面试考试	chao'yang'shi'gong'wu'yuan'mian'shi'kao'shi	0
朝阳市公务员招录面试	chao'yang'shi'gong'wu'yuan'zhao'lu'mian'shi	0
朝阳市人事人才网	chao'yang'shi'ren'shi'ren'cai'wang	0
大连公务员成绩查询	da'lian'gong'wu'yuan'cheng'ji'cha'xun	0
大连公务员结构化面试	da'lian'gong'wu'yuan'jie'gou'hua'mian'shi	0
大连公务员考试成绩	da'lian'gong'wu'yuan'kao'shi'cheng'ji	0
大连公务员考试面试	da'lian'gong'wu'yuan'kao'shi'mian'shi	0
大连公务员考试名单	da'lian'gong'wu'yuan'kao'shi'ming'dan	0
大连公务员科信教育	da'lian'gong'wu'yuan'ke'xin'jiao'yu	0
大连公务员面试	da'lian'gong'wu'yuan'mian'shi	0
大连公务员面试考试	da'lian'gong'wu'yuan'mian'shi'kao'shi	0
大连公务员面试名单	da'lian'gong'wu'yuan'mian'shi'ming'dan	0
大连公务员面试资格	da'lian'gong'wu'yuan'mian'shi'zi'ge	0
大连公务员招录面试	da'lian'gong'wu'yuan'zhao'lu'mian'shi	0
大连面试资格审查时间	da'lian'mian'shi'zi'ge'shen'cha'shi'jian	0
大连人事考试网	da'lian'ren'shi'kao'shi'wang	0
大连市公务员考试面试	da'lian'shi'gong'wu'yuan'kao'shi'mian'shi	0
大连市公务员面试	da'lian'shi'gong'wu'yuan'mian'shi	0
大连市公务员面试考试	da'lian'shi'gong'wu'yuan'mian'shi'kao'shi	0
大连市公务员招录面试	da'lian'shi'gong'wu'yuan'zhao'lu'mian'shi	0
大连市人力资源网	da'lian'shi'ren'li'zi'yuan'wang	0
丹东公务员成绩查询	dan'dong'gong'wu'yuan'cheng'ji'cha'xun	0
丹东公务员结构化面试	dan'dong'gong'wu'yuan'jie'gou'hua'mian'shi	0
丹东公务员考试成绩	dan'dong'gong'wu'yuan'kao'shi'cheng'ji	0
丹东公务员考试面试	dan'dong'gong'wu'yuan'kao'shi'mian'shi	0
丹东公务员考试面试班	dan'dong'gong'wu'yuan'kao'shi'mian'shi'ban	0
丹东公务员考试名单	dan'dong'gong'wu'yuan'kao'shi'ming'dan	0
丹东公务员科信教育	dan'dong'gong'wu'yuan'ke'xin'jiao'yu	0
丹东公务员面试	dan'dong'gong'wu'yuan'mian'shi	0
丹东公务员面试班	dan'dong'gong'wu'yuan'mian'shi'ban	0
丹东公务员面试辅导	dan'dong'gong'wu'yuan'mian'shi'fu'dao	0
丹东公务员面试辅导班	dan'dong'gong'wu'yuan'mian'shi'fu'dao'ban	0
丹东公务员面试考试	dan'dong'gong'wu'yuan'mian'shi'kao'shi	0
丹东公务员面试名单	dan'dong'gong'wu'yuan'mian'shi'ming'dan	0
丹东公务员面试培训	dan'dong'gong'wu'yuan'mian'shi'pei'xun	0
丹东公务员面试培训班	dan'dong'gong'wu'yuan'mian'shi'pei'xun'ban	0
丹东公务员面试资格	dan'dong'gong'wu'yuan'mian'shi'zi'ge	0
丹东公务员招录面试	dan'dong'gong'wu'yuan'zhao'lu'mian'shi	0
丹东面试资格审查时间	dan'dong'mian'shi'zi'ge'shen'cha'shi'jian	0
丹东人力资源网	dan'dong'ren'li'zi'yuan'wang	0
丹东人事考试网	dan'dong'ren'shi'kao'shi'wang	0
丹东省考面试班	dan'dong'sheng'kao'mian'shi'ban	0
丹东省考面试辅导	dan'dong'sheng'kao'mian'shi'fu'dao	0
丹东省考面试辅导班	dan'dong'sheng'kao'mian'shi'fu'dao'ban	0
丹东省考面试培训	dan'dong'sheng'kao'mian'shi'pei'xun	0
丹东省考面试培训班	dan'dong'sheng'kao'mian'shi'pei'xun'ban	0
丹东市公务员结构化面试	dan'dong'shi'gong'wu'yuan'jie'gou'hua'mian'shi	0
丹东市公务员考试面试	dan'dong'shi'gong'wu'yuan'kao'shi'mian'shi	0
丹东市公务员面试	dan'dong'shi'gong'wu'yuan'mian'shi	0
丹东市公务员面试班	dan'dong'shi'gong'wu'yuan'mian'shi'ban	0
丹东市公务员面试考试	dan'dong'shi'gong'wu'yuan'mian'shi'kao'shi	0
丹东市公务员招录面试	dan'dong'shi'gong'wu'yuan'zhao'lu'mian'shi	0
丹东市人力资源网	dan'dong'shi'ren'li'zi'yuan'wang	0
抚顺公务员成绩查询	fu'shun'gong'wu'yuan'cheng'ji'cha'xun	0
抚顺公务员结构化面试	fu'shun'gong'wu'yuan'jie'gou'hua'mian'shi	0
抚顺公务员考试成绩	fu'shun'gong'wu'yuan'kao'shi'cheng'ji	0
抚顺公务员考试面试	fu'shun'gong'wu'yuan'kao'shi'mian'shi	0
抚顺公务员考试面试班	fu'shun'gong'wu'yuan'kao'shi'mian'shi'ban	0
抚顺公务员考试名单	fu'shun'gong'wu'yuan'kao'shi'ming'dan	0
抚顺公务员科信教育	fu'shun'gong'wu'yuan'ke'xin'jiao'yu	0
抚顺公务员面试	fu'shun'gong'wu'yuan'mian'shi	0
抚顺公务员面试班	fu'shun'gong'wu'yuan'mian'shi'ban	0
抚顺公务员面试辅导	fu'shun'gong'wu'yuan'mian'shi'fu'dao	0
抚顺公务员面试辅导班	fu'shun'gong'wu'yuan'mian'shi'fu'dao'ban	0
抚顺公务员面试考试	fu'shun'gong'wu'yuan'mian'shi'kao'shi	0
抚顺公务员面试名单	fu'shun'gong'wu'yuan'mian'shi'ming'dan	0
抚顺公务员面试培训	fu'shun'gong'wu'yuan'mian'shi'pei'xun	0
抚顺公务员面试培训班	fu'shun'gong'wu'yuan'mian'shi'pei'xun'ban	0
抚顺公务员面试资格	fu'shun'gong'wu'yuan'mian'shi'zi'ge	0
抚顺公务员招录面试	fu'shun'gong'wu'yuan'zhao'lu'mian'shi	0
抚顺面试资格审查时间	fu'shun'mian'shi'zi'ge'shen'cha'shi'jian	0
抚顺人力资源网	fu'shun'ren'li'zi'yuan'wang	0
抚顺人事考试网	fu'shun'ren'shi'kao'shi'wang	0
抚顺省考面试班	fu'shun'sheng'kao'mian'shi'ban	0
抚顺省考面试辅导	fu'shun'sheng'kao'mian'shi'fu'dao	0
抚顺省考面试辅导班	fu'shun'sheng'kao'mian'shi'fu'dao'ban	0
抚顺省考面试培训	fu'shun'sheng'kao'mian'shi'pei'xun	0
抚顺省考面试培训班	fu'shun'sheng'kao'mian'shi'pei'xun'ban	0
抚顺市公务员考试面试	fu'shun'shi'gong'wu'yuan'kao'shi'mian'shi	0
抚顺市公务员面试	fu'shun'shi'gong'wu'yuan'mian'shi	0
抚顺市公务员面试班	fu'shun'shi'gong'wu'yuan'mian'shi'ban	0
抚顺市公务员面试考试	fu'shun'shi'gong'wu'yuan'mian'shi'kao'shi	0
抚顺市公务员招录面试	fu'shun'shi'gong'wu'yuan'zhao'lu'mian'shi	0
阜新公务员成绩查询	fu'xin'gong'wu'yuan'cheng'ji'cha'xun	0
阜新公务员结构化面试	fu'xin'gong'wu'yuan'jie'gou'hua'mian'shi	0
阜新公务员考试成绩	fu'xin'gong'wu'yuan'kao'shi'cheng'ji	0
阜新公务员考试面试	fu'xin'gong'wu'yuan'kao'shi'mian'shi	0
阜新公务员考试面试班	fu'xin'gong'wu'yuan'kao'shi'mian'shi'ban	0
阜新公务员考试名单	fu'xin'gong'wu'yuan'kao'shi'ming'dan	0
阜新公务员科信教育	fu'xin'gong'wu'yuan'ke'xin'jiao'yu	0
阜新公务员面试	fu'xin'gong'wu'yuan'mian'shi	0
阜新公务员面试班	fu'xin'gong'wu'yuan'mian'shi'ban	0
阜新公务员面试辅导	fu'xin'gong'wu'yuan'mian'shi'fu'dao	0
阜新公务员面试辅导班	fu'xin'gong'wu'yuan'mian'shi'fu'dao'ban	0
阜新公务员面试考试	fu'xin'gong'wu'yuan'mian'shi'kao'shi	0
阜新公务员面试名单	fu'xin'gong'wu'yuan'mian'shi'ming'dan	0
阜新公务员面试培训	fu'xin'gong'wu'yuan'mian'shi'pei'xun	0
阜新公务员面试培训班	fu'xin'gong'wu'yuan'mian'shi'pei'xun'ban	0
阜新公务员面试资格	fu'xin'gong'wu'yuan'mian'shi'zi'ge	0
阜新公务员招录面试	fu'xin'gong'wu'yuan'zhao'lu'mian'shi	0
阜新人力资源网	fu'xin'ren'li'zi'yuan'wang	0
阜新人事考试网	fu'xin'ren'shi'kao'shi'wang	0
阜新省考面试班	fu'xin'sheng'kao'mian'shi'ban	0
阜新省考面试辅导	fu'xin'sheng'kao'mian'shi'fu'dao	0
阜新省考面试辅导班	fu'xin'sheng'kao'mian'shi'fu'dao'ban	0
阜新省考面试培训	fu'xin'sheng'kao'mian'shi'pei'xun	0
阜新省考面试培训班	fu'xin'sheng'kao'mian'shi'pei'xun'ban	0
阜新市公务员考试面试	fu'xin'shi'gong'wu'yuan'kao'shi'mian'shi	0
阜新市公务员面试	fu'xin'shi'gong'wu'yuan'mian'shi	0
阜新市公务员面试班	fu'xin'shi'gong'wu'yuan'mian'shi'ban	0
阜新市公务员面试考试	fu'xin'shi'gong'wu'yuan'mian'shi'kao'shi	0
阜新市公务员招录面试	fu'xin'shi'gong'wu'yuan'zhao'lu'mian'shi	0
阜新市人力资源网	fu'xin'shi'ren'li'zi'yuan'wang	0
公安考试面试辅导	gong'an'kao'shi'mian'shi'fu'dao	0
公安考试面试培训	gong'an'kao'shi'mian'shi'pei'xun	0
公安考试面试培训班	gong'an'kao'shi'mian'shi'pei'xun'ban	0
公安面试辅导	gong'an'mian'shi'fu'dao	0
公安面试培训	gong'an'mian'shi'pei'xun	0
公安面试培训班	gong'an'mian'shi'pei'xun'ban	0
公安系统面试辅导	gong'an'xi'tong'mian'shi'fu'dao	0
公安系统面试培训	gong'an'xi'tong'mian'shi'pei'xun	0
公安系统面试培训班	gong'an'xi'tong'mian'shi'pei'xun'ban	0
公务员讲师王森名师	gong'wu'yuan'jiang'shi'wang'sen'ming'shi	0
公务员结构化面试	gong'wu'yuan'jie'gou'hua'mian'shi	0
公务员考试递补	gong'wu'yuan'kao'shi'di'bu	0
公务员考试递补名单	gong'wu'yuan'kao'shi'di'bu'ming'dan	0
公务员考试面试	gong'wu'yuan'kao'shi'mian'shi	0
公务员科信教育培训	gong'wu'yuan'ke'xin'jiao'yu'pei'xun	0
公务员面试技巧课程	gong'wu'yuan'mian'shi'ji'qiao'ke'cheng	0
公务员面试考试	gong'wu'yuan'mian'shi'kao'shi	0
公务员面试科信培训	gong'wu'yuan'mian'shi'ke'xin'pei'xun	0
公务员面试流程	gong'wu'yuan'mian'shi'liu'cheng	0
公务员面试马义讲师	gong'wu'yuan'mian'shi'ma'yi'jiang'shi	0
公务员面试审查名单	gong'wu'yuan'mian'shi'shen'cha'ming'dan	0
公务员面试审查时间	gong'wu'yuan'mian'shi'shen'cha'shi'jian	0
公务员培训科信教育	gong'wu'yuan'pei'xun'ke'xin'jiao'yu	0
公务员申论考题	gong'wu'yuan'shen'lun'kao'ti	0
公务员申论李弼武	gong'wu'yuan'shen'lun'li'bi'wu	0
公务员数量区杨名师	gong'wu'yuan'shu'liang'qu'yang'ming'shi	0
公务员行测考题	gong'wu'yuan'xing'ce'kao'ti	0
公务员行测孙昊名师	gong'wu'yuan'xing'ce'sun'hao'ming'shi	0
公务员招录面试	gong'wu'yuan'zhao'lu'mian'shi	0
葫芦岛公务员成绩查询	hu'lu'dao'gong'wu'yuan'cheng'ji'cha'xun	0
葫芦岛公务员考试成绩	hu'lu'dao'gong'wu'yuan'kao'shi'cheng'ji	0
葫芦岛公务员考试面试	hu'lu'dao'gong'wu'yuan'kao'shi'mian'shi	0
葫芦岛公务员面试	hu'lu'dao'gong'wu'yuan'mian'shi	0
葫芦岛公务员面试考试	hu'lu'dao'gong'wu'yuan'mian'shi'kao'shi	0
葫芦岛公务员面试名单	hu'lu'dao'gong'wu'yuan'mian'shi'ming'dan	0
葫芦岛公务员招录面试	hu'lu'dao'gong'wu'yuan'zhao'lu'mian'shi	0
葫芦岛人事考试网	hu'lu'dao'ren'shi'kao'shi'wang	0
葫芦岛省考面试辅导	hu'lu'dao'sheng'kao'mian'shi'fu'dao	0
葫芦岛省考面试培训	hu'lu'dao'sheng'kao'mian'shi'pei'xun	0
葫芦岛市公务员面试	hu'lu'dao'shi'gong'wu'yuan'mian'shi	0
葫芦岛市人力资源网	hu'lu'dao'shi'ren'li'zi'yuan'wang	0
监狱考试面试	jian'yu'kao'shi'mian'shi	0
监狱考试面试班	jian'yu'kao'shi'mian'shi'ban	0
监狱考试面试辅导班	jian'yu'kao'shi'mian'shi'fu'dao'ban	0
监狱考试面试培训	jian'yu'kao'shi'mian'shi'pei'xun	0
监狱考试面试培训班	jian'yu'kao'shi'mian'shi'pei'xun'ban	0
监狱面试	jian'yu'mian'shi	0
监狱面试班	jian'yu'mian'shi'ban	0
监狱面试辅导班	jian'yu'mian'shi'fu'dao'ban	0
监狱面试培训	jian'yu'mian'shi'pei'xun	0
监狱面试培训班	jian'yu'mian'shi'pei'xun'ban	0
监狱系统面试	jian'yu'xi'tong'mian'shi	0
监狱系统面试班	jian'yu'xi'tong'mian'shi'ban	0
监狱系统面试辅导班	jian'yu'xi'tong'mian'shi'fu'dao'ban	0
监狱系统面试培训	jian'yu'xi'tong'mian'shi'pei'xun	0
监狱系统面试培训班	jian'yu'xi'tong'mian'shi'pei'xun'ban	0
结构化面试流程	jie'gou'hua'mian'shi'liu'cheng	0
锦州公务员成绩查询	jin'zhou'gong'wu'yuan'cheng'ji'cha'xun	0
锦州公务员结构化面试	jin'zhou'gong'wu'yuan'jie'gou'hua'mian'shi	0
锦州公务员考试成绩	jin'zhou'gong'wu'yuan'kao'shi'cheng'ji	0
锦州公务员考试面试	jin'zhou'gong'wu'yuan'kao'shi'mian'shi	0
锦州公务员考试面试班	jin'zhou'gong'wu'yuan'kao'shi'mian'shi'ban	0
锦州公务员考试名单	jin'zhou'gong'wu'yuan'kao'shi'ming'dan	0
锦州公务员科信教育	jin'zhou'gong'wu'yuan'ke'xin'jiao'yu	0
锦州公务员面试	jin'zhou'gong'wu'yuan'mian'shi	0
锦州公务员面试班	jin'zhou'gong'wu'yuan'mian'shi'ban	0
锦州公务员面试辅导	jin'zhou'gong'wu'yuan'mian'shi'fu'dao	0
锦州公务员面试辅导班	jin'zhou'gong'wu'yuan'mian'shi'fu'dao'ban	0
锦州公务员面试考试	jin'zhou'gong'wu'yuan'mian'shi'kao'shi	0
锦州公务员面试名单	jin'zhou'gong'wu'yuan'mian'shi'ming'dan	0
锦州公务员面试培训	jin'zhou'gong'wu'yuan'mian'shi'pei'xun	0
锦州公务员面试培训班	jin'zhou'gong'wu'yuan'mian'shi'pei'xun'ban	0
锦州公务员面试资格	jin'zhou'gong'wu'yuan'mian'shi'zi'ge	0
锦州公务员招录面试	jin'zhou'gong'wu'yuan'zhao'lu'mian'shi	0
锦州面试资格审查时间	jin'zhou'mian'shi'zi'ge'shen'cha'shi'jian	0
锦州人事考试网	jin'zhou'ren'shi'kao'shi'wang	0
锦州人事信息网	jin'zhou'ren'shi'xin'xi'wang	0
锦州省考面试班	jin'zhou'sheng'kao'mian'shi'ban	0
锦州省考面试辅导	jin'zhou'sheng'kao'mian'shi'fu'dao	0
锦州省考面试辅导班	jin'zhou'sheng'kao'mian'shi'fu'dao'ban	0
锦州省考面试培训	jin'zhou'sheng'kao'mian'shi'pei'xun	0
锦州省考面试培训班	jin'zhou'sheng'kao'mian'shi'pei'xun'ban	0
锦州市公务员考试面试	jin'zhou'shi'gong'wu'yuan'kao'shi'mian'shi	0
锦州市公务员面试	jin'zhou'shi'gong'wu'yuan'mian'shi	0
锦州市公务员面试班	jin'zhou'shi'gong'wu'yuan'mian'shi'ban	0
锦州市公务员面试考试	jin'zhou'shi'gong'wu'yuan'mian'shi'kao'shi	0
锦州市公务员招录面试	jin'zhou'shi'gong'wu'yuan'zhao'lu'mian'shi	0
锦州市人力资源网	jin'zhou'shi'ren'li'zi'yuan'wang	0
锦州市人事信息网	jin'zhou'shi'ren'shi'xin'xi'wang	0
科信教育培训学校	ke'xin'jiao'yu'pei'xun'xue'xiao	0
辽宁公安面试辅导	liao'ning'gong'an'mian'shi'fu'dao	0
辽宁公安面试培训	liao'ning'gong'an'mian'shi'pei'xun	0
辽宁公安面试培训班	liao'ning'gong'an'mian'shi'pei'xun'ban	0
辽宁公安系统面试辅导	liao'ning'gong'an'xi'tong'mian'shi'fu'dao	0
辽宁公安系统面试培训	liao'ning'gong'an'xi'tong'mian'shi'pei'xun	0
辽宁公务员结构化面试	liao'ning'gong'wu'yuan'jie'gou'hua'mian'shi	0
辽宁公务员考试面试	liao'ning'gong'wu'yuan'kao'shi'mian'shi	0
辽宁公务员面试	liao'ning'gong'wu'yuan'mian'shi	0
辽宁公务员面试考试	liao'ning'gong'wu'yuan'mian'shi'kao'shi	0
辽宁公务员面试流程	liao'ning'gong'wu'yuan'mian'shi'liu'cheng	0
辽宁公务员招录面试	liao'ning'gong'wu'yuan'zhao'lu'mian'shi	0
辽宁监狱面试	liao'ning'jian'yu'mian'shi	0
辽宁监狱面试班	liao'ning'jian'yu'mian'shi'ban	0
辽宁监狱面试辅导班	liao'ning'jian'yu'mian'shi'fu'dao'ban	0
辽宁监狱面试培训	liao'ning'jian'yu'mian'shi'pei'xun	0
辽宁监狱面试培训班	liao'ning'jian'yu'mian'shi'pei'xun'ban	0
辽宁监狱系统面试	liao'ning'jian'yu'xi'tong'mian'shi	0
辽宁监狱系统面试班	liao'ning'jian'yu'xi'tong'mian'shi'ban	0
辽宁监狱系统面试培训	liao'ning'jian'yu'xi'tong'mian'shi'pei'xun	0
辽宁结构化面试流程	liao'ning'jie'gou'hua'mian'shi'liu'cheng	0
辽宁省公安面试辅导	liao'ning'sheng'gong'an'mian'shi'fu'dao	0
辽宁省公安面试培训	liao'ning'sheng'gong'an'mian'shi'pei'xun	0
辽宁省公安面试培训班	liao'ning'sheng'gong'an'mian'shi'pei'xun'ban	0
辽宁省公务员考试面试	liao'ning'sheng'gong'wu'yuan'kao'shi'mian'shi	0
辽宁省公务员面试	liao'ning'sheng'gong'wu'yuan'mian'shi	0
辽宁省公务员面试考试	liao'ning'sheng'gong'wu'yuan'mian'shi'kao'shi	0
辽宁省公务员面试流程	liao'ning'sheng'gong'wu'yuan'mian'shi'liu'cheng	0
辽宁省公务员招录面试	liao'ning'sheng'gong'wu'yuan'zhao'lu'mian'shi	0
辽宁省监狱面试	liao'ning'sheng'jian'yu'mian'shi	0
辽宁省监狱面试班	liao'ning'sheng'jian'yu'mian'shi'ban	0
辽宁省监狱面试辅导班	liao'ning'sheng'jian'yu'mian'shi'fu'dao'ban	0
辽宁省监狱面试培训	liao'ning'sheng'jian'yu'mian'shi'pei'xun	0
辽宁省监狱面试培训班	liao'ning'sheng'jian'yu'mian'shi'pei'xun'ban	0
辽宁省监狱系统面试	liao'ning'sheng'jian'yu'xi'tong'mian'shi	0
辽宁省监狱系统面试班	liao'ning'sheng'jian'yu'xi'tong'mian'shi'ban	0
辽宁省结构化面试	liao'ning'sheng'jie'gou'hua'mian'shi	0
辽宁省结构化面试流程	liao'ning'sheng'jie'gou'hua'mian'shi'liu'cheng	0
辽宁省人力资源厅	liao'ning'sheng'ren'li'zi'yuan'ting	0
辽宁省人力资源网	liao'ning'sheng'ren'li'zi'yuan'wang	0
辽阳公务员成绩查询	liao'yang'gong'wu'yuan'cheng'ji'cha'xun	0
辽阳公务员结构化面试	liao'yang'gong'wu'yuan'jie'gou'hua'mian'shi	0
辽阳公务员考试成绩	liao'yang'gong'wu'yuan'kao'shi'cheng'ji	0
辽阳公务员考试面试	liao'yang'gong'wu'yuan'kao'shi'mian'shi	0
辽阳公务员考试名单	liao'yang'gong'wu'yuan'kao'shi'ming'dan	0
辽阳公务员科信教育	liao'yang'gong'wu'yuan'ke'xin'jiao'yu	0
辽阳公务员面试	liao'yang'gong'wu'yuan'mian'shi	0
辽阳公务员面试班	liao'yang'gong'wu'yuan'mian'shi'ban	0
辽阳公务员面试辅导	liao'yang'gong'wu'yuan'mian'shi'fu'dao	0
辽阳公务员面试考试	liao'yang'gong'wu'yuan'mian'shi'kao'shi	0
辽阳公务员面试名单	liao'yang'gong'wu'yuan'mian'shi'ming'dan	0
辽阳公务员面试培训	liao'yang'gong'wu'yuan'mian'shi'pei'xun	0
辽阳公务员面试培训班	liao'yang'gong'wu'yuan'mian'shi'pei'xun'ban	0
辽阳公务员面试资格	liao'yang'gong'wu'yuan'mian'shi'zi'ge	0
辽阳公务员招录面试	liao'yang'gong'wu'yuan'zhao'lu'mian'shi	0
辽阳人事考试网	liao'yang'ren'shi'kao'shi'wang	0
辽阳省考面试班	liao'yang'sheng'kao'mian'shi'ban	0
辽阳省考面试辅导	liao'yang'sheng'kao'mian'shi'fu'dao	0
辽阳省考面试培训	liao'yang'sheng'kao'mian'shi'pei'xun	0
辽阳省考面试培训班	liao'yang'sheng'kao'mian'shi'pei'xun'ban	0
辽阳市公务员考试面试	liao'yang'shi'gong'wu'yuan'kao'shi'mian'shi	0
辽阳市公务员面试	liao'yang'shi'gong'wu'yuan'mian'shi	0
辽阳市公务员面试班	liao'yang'shi'gong'wu'yuan'mian'shi'ban	0
辽阳市公务员面试考试	liao'yang'shi'gong'wu'yuan'mian'shi'kao'shi	0
辽阳市公务员招录面试	liao'yang'shi'gong'wu'yuan'zhao'lu'mian'shi	0
辽阳市人力资源网	liao'yang'shi'ren'li'zi'yuan'wang	0
面试培训班科信教育	mian'shi'pei'xun'ban'ke'xin'jiao'yu	0
面试培训科信教育	mian'shi'pei'xun'ke'xin'jiao'yu	0
年本溪公务员考试面试	nian'ben'xi'gong'wu'yuan'kao'shi'mian'shi	0
年本溪公务员面试考试	nian'ben'xi'gong'wu'yuan'mian'shi'kao'shi	0
年丹东公务员考试面试	nian'dan'dong'gong'wu'yuan'kao'shi'mian'shi	0
年丹东公务员面试	nian'dan'dong'gong'wu'yuan'mian'shi	0
年丹东公务员面试培训	nian'dan'dong'gong'wu'yuan'mian'shi'pei'xun	0
年丹东市公务员面试考试	nian'dan'dong'shi'gong'wu'yuan'mian'shi'kao'shi	0
年锦州省考面试辅导	nian'jin'zhou'sheng'kao'mian'shi'fu'dao	0
年铁岭公务员考试面试	nian'tie'ling'gong'wu'yuan'kao'shi'mian'shi	0
年铁岭公务员面试	nian'tie'ling'gong'wu'yuan'mian'shi	0
盘锦公务员成绩查询	pan'jin'gong'wu'yuan'cheng'ji'cha'xun	0
盘锦公务员结构化面试	pan'jin'gong'wu'yuan'jie'gou'hua'mian'shi	0
盘锦公务员考试成绩	pan'jin'gong'wu'yuan'kao'shi'cheng'ji	0
盘锦公务员考试面试	pan'jin'gong'wu'yuan'kao'shi'mian'shi	0
盘锦公务员考试面试班	pan'jin'gong'wu'yuan'kao'shi'mian'shi'ban	0
盘锦公务员考试名单	pan'jin'gong'wu'yuan'kao'shi'ming'dan	0
盘锦公务员科信教育	pan'jin'gong'wu'yuan'ke'xin'jiao'yu	0
盘锦公务员面试	pan'jin'gong'wu'yuan'mian'shi	0
盘锦公务员面试班	pan'jin'gong'wu'yuan'mian'shi'ban	0
盘锦公务员面试辅导	pan'jin'gong'wu'yuan'mian'shi'fu'dao	0
盘锦公务员面试考试	pan'jin'gong'wu'yuan'mian'shi'kao'shi	0
盘锦公务员面试名单	pan'jin'gong'wu'yuan'mian'shi'ming'dan	0
盘锦公务员面试培训	pan'jin'gong'wu'yuan'mian'shi'pei'xun	0
盘锦公务员面试培训班	pan'jin'gong'wu'yuan'mian'shi'pei'xun'ban	0
盘锦公务员招录面试	pan'jin'gong'wu'yuan'zhao'lu'mian'shi	0
盘锦人力资源网	pan'jin'ren'li'zi'yuan'wang	0
盘锦人事考试网	pan'jin'ren'shi'kao'shi'wang	0
盘锦人事人才网	pan'jin'ren'shi'ren'cai'wang	0
盘锦省考面试班	pan'jin'sheng'kao'mian'shi'ban	0
盘锦省考面试辅导	pan'jin'sheng'kao'mian'shi'fu'dao	0
盘锦省考面试辅导班	pan'jin'sheng'kao'mian'shi'fu'dao'ban	0
盘锦省考面试培训	pan'jin'sheng'kao'mian'shi'pei'xun	0
盘锦省考面试培训班	pan'jin'sheng'kao'mian'shi'pei'xun'ban	0
盘锦市公务员考试面试	pan'jin'shi'gong'wu'yuan'kao'shi'mian'shi	0
盘锦市公务员面试	pan'jin'shi'gong'wu'yuan'mian'shi	0
盘锦市公务员面试班	pan'jin'shi'gong'wu'yuan'mian'shi'ban	0
盘锦市公务员面试考试	pan'jin'shi'gong'wu'yuan'mian'shi'kao'shi	0
盘锦市公务员招录面试	pan'jin'shi'gong'wu'yuan'zhao'lu'mian'shi	0
盘锦市人力资源网	pan'jin'shi'ren'li'zi'yuan'wang	0
人力资源和社会保障局	ren'li'zi'yuan'he'she'hui'bao'zhang'ju	0
人力资源和社会保障网	ren'li'zi'yuan'he'she'hui'bao'zhang'wang	0
沈阳公务员成绩查询	shen'yang'gong'wu'yuan'cheng'ji'cha'xun	0
沈阳公务员结构化面试	shen'yang'gong'wu'yuan'jie'gou'hua'mian'shi	0
沈阳公务员考试成绩	shen'yang'gong'wu'yuan'kao'shi'cheng'ji	0
沈阳公务员考试面试	shen'yang'gong'wu'yuan'kao'shi'mian'shi	0
沈阳公务员考试面试班	shen'yang'gong'wu'yuan'kao'shi'mian'shi'ban	0
沈阳公务员科信教育	shen'yang'gong'wu'yuan'ke'xin'jiao'yu	0
沈阳公务员面试	shen'yang'gong'wu'yuan'mian'shi	0
沈阳公务员面试班	shen'yang'gong'wu'yuan'mian'shi'ban	0
沈阳公务员面试辅导	shen'yang'gong'wu'yuan'mian'shi'fu'dao	0
沈阳公务员面试辅导班	shen'yang'gong'wu'yuan'mian'shi'fu'dao'ban	0
沈阳公务员面试考试	shen'yang'gong'wu'yuan'mian'shi'kao'shi	0
沈阳公务员面试考试班	shen'yang'gong'wu'yuan'mian'shi'kao'shi'ban	0
沈阳公务员面试名单	shen'yang'gong'wu'yuan'mian'shi'ming'dan	0
沈阳公务员面试培训	shen'yang'gong'wu'yuan'mian'shi'pei'xun	0
沈阳公务员面试资格	shen'yang'gong'wu'yuan'mian'shi'zi'ge	0
沈阳公务员招录面试	shen'yang'gong'wu'yuan'zhao'lu'mian'shi	0
沈阳公务员招录面试班	shen'yang'gong'wu'yuan'zhao'lu'mian'shi'ban	0
沈阳面试资格审查时间	shen'yang'mian'shi'zi'ge'shen'cha'shi'jian	0
沈阳人力资源网	shen'yang'ren'li'zi'yuan'wang	0
沈阳人事考试网	shen'yang'ren'shi'kao'shi'wang	0
沈阳省考面试班	shen'yang'sheng'kao'mian'shi'ban	0
沈阳省考面试辅导	shen'yang'sheng'kao'mian'shi'fu'dao	0
沈阳省考面试辅导班	shen'yang'sheng'kao'mian'shi'fu'dao'ban	0
沈阳省考面试培训	shen'yang'sheng'kao'mian'shi'pei'xun	0
沈阳省考面试培训班	shen'yang'sheng'kao'mian'shi'pei'xun'ban	0
沈阳市公务员考试面试	shen'yang'shi'gong'wu'yuan'kao'shi'mian'shi	0
沈阳市公务员面试	shen'yang'shi'gong'wu'yuan'mian'shi	0
沈阳市公务员面试班	shen'yang'shi'gong'wu'yuan'mian'shi'ban	0
沈阳市公务员面试考试	shen'yang'shi'gong'wu'yuan'mian'shi'kao'shi	0
沈阳市公务员招录面试	shen'yang'shi'gong'wu'yuan'zhao'lu'mian'shi	0
铁岭公务员成绩查询	tie'ling'gong'wu'yuan'cheng'ji'cha'xun	0
铁岭公务员结构化面试	tie'ling'gong'wu'yuan'jie'gou'hua'mian'shi	0
铁岭公务员考试成绩	tie'ling'gong'wu'yuan'kao'shi'cheng'ji	0
铁岭公务员考试面试	tie'ling'gong'wu'yuan'kao'shi'mian'shi	0
铁岭公务员考试名单	tie'ling'gong'wu'yuan'kao'shi'ming'dan	0
铁岭公务员科信教育	tie'ling'gong'wu'yuan'ke'xin'jiao'yu	0
铁岭公务员面试	tie'ling'gong'wu'yuan'mian'shi	0
铁岭公务员面试班	tie'ling'gong'wu'yuan'mian'shi'ban	0
铁岭公务员面试辅导	tie'ling'gong'wu'yuan'mian'shi'fu'dao	0
铁岭公务员面试辅导班	tie'ling'gong'wu'yuan'mian'shi'fu'dao'ban	0
铁岭公务员面试考试	tie'ling'gong'wu'yuan'mian'shi'kao'shi	0
铁岭公务员面试名单	tie'ling'gong'wu'yuan'mian'shi'ming'dan	0
铁岭公务员面试培训	tie'ling'gong'wu'yuan'mian'shi'pei'xun	0
铁岭公务员面试培训班	tie'ling'gong'wu'yuan'mian'shi'pei'xun'ban	0
铁岭公务员面试资格	tie'ling'gong'wu'yuan'mian'shi'zi'ge	0
铁岭公务员招录面试	tie'ling'gong'wu'yuan'zhao'lu'mian'shi	0
铁岭人事考试网	tie'ling'ren'shi'kao'shi'wang	0
铁岭人事人才网	tie'ling'ren'shi'ren'cai'wang	0
铁岭省考面试班	tie'ling'sheng'kao'mian'shi'ban	0
铁岭省考面试辅导	tie'ling'sheng'kao'mian'shi'fu'dao	0
铁岭省考面试辅导班	tie'ling'sheng'kao'mian'shi'fu'dao'ban	0
铁岭省考面试培训	tie'ling'sheng'kao'mian'shi'pei'xun	0
铁岭省考面试培训班	tie'ling'sheng'kao'mian'shi'pei'xun'ban	0
铁岭市公务员考试面试	tie'ling'shi'gong'wu'yuan'kao'shi'mian'shi	0
铁岭市公务员面试	tie'ling'shi'gong'wu'yuan'mian'shi	0
铁岭市公务员面试班	tie'ling'shi'gong'wu'yuan'mian'shi'ban	0
铁岭市公务员面试考试	tie'ling'shi'gong'wu'yuan'mian'shi'kao'shi	0
铁岭市公务员招录面试	tie'ling'shi'gong'wu'yuan'zhao'lu'mian'shi	0
铁岭市人力资源网	tie'ling'shi'ren'li'zi'yuan'wang	0
营口公务员成绩查询	ying'kou'gong'wu'yuan'cheng'ji'cha'xun	0
营口公务员结构化面试	ying'kou'gong'wu'yuan'jie'gou'hua'mian'shi	0
营口公务员考试成绩	ying'kou'gong'wu'yuan'kao'shi'cheng'ji	0
营口公务员考试面试	ying'kou'gong'wu'yuan'kao'shi'mian'shi	0
营口公务员考试面试班	ying'kou'gong'wu'yuan'kao'shi'mian'shi'ban	0
营口公务员考试名单	ying'kou'gong'wu'yuan'kao'shi'ming'dan	0
营口公务员科信教育	ying'kou'gong'wu'yuan'ke'xin'jiao'yu	0
营口公务员面试	ying'kou'gong'wu'yuan'mian'shi	0
营口公务员面试班	ying'kou'gong'wu'yuan'mian'shi'ban	0
营口公务员面试辅导	ying'kou'gong'wu'yuan'mian'shi'fu'dao	0
营口公务员面试辅导班	ying'kou'gong'wu'yuan'mian'shi'fu'dao'ban	0
营口公务员面试考试	ying'kou'gong'wu'yuan'mian'shi'kao'shi	0
营口公务员面试考试辅导	ying'kou'gong'wu'yuan'mian'shi'kao'shi'fu'dao	0
营口公务员面试名单	ying'kou'gong'wu'yuan'mian'shi'ming'dan	0
营口公务员面试培训	ying'kou'gong'wu'yuan'mian'shi'pei'xun	0
营口公务员面试培训班	ying'kou'gong'wu'yuan'mian'shi'pei'xun'ban	0
营口公务员面试资格	ying'kou'gong'wu'yuan'mian'shi'zi'ge	0
营口公务员招录面试	ying'kou'gong'wu'yuan'zhao'lu'mian'shi	0
营口面试资格审查时间	ying'kou'mian'shi'zi'ge'shen'cha'shi'jian	0
营口人事考试网	ying'kou'ren'shi'kao'shi'wang	0
营口省考面试班	ying'kou'sheng'kao'mian'shi'ban	0
营口省考面试辅导	ying'kou'sheng'kao'mian'shi'fu'dao	0
营口省考面试辅导班	ying'kou'sheng'kao'mian'shi'fu'dao'ban	0
营口省考面试培训	ying'kou'sheng'kao'mian'shi'pei'xun	0
营口省考面试培训班	ying'kou'sheng'kao'mian'shi'pei'xun'ban	0
营口市公务员考试面试	ying'kou'shi'gong'wu'yuan'kao'shi'mian'shi	0
营口市公务员面试	ying'kou'shi'gong'wu'yuan'mian'shi	0
营口市公务员面试班	ying'kou'shi'gong'wu'yuan'mian'shi'ban	0
营口市公务员面试考试	ying'kou'shi'gong'wu'yuan'mian'shi'kao'shi	0
营口市公务员招录面试	ying'kou'shi'gong'wu'yuan'zhao'lu'mian'shi	0
营口市人力资源网	ying'kou'shi'ren'li'zi'yuan'wang	0
朝阳公务员成绩查询	zhao'yang'gong'wu'yuan'cheng'ji'cha'xun	0
朝阳公务员结构化面试	zhao'yang'gong'wu'yuan'jie'gou'hua'mian'shi	0
朝阳公务员考试成绩	zhao'yang'gong'wu'yuan'kao'shi'cheng'ji	0
朝阳公务员考试面试	zhao'yang'gong'wu'yuan'kao'shi'mian'shi	0
朝阳公务员考试面试班	zhao'yang'gong'wu'yuan'kao'shi'mian'shi'ban	0
朝阳公务员科信教育	zhao'yang'gong'wu'yuan'ke'xin'jiao'yu	0
朝阳公务员面试	zhao'yang'gong'wu'yuan'mian'shi	0
朝阳公务员面试班	zhao'yang'gong'wu'yuan'mian'shi'ban	0
朝阳公务员面试辅导	zhao'yang'gong'wu'yuan'mian'shi'fu'dao	0
朝阳公务员面试辅导班	zhao'yang'gong'wu'yuan'mian'shi'fu'dao'ban	0
朝阳公务员面试考试	zhao'yang'gong'wu'yuan'mian'shi'kao'shi	0
朝阳公务员面试名单	zhao'yang'gong'wu'yuan'mian'shi'ming'dan	0
朝阳公务员面试培训	zhao'yang'gong'wu'yuan'mian'shi'pei'xun	0
朝阳公务员面试培训班	zhao'yang'gong'wu'yuan'mian'shi'pei'xun'ban	0
朝阳公务员面试资格	zhao'yang'gong'wu'yuan'mian'shi'zi'ge	0
朝阳公务员招录面试	zhao'yang'gong'wu'yuan'zhao'lu'mian'shi	0
朝阳面试资格审查时间	zhao'yang'mian'shi'zi'ge'shen'cha'shi'jian	0
朝阳人事考试网	zhao'yang'ren'shi'kao'shi'wang	0
朝阳人事人才网	zhao'yang'ren'shi'ren'cai'wang	0
朝阳省考面试班	zhao'yang'sheng'kao'mian'shi'ban	0
朝阳省考面试辅导	zhao'yang'sheng'kao'mian'shi'fu'dao	0
朝阳省考面试辅导班	zhao'yang'sheng'kao'mian'shi'fu'dao'ban	0
朝阳省考面试培训	zhao'yang'sheng'kao'mian'shi'pei'xun	0
朝阳省考面试培训班	zhao'yang'sheng'kao'mian'shi'pei'xun'ban	0
