办公定制家具	ban'gong'ding'zhi'jia'ju	0
办公订制家具	ban'gong'ding'zhi'jia'ju	0
办公家具	ban'gong'jia'ju	0
办公家俱采购	ban'gong'jia'ju'cai'gou	0
办公家具采购	ban'gong'jia'ju'cai'gou	0
办公家具采购标准	ban'gong'jia'ju'cai'gou'biao'zhun	0
办公家具采购公司	ban'gong'jia'ju'cai'gou'gong'si	0
办公家具采购哪家好	ban'gong'jia'ju'cai'gou'na'jia'hao	0
办公家具采购平台	ban'gong'jia'ju'cai'gou'ping'tai	0
办公家具采购中心	ban'gong'jia'ju'cai'gou'zhong'xin	0
办公家具厂	ban'gong'jia'ju'chang	0
办公家具厂办公家具厂	ban'gong'jia'ju'chang'ban'gong'jia'ju'chang	0
办公家具厂店	ban'gong'jia'ju'chang'dian	0
办公家具厂电话	ban'gong'jia'ju'chang'dian'hua	0
办公家具厂定制	ban'gong'jia'ju'chang'ding'zhi	0
办公家具厂定做	ban'gong'jia'ju'chang'ding'zuo	0
办公家具厂公司	ban'gong'jia'ju'chang'gong'si	0
办公家俱厂家	ban'gong'jia'ju'chang'jia	0
办公家具厂家	ban'gong'jia'ju'chang'jia	0
办公家居厂家	ban'gong'jia'ju'chang'jia	0
办公家具厂家厂家	ban'gong'jia'ju'chang'jia'chang'jia	0
办公家具厂家电话	ban'gong'jia'ju'chang'jia'dian'hua	0
办公家具厂家定制	ban'gong'jia'ju'chang'jia'ding'zhi	0
办公家具厂家定做	ban'gong'jia'ju'chang'jia'ding'zuo	0
办公家具厂家家	ban'gong'jia'ju'chang'jia'jia	0
办公家具厂家具	ban'gong'jia'ju'chang'jia'ju	0
办公家具厂家联系方式	ban'gong'jia'ju'chang'jia'lian'xi'fang'shi	0
办公家具厂家哪家好	ban'gong'jia'ju'chang'jia'na'jia'hao	0
办公家具厂家哪里好	ban'gong'jia'ju'chang'jia'na'li'hao	0
办公家具厂家武汉	ban'gong'jia'ju'chang'jia'wu'han	0
办公家具厂家有哪些	ban'gong'jia'ju'chang'jia'you'na'xie	0
办公家具厂家直销	ban'gong'jia'ju'chang'jia'zhi'xiao	0
办公家具厂哪家好	ban'gong'jia'ju'chang'na'jia'hao	0
办公家具厂哪里	ban'gong'jia'ju'chang'na'li	0
办公家具厂商	ban'gong'jia'ju'chang'shang	0
办公家具的厂家	ban'gong'jia'ju'de'chang'jia	0
办公家具的定制	ban'gong'jia'ju'de'ding'zhi	0
办公家具的品牌	ban'gong'jia'ju'de'pin'pai	0
办公家俱定制	ban'gong'jia'ju'ding'zhi	0
办公家俱订制	ban'gong'jia'ju'ding'zhi	0
办公家具定制	ban'gong'jia'ju'ding'zhi	0
办公家具订制	ban'gong'jia'ju'ding'zhi	0
办公家居定制	ban'gong'jia'ju'ding'zhi	0
办公家具定制报价	ban'gong'jia'ju'ding'zhi'bao'jia	0
办公家具定制厂	ban'gong'jia'ju'ding'zhi'chang	0
办公家具定制厂家	ban'gong'jia'ju'ding'zhi'chang'jia	0
办公家具定制厂家哪家好	ban'gong'jia'ju'ding'zhi'chang'jia'na'jia'hao	0
办公家具定制服务	ban'gong'jia'ju'ding'zhi'fu'wu	0
办公家具定制工厂	ban'gong'jia'ju'ding'zhi'gong'chang	0
办公家具定制公司	ban'gong'jia'ju'ding'zhi'gong'si	0
办公家具定制价位	ban'gong'jia'ju'ding'zhi'jia'wei	0
办公家具定制江华	ban'gong'jia'ju'ding'zhi'jiang'hua	0
办公家具定制哪个牌子好	ban'gong'jia'ju'ding'zhi'na'ge'pai'zi'hao	0
办公家具定制哪家公司好	ban'gong'jia'ju'ding'zhi'na'jia'gong'si'hao	0
办公家具定制哪家好	ban'gong'jia'ju'ding'zhi'na'jia'hao	0
办公家具定制哪里好	ban'gong'jia'ju'ding'zhi'na'li'hao	0
办公家具定制品牌	ban'gong'jia'ju'ding'zhi'pin'pai	0
办公家具定制网	ban'gong'jia'ju'ding'zhi'wang	0
办公家具定制武汉	ban'gong'jia'ju'ding'zhi'wu'han	0
办公家具定制怎么样	ban'gong'jia'ju'ding'zhi'zen'me'yang	0
办公家具定做	ban'gong'jia'ju'ding'zuo	0
办公家具订做	ban'gong'jia'ju'ding'zuo	0
办公家具定做厂家	ban'gong'jia'ju'ding'zuo'chang'jia	0
办公家具定做公司	ban'gong'jia'ju'ding'zuo'gong'si	0
办公家俱定做江华	ban'gong'jia'ju'ding'zuo'jiang'hua	0
办公家具定做哪家好	ban'gong'jia'ju'ding'zuo'na'jia'hao	0
办公家具订做哪里好	ban'gong'jia'ju'ding'zuo'na'li'hao	0
办公家具个性化定制	ban'gong'jia'ju'ge'xing'hua'ding'zhi	0
办公家具工厂	ban'gong'jia'ju'gong'chang	0
办公家具工程定制	ban'gong'jia'ju'gong'cheng'ding'zhi	0
办公家具公司	ban'gong'jia'ju'gong'si	0
办公家具公司厂	ban'gong'jia'ju'gong'si'chang	0
办公家具公司厂家	ban'gong'jia'ju'gong'si'chang'jia	0
办公家具公司地址	ban'gong'jia'ju'gong'si'di'zhi	0
办公家具公司定制	ban'gong'jia'ju'gong'si'ding'zhi	0
办公家具公司哪家好	ban'gong'jia'ju'gong'si'na'jia'hao	0
办公家具公司武汉	ban'gong'jia'ju'gong'si'wu'han	0
办公家具供应厂家	ban'gong'jia'ju'gong'ying'chang'jia	0
办公家具好的品牌	ban'gong'jia'ju'hao'de'pin'pai	0
办公家具集中采购	ban'gong'jia'ju'ji'zhong'cai'gou	0
办公家具加工厂	ban'gong'jia'ju'jia'gong'chang	0
办公家具家具厂	ban'gong'jia'ju'jia'ju'chang	0
办公家具家具厂家	ban'gong'jia'ju'jia'ju'chang'jia	0
办公家具家具定制	ban'gong'jia'ju'jia'ju'ding'zhi	0
办公家具家具定做	ban'gong'jia'ju'jia'ju'ding'zuo	0
办公家具家具生产厂	ban'gong'jia'ju'jia'ju'sheng'chan'chang	0
办公家具家具生产厂家	ban'gong'jia'ju'jia'ju'sheng'chan'chang'jia	0
办公家具家具制造厂	ban'gong'jia'ju'jia'ju'zhi'zao'chang	0
办公家具江华	ban'gong'jia'ju'jiang'hua	0
办公家具那个品牌好	ban'gong'jia'ju'na'ge'pin'pai'hao	0
办公家具哪里定制	ban'gong'jia'ju'na'li'ding'zhi	0
办公家具哪里有定做的	ban'gong'jia'ju'na'li'you'ding'zuo'de	0
办公家具哪种品牌好	ban'gong'jia'ju'na'zhong'pin'pai'hao	0
办公家具配件厂家	ban'gong'jia'ju'pei'jian'chang'jia	0
办公家具配套厂家	ban'gong'jia'ju'pei'tao'chang'jia	0
办公家具批量定制	ban'gong'jia'ju'pi'liang'ding'zhi	0
办公家具品牌	ban'gong'jia'ju'pin'pai	0
办公家具品牌厂	ban'gong'jia'ju'pin'pai'chang	0
办公家具品牌厂家	ban'gong'jia'ju'pin'pai'chang'jia	0
办公家具品牌好	ban'gong'jia'ju'pin'pai'hao	0
办公家具品牌推荐	ban'gong'jia'ju'pin'pai'tui'jian	0
办公家具屏风厂家	ban'gong'jia'ju'ping'feng'chang'jia	0
办公家具沙发厂家	ban'gong'jia'ju'sha'fa'chang'jia	0
办公家具沙发定制	ban'gong'jia'ju'sha'fa'ding'zhi	0
办公家具上门定制	ban'gong'jia'ju'shang'men'ding'zhi	0
办公家具上门定做	ban'gong'jia'ju'shang'men'ding'zuo	0
办公家具设计定制	ban'gong'jia'ju'she'ji'ding'zhi	0
办公家具设计定做	ban'gong'jia'ju'she'ji'ding'zuo	0
办公家具什么品牌	ban'gong'jia'ju'shen'me'pin'pai	0
办公家具什么品牌好	ban'gong'jia'ju'shen'me'pin'pai'hao	0
办公家俱生产厂	ban'gong'jia'ju'sheng'chan'chang	0
办公家具生产厂	ban'gong'jia'ju'sheng'chan'chang	0
办公家俱生产厂家	ban'gong'jia'ju'sheng'chan'chang'jia	0
办公家具生产厂家	ban'gong'jia'ju'sheng'chan'chang'jia	0
办公家具生产厂商	ban'gong'jia'ju'sheng'chan'chang'shang	0
办公家具生产工厂	ban'gong'jia'ju'sheng'chan'gong'chang	0
办公家具生产公司	ban'gong'jia'ju'sheng'chan'gong'si	0
办公家具宿舍家具	ban'gong'jia'ju'su'she'jia'ju	0
办公家具武汉	ban'gong'jia'ju'wu'han	0
办公家具销售厂家	ban'gong'jia'ju'xiao'shou'chang'jia	0
办公家具椅厂家	ban'gong'jia'ju'yi'chang'jia	0
办公家具政府采购	ban'gong'jia'ju'zheng'fu'cai'gou	0
办公家具整体定制	ban'gong'jia'ju'zheng'ti'ding'zhi	0
办公家具知名品牌	ban'gong'jia'ju'zhi'ming'pin'pai	0
办公家俱制造厂	ban'gong'jia'ju'zhi'zao'chang	0
办公家具制造厂	ban'gong'jia'ju'zhi'zao'chang	0
办公家具制造厂家	ban'gong'jia'ju'zhi'zao'chang'jia	0
办公家具制造厂商	ban'gong'jia'ju'zhi'zao'chang'shang	0
办公家具制造公司	ban'gong'jia'ju'zhi'zao'gong'si	0
办公家具制造有限公司	ban'gong'jia'ju'zhi'zao'you'xian'gong'si	0
办公家具制作厂家	ban'gong'jia'ju'zhi'zuo'chang'jia	0
办公家具著名品牌	ban'gong'jia'ju'zhu'ming'pin'pai	0
办公家具专业定制	ban'gong'jia'ju'zhuan'ye'ding'zhi	0
办公家具桌椅厂	ban'gong'jia'ju'zhuo'yi'chang	0
办公家具桌椅厂家	ban'gong'jia'ju'zhuo'yi'chang'jia	0
办公家具桌椅定制	ban'gong'jia'ju'zhuo'yi'ding'zhi	0
办公家具桌椅定做	ban'gong'jia'ju'zhuo'yi'ding'zuo	0
办公家私厂家	ban'gong'jia'si'chang'jia	0
办公家私定制	ban'gong'jia'si'ding'zhi	0
办公家私订制	ban'gong'jia'si'ding'zhi	0
办公楼办公家具采购	ban'gong'lou'ban'gong'jia'ju'cai'gou	0
办公屏风定制	ban'gong'ping'feng'ding'zhi	0
办公屏风哪里定制好	ban'gong'ping'feng'na'li'ding'zhi'hao	0
办公屏风位定制	ban'gong'ping'feng'wei'ding'zhi	0
办公屏风桌定制	ban'gong'ping'feng'zhuo'ding'zhi	0
办公沙发厂家	ban'gong'sha'fa'chang'jia	0
办公沙发定制	ban'gong'sha'fa'ding'zhi	0
办公沙发定制厂	ban'gong'sha'fa'ding'zhi'chang	0
办公沙发定制厂家	ban'gong'sha'fa'ding'zhi'chang'jia	0
办公沙发生产厂家	ban'gong'sha'fa'sheng'chan'chang'jia	0
办公室办公家具定做	ban'gong'shi'ban'gong'jia'ju'ding'zuo	0
办公室办公桌椅厂家	ban'gong'shi'ban'gong'zhuo'yi'chang'jia	0
办公室定制家具	ban'gong'shi'ding'zhi'jia'ju	0
办公室家具厂	ban'gong'shi'jia'ju'chang	0
办公室家具厂家	ban'gong'shi'jia'ju'chang'jia	0
办公室家具定制	ban'gong'shi'jia'ju'ding'zhi	0
办公室家具订制	ban'gong'shi'jia'ju'ding'zhi	0
办公室家具工厂	ban'gong'shi'jia'ju'gong'chang	0
办公室家具公司哪家好	ban'gong'shi'jia'ju'gong'si'na'jia'hao	0
办公室家具生产厂家	ban'gong'shi'jia'ju'sheng'chan'chang'jia	0
办公实木家具厂家	ban'gong'shi'mu'jia'ju'chang'jia	0
办公室沙发定制	ban'gong'shi'sha'fa'ding'zhi	0
办公室整体家具定制	ban'gong'shi'zheng'ti'jia'ju'ding'zhi	0
办公室桌椅定制	ban'gong'shi'zhuo'yi'ding'zhi	0
办公室桌椅订制	ban'gong'shi'zhuo'yi'ding'zhi	0
办公室桌椅定做	ban'gong'shi'zhuo'yi'ding'zuo	0
办公台定制	ban'gong'tai'ding'zhi	0
办公椅定制	ban'gong'yi'ding'zhi	0
办公椅子定制	ban'gong'yi'zi'ding'zhi	0
办公用家具厂家	ban'gong'yong'jia'ju'chang'jia	0
办公用家具定制	ban'gong'yong'jia'ju'ding'zhi	0
办公用家具订制	ban'gong'yong'jia'ju'ding'zhi	0
办公用家具定做	ban'gong'yong'jia'ju'ding'zuo	0
办公用家具订做	ban'gong'yong'jia'ju'ding'zuo	0
办公用家具生产厂家	ban'gong'yong'jia'ju'sheng'chan'chang'jia	0
办公用沙发厂家	ban'gong'yong'sha'fa'chang'jia	0
办公桌定制	ban'gong'zhuo'ding'zhi	0
办公桌订制	ban'gong'zhuo'ding'zhi	0
办公桌定制厂家	ban'gong'zhuo'ding'zhi'chang'jia	0
办公桌订做	ban'gong'zhuo'ding'zuo	0
办公桌定做厂家	ban'gong'zhuo'ding'zuo'chang'jia	0
办公桌家具厂	ban'gong'zhuo'jia'ju'chang	0
办公桌家具厂家	ban'gong'zhuo'jia'ju'chang'jia	0
办公桌家具定制	ban'gong'zhuo'jia'ju'ding'zhi	0
办公桌家具定做	ban'gong'zhuo'jia'ju'ding'zuo	0
办公桌卡位厂家	ban'gong'zhuo'ka'wei'chang'jia	0
办公桌哪里定制好	ban'gong'zhuo'na'li'ding'zhi'hao	0
办公桌生产厂家	ban'gong'zhuo'sheng'chan'chang'jia	0
办公桌椅厂家	ban'gong'zhuo'yi'chang'jia	0
办公桌椅厂家定制	ban'gong'zhuo'yi'chang'jia'ding'zhi	0
办公桌椅定制	ban'gong'zhuo'yi'ding'zhi	0
办公桌椅订制	ban'gong'zhuo'yi'ding'zhi	0
办公桌椅定制厂	ban'gong'zhuo'yi'ding'zhi'chang	0
办公桌椅定制厂家	ban'gong'zhuo'yi'ding'zhi'chang'jia	0
办公桌椅定做	ban'gong'zhuo'yi'ding'zuo	0
办公桌椅订做	ban'gong'zhuo'yi'ding'zuo	0
办公桌椅定做厂家	ban'gong'zhuo'yi'ding'zuo'chang'jia	0
办公桌椅家具厂家	ban'gong'zhuo'yi'jia'ju'chang'jia	0
办公桌椅配件厂家	ban'gong'zhuo'yi'pei'jian'chang'jia	0
办公桌椅配套厂家	ban'gong'zhuo'yi'pei'tao'chang'jia	0
办公桌椅生产厂家	ban'gong'zhuo'yi'sheng'chan'chang'jia	0
板式办公家具厂家	ban'shi'ban'gong'jia'ju'chang'jia	0
板式办公家具厂商	ban'shi'ban'gong'jia'ju'chang'shang	0
板式办公家具定制	ban'shi'ban'gong'jia'ju'ding'zhi	0
板式办公家具定做	ban'shi'ban'gong'jia'ju'ding'zuo	0
板式办公桌定做	ban'shi'ban'gong'zhuo'ding'zuo	0
采购办公家具报价	cai'gou'ban'gong'jia'ju'bao'jia	0
采购办公家具公司	cai'gou'ban'gong'jia'ju'gong'si	0
采购公司办公家具	cai'gou'gong'si'ban'gong'jia'ju	0
厂家办公室家具	chang'jia'ban'gong'shi'jia'ju	0
厂家定制办公家具	chang'jia'ding'zhi'ban'gong'jia'ju	0
厂家定做办公家具	chang'jia'ding'zuo'ban'gong'jia'ju	0
厂家供应办公家具	chang'jia'gong'ying'ban'gong'jia'ju	0
厂家宿舍家具厂家	chang'jia'su'she'jia'ju'chang'jia	0
厂家直销办公桌	chang'jia'zhi'xiao'ban'gong'zhuo	0
成套办公家具定制	cheng'tao'ban'gong'jia'ju'ding'zhi	0
大型办公家具厂家	da'xing'ban'gong'jia'ju'chang'jia	0
电脑办公桌椅定做	dian'nao'ban'gong'zhuo'yi'ding'zuo	0
定制办公柜	ding'zhi'ban'gong'gui	0
定制办公家俱	ding'zhi'ban'gong'jia'ju	0
定制办公家具	ding'zhi'ban'gong'jia'ju	0
订制办公家俱	ding'zhi'ban'gong'jia'ju	0
订制办公家具	ding'zhi'ban'gong'jia'ju	0
订制办公家居	ding'zhi'ban'gong'jia'ju	0
定制办公家具厂	ding'zhi'ban'gong'jia'ju'chang	0
定制办公家具厂家	ding'zhi'ban'gong'jia'ju'chang'jia	0
定制办公家具公司	ding'zhi'ban'gong'jia'ju'gong'si	0
定制办公家具哪家好	ding'zhi'ban'gong'jia'ju'na'jia'hao	0
定制办公家具品牌	ding'zhi'ban'gong'jia'ju'pin'pai	0
定制办公家私	ding'zhi'ban'gong'jia'si	0
定制办公屏风	ding'zhi'ban'gong'ping'feng	0
定制办公沙发	ding'zhi'ban'gong'sha'fa	0
定制办公室家具	ding'zhi'ban'gong'shi'jia'ju	0
订制办公室家具	ding'zhi'ban'gong'shi'jia'ju	0
定制办公室沙发	ding'zhi'ban'gong'shi'sha'fa	0
定制办公室桌椅	ding'zhi'ban'gong'shi'zhuo'yi	0
定制办公椅	ding'zhi'ban'gong'yi	0
定制办公用家具	ding'zhi'ban'gong'yong'jia'ju	0
定制办公桌	ding'zhi'ban'gong'zhuo	0
订制办公桌	ding'zhi'ban'gong'zhuo	0
定制办公桌厂家	ding'zhi'ban'gong'zhuo'chang'jia	0
定制办公桌椅	ding'zhi'ban'gong'zhuo'yi	0
订制办公桌椅	ding'zhi'ban'gong'zhuo'yi	0
定制办公桌椅厂家	ding'zhi'ban'gong'zhuo'yi'chang'jia	0
定制板式办公家具	ding'zhi'ban'shi'ban'gong'jia'ju	0
定制高档办公家具	ding'zhi'gao'dang'ban'gong'jia'ju	0
定制高档办公桌椅	ding'zhi'gao'dang'ban'gong'zhuo'yi	0
定制高端办公家具	ding'zhi'gao'duan'ban'gong'jia'ju	0
定制公司办公家具	ding'zhi'gong'si'ban'gong'jia'ju	0
定制欧式办公家具	ding'zhi'ou'shi'ban'gong'jia'ju	0
定制品牌办公家具	ding'zhi'pin'pai'ban'gong'jia'ju	0
定制实木办公家具	ding'zhi'shi'mu'ban'gong'jia'ju	0
订制实木办公家具	ding'zhi'shi'mu'ban'gong'jia'ju	0
定制现代办公家具	ding'zhi'xian'dai'ban'gong'jia'ju	0
定制学校办公桌椅	ding'zhi'xue'xiao'ban'gong'zhuo'yi	0
定制整体办公家具	ding'zhi'zheng'ti'ban'gong'jia'ju	0
定制中高档办公家具	ding'zhi'zhong'gao'dang'ban'gong'jia'ju	0
定做办公家具	ding'zuo'ban'gong'jia'ju	0
订做办公家俱	ding'zuo'ban'gong'jia'ju	0
订做办公家具	ding'zuo'ban'gong'jia'ju	0
定做办公家具厂	ding'zuo'ban'gong'jia'ju'chang	0
定做办公家具厂家	ding'zuo'ban'gong'jia'ju'chang'jia	0
定做办公家具公司	ding'zuo'ban'gong'jia'ju'gong'si	0
订做办公家具公司	ding'zuo'ban'gong'jia'ju'gong'si	0
定做办公家具哪家好	ding'zuo'ban'gong'jia'ju'na'jia'hao	0
订做办公家私	ding'zuo'ban'gong'jia'si	0
定做办公室家具	ding'zuo'ban'gong'shi'jia'ju	0
定做办公用家具	ding'zuo'ban'gong'yong'jia'ju	0
订做办公用家具	ding'zuo'ban'gong'yong'jia'ju	0
订做办公桌	ding'zuo'ban'gong'zhuo	0
定做办公桌家具	ding'zuo'ban'gong'zhuo'jia'ju	0
定做办公桌椅	ding'zuo'ban'gong'zhuo'yi	0
订做办公桌椅	ding'zuo'ban'gong'zhuo'yi	0
定做办公桌椅厂家	ding'zuo'ban'gong'zhuo'yi'chang'jia	0
定做板式办公家具	ding'zuo'ban'shi'ban'gong'jia'ju	0
定做高档办公家具	ding'zuo'gao'dang'ban'gong'jia'ju	0
定做实木办公家具	ding'zuo'shi'mu'ban'gong'jia'ju	0
定做现代办公家具	ding'zuo'xian'dai'ban'gong'jia'ju	0
多功能宿舍家具	duo'gong'neng'su'she'jia'ju	0
高档办公家具厂家	gao'dang'ban'gong'jia'ju'chang'jia	0
高档办公家具定制	gao'dang'ban'gong'jia'ju'ding'zhi	0
高档办公家具订制	gao'dang'ban'gong'jia'ju'ding'zhi	0
高档办公家具定做	gao'dang'ban'gong'jia'ju'ding'zuo	0
高档办公家具生产厂家	gao'dang'ban'gong'jia'ju'sheng'chan'chang'jia	0
高档办公室家具定制	gao'dang'ban'gong'shi'jia'ju'ding'zhi	0
高档办公桌椅厂家	gao'dang'ban'gong'zhuo'yi'chang'jia	0
高档办公桌椅定制	gao'dang'ban'gong'zhuo'yi'ding'zhi	0
高档办公桌椅定做	gao'dang'ban'gong'zhuo'yi'ding'zuo	0
高档品牌办公家具	gao'dang'pin'pai'ban'gong'jia'ju	0
高端办公家具采购	gao'duan'ban'gong'jia'ju'cai'gou	0
高端办公家具厂家	gao'duan'ban'gong'jia'ju'chang'jia	0
高端办公家具定制	gao'duan'ban'gong'jia'ju'ding'zhi	0
高端办公家具定做	gao'duan'ban'gong'jia'ju'ding'zuo	0
高端定制办公家具	gao'duan'ding'zhi'ban'gong'jia'ju	0
高级办公家具厂家	gao'ji'ban'gong'jia'ju'chang'jia	0
高级办公家具定制	gao'ji'ban'gong'jia'ju'ding'zhi	0
各种办公家具定制	ge'zhong'ban'gong'jia'ju'ding'zhi	0
各种办公桌椅定做	ge'zhong'ban'gong'zhuo'yi'ding'zuo	0
工厂宿舍家具	gong'chang'su'she'jia'ju	0
工程办公家具定做	gong'cheng'ban'gong'jia'ju'ding'zuo	0
公司办公家具	gong'si'ban'gong'jia'ju	0
公司办公家具采购	gong'si'ban'gong'jia'ju'cai'gou	0
公司办公家具厂家	gong'si'ban'gong'jia'ju'chang'jia	0
公司办公家具定制	gong'si'ban'gong'jia'ju'ding'zhi	0
公司办公家具定做	gong'si'ban'gong'jia'ju'ding'zuo	0
公司办公家具有哪些	gong'si'ban'gong'jia'ju'you'na'xie	0
公司办公桌椅厂家	gong'si'ban'gong'zhuo'yi'chang'jia	0
公司采购办公家具	gong'si'cai'gou'ban'gong'jia'ju	0
公司宿舍家具	gong'si'su'she'jia'ju	0
供应办公家具厂家	gong'ying'ban'gong'jia'ju'chang'jia	0
古典办公家具厂家	gu'dian'ban'gong'jia'ju'chang'jia	0
国际知名办公家具品牌	guo'ji'zhi'ming'ban'gong'jia'ju'pin'pai	0
豪华办公家具厂家	hao'hua'ban'gong'jia'ju'chang'jia	0
湖北办公家具定制	hu'bei'ban'gong'jia'ju'ding'zhi	0
环保办公家具厂家	huan'bao'ban'gong'jia'ju'chang'jia	0
环保办公家具定制	huan'bao'ban'gong'jia'ju'ding'zhi	0
环保办公家具定做厂家	huan'bao'ban'gong'jia'ju'ding'zuo'chang'jia	0
环保宿舍家具	huan'bao'su'she'jia'ju	0
集体宿舍家具	ji'ti'su'she'jia'ju	0
家具办公厂家	jia'ju'ban'gong'chang'jia	0
家具办公定制	jia'ju'ban'gong'ding'zhi	0
家具办公家具厂	jia'ju'ban'gong'jia'ju'chang	0
家具办公家具厂家	jia'ju'ban'gong'jia'ju'chang'jia	0
家具办公家具定制	jia'ju'ban'gong'jia'ju'ding'zhi	0
家具办公家具生产厂	jia'ju'ban'gong'jia'ju'sheng'chan'chang	0
家具办公家具生产厂家	jia'ju'ban'gong'jia'ju'sheng'chan'chang'jia	0
家具厂宿舍	jia'ju'chang'su'she	0
家具定制公司	jia'ju'ding'zhi'gong'si	0
家具工贸宿舍	jia'ju'gong'mao'su'she	0
家具公司宿舍	jia'ju'gong'si'su'she	0
简单办公桌定制	jian'dan'ban'gong'zhuo'ding'zhi	0
简易办公家具厂家	jian'yi'ban'gong'jia'ju'chang'jia	0
简约办公家具厂家	jian'yue'ban'gong'jia'ju'chang'jia	0
简约办公桌椅厂家	jian'yue'ban'gong'zhuo'yi'chang'jia	0
酒店办公家具采购	jiu'dian'ban'gong'jia'ju'cai'gou	0
酒店办公家具工厂	jiu'dian'ban'gong'jia'ju'gong'chang	0
美式公司办公家具	mei'shi'gong'si'ban'gong'jia'ju	0
木质办公家具厂家	mu'zhi'ban'gong'jia'ju'chang'jia	0
哪个办公家具品牌好	na'ge'ban'gong'jia'ju'pin'pai'hao	0
哪家办公家具厂好	na'jia'ban'gong'jia'ju'chang'hao	0
哪里有办公家具厂家	na'li'you'ban'gong'jia'ju'chang'jia	0
品牌办公家具	pin'pai'ban'gong'jia'ju	0
品牌办公家具厂	pin'pai'ban'gong'jia'ju'chang	0
品牌办公家具厂家	pin'pai'ban'gong'jia'ju'chang'jia	0
品牌办公家具公司	pin'pai'ban'gong'jia'ju'gong'si	0
品牌好的办公家具	pin'pai'hao'de'ban'gong'jia'ju	0
屏风办公家具定做	ping'feng'ban'gong'jia'ju'ding'zuo	0
普通办公桌椅厂家	pu'tong'ban'gong'zhuo'yi'chang'jia	0
企业办公家具定制	qi'ye'ban'gong'jia'ju'ding'zhi	0
企业办公家具订制	qi'ye'ban'gong'jia'ju'ding'zhi	0
企业家具定制	qi'ye'jia'ju'ding'zhi	0
寝室家具	qin'shi'jia'ju	0
寝室家具批发	qin'shi'jia'ju'pi'fa	0
全套办公家具	quan'tao'ban'gong'jia'ju	0
全套办公家具定制	quan'tao'ban'gong'jia'ju'ding'zhi	0
全屋定制办公家具	quan'wu'ding'zhi'ban'gong'jia'ju	0
上门定制办公家具	shang'men'ding'zhi'ban'gong'jia'ju	0
什么品牌的办公家具	shen'me'pin'pai'de'ban'gong'jia'ju	0
生产办公家具厂家	sheng'chan'ban'gong'jia'ju'chang'jia	0
生产办公家具的厂家	sheng'chan'ban'gong'jia'ju'de'chang'jia	0
生产办公桌椅厂家	sheng'chan'ban'gong'zhuo'yi'chang'jia	0
生产厂家办公家具	sheng'chan'chang'jia'ban'gong'jia'ju	0
实木办公家具厂	shi'mu'ban'gong'jia'ju'chang	0
实木办公家具厂家	shi'mu'ban'gong'jia'ju'chang'jia	0
实木办公家具定制	shi'mu'ban'gong'jia'ju'ding'zhi	0
实木办公家具定做	shi'mu'ban'gong'jia'ju'ding'zuo	0
实木办公家具定做厂家	shi'mu'ban'gong'jia'ju'ding'zuo'chang'jia	0
实木定制办公家具	shi'mu'ding'zhi'ban'gong'jia'ju	0
时尚办公家具厂家	shi'shang'ban'gong'jia'ju'chang'jia	0
时尚办公家具定制	shi'shang'ban'gong'jia'ju'ding'zhi	0
双人床	shuang'ren'chuang	0
私人定制办公家具	si'ren'ding'zhi'ban'gong'jia'ju	0
宿舍办公桌椅	su'she'ban'gong'zhuo'yi	0
宿舍床	su'she'chuang	0
宿舍床家具厂	su'she'chuang'jia'ju'chang	0
宿舍家具采购	su'she'jia'ju'cai'gou	0
宿舍家具厂	su'she'jia'ju'chang	0
宿舍家具厂家	su'she'jia'ju'chang'jia	0
宿舍家具厂商	su'she'jia'ju'chang'shang	0
宿舍家具定制	su'she'jia'ju'ding'zhi	0
宿舍家具定做	su'she'jia'ju'ding'zuo	0
宿舍家具工厂	su'she'jia'ju'gong'chang	0
宿舍家具生产厂家	su'she'jia'ju'sheng'chan'chang'jia	0
宿舍配套家具	su'she'pei'tao'jia'ju	0
宿舍用家具	su'she'yong'jia'ju	0
宿舍整体家具	su'she'zheng'ti'jia'ju	0
网上定制办公家具	wang'shang'ding'zhi'ban'gong'jia'ju	0
武昌办公家具定制	wu'chang'ban'gong'jia'ju'ding'zhi	0
武汉办公家具	wu'han'ban'gong'jia'ju	0
武汉办公家俱厂	wu'han'ban'gong'jia'ju'chang	0
武汉办公家具厂	wu'han'ban'gong'jia'ju'chang	0
武汉办公家俱厂家	wu'han'ban'gong'jia'ju'chang'jia	0
武汉办公家具厂家	wu'han'ban'gong'jia'ju'chang'jia	0
武汉办公家具厂江华	wu'han'ban'gong'jia'ju'chang'jiang'hua	0
武汉办公家具定制	wu'han'ban'gong'jia'ju'ding'zhi	0
武汉办公家具订制	wu'han'ban'gong'jia'ju'ding'zhi	0
武汉办公家俱定制厂家	wu'han'ban'gong'jia'ju'ding'zhi'chang'jia	0
武汉办公家具定制厂家	wu'han'ban'gong'jia'ju'ding'zhi'chang'jia	0
武汉办公家俱公司	wu'han'ban'gong'jia'ju'gong'si	0
武汉办公家具公司	wu'han'ban'gong'jia'ju'gong'si	0
武汉办公家具江华	wu'han'ban'gong'jia'ju'jiang'hua	0
武汉办公桌椅定制	wu'han'ban'gong'zhuo'yi'ding'zhi	0
武汉办公桌椅定做	wu'han'ban'gong'zhuo'yi'ding'zuo	0
武汉本地办公家具	wu'han'ben'di'ban'gong'jia'ju	0
武汉定制办公家具	wu'han'ding'zhi'ban'gong'jia'ju	0
武汉订制办公家具	wu'han'ding'zhi'ban'gong'jia'ju	0
武汉定做办公桌椅	wu'han'ding'zuo'ban'gong'zhuo'yi	0
武汉宿舍家具	wu'han'su'she'jia'ju	0
现代办公家具厂家	xian'dai'ban'gong'jia'ju'chang'jia	0
现代办公家具定制	xian'dai'ban'gong'jia'ju'ding'zhi	0
现代办公家具定做	xian'dai'ban'gong'jia'ju'ding'zuo	0
现代办公家具订做	xian'dai'ban'gong'jia'ju'ding'zuo	0
现代办公家具生产厂家	xian'dai'ban'gong'jia'ju'sheng'chan'chang'jia	0
现代办公桌椅厂家	xian'dai'ban'gong'zhuo'yi'chang'jia	0
现代办公桌椅定制	xian'dai'ban'gong'zhuo'yi'ding'zhi	0
写字楼办公家具厂家	xie'zi'lou'ban'gong'jia'ju'chang'jia	0
写字楼办公家具定制	xie'zi'lou'ban'gong'jia'ju'ding'zhi	0
新中式办公家具厂家	xin'zhong'shi'ban'gong'jia'ju'chang'jia	0
医用办公家具厂家	yi'yong'ban'gong'jia'ju'chang'jia	0
银行办公家具定制	yin'hang'ban'gong'jia'ju'ding'zhi	0
优质办公家具厂家	you'zhi'ban'gong'jia'ju'chang'jia	0
优质办公家具定制	you'zhi'ban'gong'jia'ju'ding'zhi	0
员工办公家具厂家	yuan'gong'ban'gong'jia'ju'chang'jia	0
员工寝室床	yuan'gong'qin'shi'chuang	0
员工宿舍床	yuan'gong'su'she'chuang	0
员工宿舍家具定做	yuan'gong'su'she'jia'ju'ding'zuo	0
找办公家具厂	zhao'ban'gong'jia'ju'chang	0
整体办公家具厂家	zheng'ti'ban'gong'jia'ju'chang'jia	0
整体办公家具定制	zheng'ti'ban'gong'jia'ju'ding'zhi	0
职工寝室床	zhi'gong'qin'shi'chuang	0
知名办公家具厂家	zhi'ming'ban'gong'jia'ju'chang'jia	0
知名办公家具定制	zhi'ming'ban'gong'jia'ju'ding'zhi	0
职员办公桌椅定制	zhi'yuan'ban'gong'zhuo'yi'ding'zhi	0
中高档办公家具定制	zhong'gao'dang'ban'gong'jia'ju'ding'zhi	0
中国办公家具绿色品牌	zhong'guo'ban'gong'jia'ju'lv'se'pin'pai	0
中国品牌办公家具	zhong'guo'pin'pai'ban'gong'jia'ju	0
中国著名办公家具品牌	zhong'guo'zhu'ming'ban'gong'jia'ju'pin'pai	0
中式办公家具厂家	zhong'shi'ban'gong'jia'ju'chang'jia	0
中式办公家具定制	zhong'shi'ban'gong'jia'ju'ding'zhi	0
著名办公家具厂家	zhu'ming'ban'gong'jia'ju'chang'jia	0
专业办公家具厂家	zhuan'ye'ban'gong'jia'ju'chang'jia	0
专业办公家具定制	zhuan'ye'ban'gong'jia'ju'ding'zhi	0
专业办公家具订制	zhuan'ye'ban'gong'jia'ju'ding'zhi	0
专业办公家具定制厂	zhuan'ye'ban'gong'jia'ju'ding'zhi'chang	0
专业办公家具定做	zhuan'ye'ban'gong'jia'ju'ding'zuo	0
专业办公家具公司	zhuan'ye'ban'gong'jia'ju'gong'si	0
专业办公桌椅厂家	zhuan'ye'ban'gong'zhuo'yi'chang'jia	0
专业定制办公家具	zhuan'ye'ding'zhi'ban'gong'jia'ju	0
桌椅办公定制	zhuo'yi'ban'gong'ding'zhi	0
组合宿舍家具	zu'he'su'she'jia'ju	0
做办公家具的厂家	zuo'ban'gong'jia'ju'de'chang'jia	0
