阿苯达唑颗粒	a'ben'da'zuo'ke'li	0
阿归养血颗粒	a'gui'yang'xue'ke'li	0
阿归养血糖浆	a'gui'yang'xue'tang'jiang	0
阿拉斯加深海鱼油	a'la'si'jia'shen'hai'yu'you	0
阿莫西林分散片	a'mo'xi'lin'fen'san'pian	0
阿莫西林胶囊	a'mo'xi'lin'jiao'nang	0
阿莫西林颗粒	a'mo'xi'lin'ke'li	0
阿奇霉素分散片	a'qi'mei'su'fen'san'pian	0
阿奇霉素颗粒	a'qi'mei'su'ke'li	0
阿奇霉素片	a'qi'mei'su'pian	0
艾附暖宫丸	ai'fu'nuan'gong'wan	0
艾滋病唾液检测	ai'zi'bing'tuo'ye'jian'ce	0
氨茶碱注射液	an'cha'jian'zhu'she'ye	0
氨酚伪麻那敏片	an'fen'wei'ma'na'min'pian	0
安宫牛黄丸	an'gong'niu'huang'wan	0
氨基酸百瑞祥	an'ji'suan'bai'rui'xiang	0
氨基酸高钙片	an'ji'suan'gao'gai'pian	0
氨基酸口服液	an'ji'suan'kou'fu'ye	0
氨咖黄敏胶囊	an'ka'huang'min'jiao'nang	0
氨咖黄敏片	an'ka'huang'min'pian	0
安神补脑液	an'shen'bu'nao'ye	0
安神丸	an'shen'wan	0
奥美拉唑肠溶胶囊	ao'mei'la'zuo'chang'rong'jiao'nang	0
八味和胃口服液	ba'wei'he'wei'kou'fu'ye	0
八珍益母丸	ba'zhen'yi'mu'wan	0
白带丸	bai'dai'wan	0
白蛋白	bai'dan'bai	0
白癜风丸	bai'dian'feng'wan	0
百咳静糖浆	bai'ke'jing'tang'jiang	0
百泉健胃消食片	bai'quan'jian'wei'xiao'shi'pian	0
白色念珠菌抗体	bai'se'nian'zhu'jun'kang'ti	0
白色念珠菌抗原	bai'se'nian'zhu'jun'kang'yuan	0
白血病免疫分型	bai'xue'bing'mian'yi'fen'xing	0
柏子养心丸	bai'zi'yang'xin'wan	0
板蓝根	ban'lan'gen	0
板蓝根滴丸	ban'lan'gen'di'wan	0
板蓝根含片	ban'lan'gen'han'pian	0
板蓝根颗粒	ban'lan'gen'ke'li	0
板蓝根凉茶	ban'lan'gen'liang'cha	0
斑贴试验	ban'tie'shi'yan	0
宝宝吃饭香口服液	bao'bao'chi'fan'xiang'kou'fu'ye	0
宝宝乐	bao'bao'le	0
宝宝湿疹	bao'bao'shi'zhen	0
爆拆灵保湿嫩白柔滑	bao'chai'ling'bao'shi'nen'bai'rou'hua	0
爆拆灵凡士林健肤	bao'chai'ling'fan'shi'lin'jian'fu	0
爆拆灵凡士林健肤倍润细致	bao'chai'ling'fan'shi'lin'jian'fu'bei'run'xi'zhi	0
爆拆灵蜂胶倍护	bao'chai'ling'feng'jiao'bei'hu	0
爆拆灵蜂胶倍护营养润泽	bao'chai'ling'feng'jiao'bei'hu'ying'yang'run'ze	0
爆拆灵芦荟滋养	bao'chai'ling'lu'hui'zi'yang	0
爆拆灵芦荟滋养深层呵护	bao'chai'ling'lu'hui'zi'yang'shen'ceng'he'hu	0
保喉片	bao'hou'pian	0
保胎灵	bao'tai'ling	0
保胎无忧片	bao'tai'wu'you'pian	0
贝诺酯片	bei'nuo'zhi'pian	0
北芪精	bei'qi'jing	0
北芪精口服液	bei'qi'jing'kou'fu'ye	0
碧春源长润茶	bi'chun'yuan'chang'run'cha	0
吡诺克辛钠滴眼液	bi'nuo'ke'xin'na'di'yan'ye	0
鼻炎立通	bi'yan'li'tong	0
鼻炎灵	bi'yan'ling	0
鼻炎灵片	bi'yan'ling'pian	0
苄达赖氨酸滴眼液	bian'da'lai'an'suan'di'yan'ye	0
便立通常润茶	bian'li'tong'chang'run'cha	0
兵兵镇痛贴	bing'bing'zhen'tong'tie	0
槟榔十三味丸	bing'lang'shi'san'wei'wan	0
槟榔四消丸	bing'lang'si'xiao'wan	0
冰硼散	bing'peng'san	0
玻璃体温计口腔型	bo'li'ti'wen'ji'kou'qiang'xing	0
玻璃体温计腋下大	bo'li'ti'wen'ji'ye'xia'da	0
布洛芬胶囊	bu'luo'fen'jiao'nang	0
布洛芬颗粒红色	bu'luo'fen'ke'li'hong'se	0
布洛芬颗粒蓝色	bu'luo'fen'ke'li'lan'se	0
布洛芬片	bu'luo'fen'pian	0
补脑安神片	bu'nao'an'shen'pian	0
补肾强身片	bu'shen'qiang'shen'pian	0
采血管	cai'xie'guan	0
参苏片	can'su'pian	0
草珊瑚含片	cao'shan'hu'han'pian	0
肠清茶	chang'qing'cha	0
肠胃宁片	chang'wei'ning'pian	0
虫草氨基酸	chong'cao'an'ji'suan	0
虫草灵芝参茸乌鸡白凤液	chong'cao'ling'zhi'shen'rong'wu'ji'bai'feng'ye	0
川贝枇杷糖浆	chuan'bei'pi'pa'tang'jiang	0
川贝清肺糖浆	chuan'bei'qing'fei'tang'jiang	0
川贝止咳糖浆	chuan'bei'zhi'ke'tang'jiang	0
传染性虱病镜检	chuan'ran'xing'shi'bing'jing'jian	0
穿心莲片	chuan'xin'lian'pian	0
创可贴	chuang'ke'tie	0
雌激素	ci'ji'su	0
促黄体生成素	cu'huang'ti'sheng'cheng'su	0
促进泡生成素	cu'jin'pao'sheng'cheng'su	0
促肾上腺皮质激素	cu'shen'shang'xian'pi'zhi'ji'su	0
醋酸地塞米松片	cu'suan'di'sai'mi'song'pian	0
醋酸氟轻松乳膏	cu'suan'fu'qing'song'ru'gao	0
醋酸萘酚酯酶染色	cu'suan'nai'fen'zhi'mei'ran'se	0
醋酸曲安奈德注射液	cu'suan'qu'an'nai'de'zhu'she'ye	0
催乳素	cui'ru'su	0
大败毒胶囊	da'bai'du'jiao'nang	0
大黄蟅虫胶囊	da'huang'zhe'chong'jiao'nang	0
大活络丸	da'huo'luo'wan	0
大山楂丸	da'shan'zha'wan	0
胆固醇	dan'gu'chun	0
单核细胞化学趋化因子	dan'he'xi'bao'hua'xue'qu'hua'yin'zi	0
胆红素	dan'hong'su	0
胆香鼻炎片	dan'xiang'bi'yan'pian	0
胆汁酸	dan'zhi'suan	0
丹栀逍遥丸	dan'zhi'xiao'yao'wan	0
滴虫霉菌性病检验	di'chong'mei'jun'xing'bing'jian'yan	0
低密度脂蛋白	di'mi'du'zhi'dan'bai	0
地塞米松磷酸钠注射液	di'sai'mi'song'lin'suan'na'zhu'she'ye	0
地西泮片	di'xi'pan'pian	0
淀粉酶	dian'fen'mei	0
典雅精品装蓝色	dian'ya'jing'pin'zhuang'lan'se	0
典雅精品装紫色	dian'ya'jing'pin'zhuang'zi'se	0
跌打活血散	die'da'huo'xue'san	0
跌打扭伤灵酊	die'da'niu'shang'ling'ding	0
跌打损伤	die'da'sun'shang	0
跌打万花油	die'da'wan'hua'you	0
丁酸萘酚酯酶染色	ding'suan'nai'fen'zhi'mei'ran'se	0
丁维葡萄糖	ding'wei'pu'tao'tang	0
冬虫夏草	dong'chong'xia'cao	0
冻疮膏	dong'chuang'gao	0
冬凌草片	dong'ling'cao'pian	0
独活寄生丸	du'huo'ji'sheng'wan	0
度米芬含片	du'mi'fen'han'pian	0
断血流胶囊	duan'xue'liu'jiao'nang	0
对乙酰氨基酚口服溶液	dui'yi'xian'an'ji'fen'kou'fu'rong'ye	0
对乙酰氨基酚片	dui'yi'xian'an'ji'fen'pian	0
多潘立酮胶囊	duo'pan'li'tong'jiao'nang	0
多潘立酮片吗丁啉	duo'pan'li'tong'pian'ma'ding'lin	0
多维葡萄糖	duo'wei'pu'tao'tang	0
多维元素片金维他	duo'wei'yuan'su'pian'jin'wei'ta	0
阿胶补血胶囊	e'jiao'bu'xue'jiao'nang	0
阿胶补血颗粒	e'jiao'bu'xue'ke'li	0
阿胶补血口服液	e'jiao'bu'xue'kou'fu'ye	0
阿胶蛋白高钙颗粒	e'jiao'dan'bai'gao'gai'ke'li	0
阿胶浆红	e'jiao'jiang'hong	0
阿胶浆黄	e'jiao'jiang'huang	0
阿胶颗粒	e'jiao'ke'li	0
阿胶鹿茸气血颗粒	e'jiao'lu'rong'qi'xue'ke'li	0
阿胶参茸气血颗粒	e'jiao'shen'rong'qi'xue'ke'li	0
阿胶益寿口服液	e'jiao'yi'shou'kou'fu'ye	0
阿胶枣	e'jiao'zao	0
儿宝膏	er'bao'gao	0
耳聋左慈丸	er'long'zuo'ci'wan	0
耳舒滴耳液	er'shu'di'er'ye	0
儿童高钙百瑞祥	er'tong'gao'gai'bai'rui'xiang	0
儿童高钙片	er'tong'gao'gai'pian	0
儿童果蔬膳食纤维素颗粒	er'tong'guo'shu'shan'shi'xian'wei'su'ke'li	0
儿童开胃益生菌颗粒	er'tong'kai'wei'yi'sheng'jun'ke'li	0
儿童型骨黄金高钙片	er'tong'xing'gu'huang'jin'gao'gai'pian	0
防风通圣丸	fang'feng'tong'sheng'wan	0
防水创口贴	fang'shui'chuang'kou'tie	0
防水卡通创口贴	fang'shui'ka'tong'chuang'kou'tie	0
肥儿宝颗粒	fei'er'bao'ke'li	0
肥儿口服液	fei'er'kou'fu'ye	0
肺炎支原体	fei'yan'zhi'yuan'ti	0
酚麻美软胶囊大灵诺	fen'ma'mei'ruan'jiao'nang'da'ling'nuo	0
酚麻美软胶囊小灵诺	fen'ma'mei'ruan'jiao'nang'xiao'ling'nuo	0
丰乳霜	feng'ru'shuang	0
风湿关节炎片	feng'shi'guan'jie'yan'pian	0
风湿性关节痛	feng'shi'xing'guan'jie'tong	0
复方氨酚那敏颗粒	fu'fang'an'fen'na'min'ke'li	0
复方氨酚烷胺片	fu'fang'an'fen'wan'an'pian	0
复方氨酚烷胺片感康	fu'fang'an'fen'wan'an'pian'gan'kang	0
复方氨基酸鳌合钙胶囊	fu'fang'an'ji'suan'ao'he'gai'jiao'nang	0
复方氨基酸注射液	fu'fang'an'ji'suan'zhu'she'ye	0
复方氨林巴比妥注射液	fu'fang'an'lin'ba'bi'tuo'zhu'she'ye	0
复方板蓝根	fu'fang'ban'lan'gen	0
复方板蓝根颗粒	fu'fang'ban'lan'gen'ke'li	0
复方醋酸地塞米松乳膏	fu'fang'cu'suan'di'sai'mi'song'ru'gao	0
复方醋酸氟轻松酊	fu'fang'cu'suan'fu'qing'song'ding	0
复方丹参片	fu'fang'dan'shen'pian	0
复方胆通胶囊	fu'fang'dan'tong'jiao'nang	0
复方胆熊通鼻喷雾剂	fu'fang'dan'xiong'tong'bi'pen'wu'ji	0
复方冬凌草含片	fu'fang'dong'ling'cao'han'pian	0
复方阿胶浆	fu'fang'e'jiao'jiang	0
复方莪术油栓	fu'fang'e'zhu'you'shuan	0
复方感冒灵片	fu'fang'gan'mao'ling'pian	0
复方岗松止痒洗痒	fu'fang'gang'song'zhi'yang'xi'yang	0
复方公英片	fu'fang'gong'ying'pian	0
复方黄连素片	fu'fang'huang'lian'su'pian	0
复方鸡内金片	fu'fang'ji'nei'jin'pian	0
复方桔梗止咳片	fu'fang'jie'geng'zhi'ke'pian	0
复方金钱草颗粒	fu'fang'jin'qian'cao'ke'li	0
复方苦参水杨酸散	fu'fang'ku'shen'shui'yang'suan'san	0
复方联苯苄唑乳膏	fu'fang'lian'ben'bian'zuo'ru'gao	0
复方罗汉果清肺糖浆	fu'fang'luo'han'guo'qing'fei'tang'jiang	0
复方罗汉果止咳颗粒	fu'fang'luo'han'guo'zhi'ke'ke'li	0
复方氯化钠滴眼液	fu'fang'lv'hua'na'di'yan'ye	0
复方门冬维甘滴眼液	fu'fang'men'dong'wei'gan'di'yan'ye	0
复方枇杷止咳颗粒	fu'fang'pi'pa'zhi'ke'ke'li	0
复方气管炎片	fu'fang'qi'guan'yan'pian	0
复方氢溴酸东莨菪碱贴膏	fu'fang'qing'xiu'suan'dong'lang'dang'jian'tie'gao	0
复方三七胶囊	fu'fang'san'qi'jiao'nang	0
复方石韦胶囊	fu'fang'shi'wei'jiao'nang	0
复方酮康唑发用洗剂	fu'fang'tong'kang'zuo'fa'yong'xi'ji	0
复方酮康唑软膏	fu'fang'tong'kang'zuo'ruan'gao	0
复方五倍子水杨酸搽剂	fu'fang'wu'bei'zi'shui'yang'suan'cha'ji	0
复方硝酸咪康唑软膏拜尼多	fu'fang'xiao'suan'mi'kang'zuo'ruan'gao'bai'ni'duo	0
复方消痔栓	fu'fang'xiao'zhi'shuan	0
复方羊角片	fu'fang'yang'jiao'pian	0
复方愈创木酚磺酸钾口服溶液	fu'fang'yu'chuang'mu'fen'huang'suan'jia'kou'fu'rong'ye	0
复方愈创木酚磺酸钾口服液	fu'fang'yu'chuang'mu'fen'huang'suan'jia'kou'fu'ye	0
复方鱼腥草软胶囊	fu'fang'yu'xing'cao'ruan'jiao'nang	0
复方珍珠暗疮片	fu'fang'zhen'zhu'an'chuang'pian	0
复方祖司麻止痛膏	fu'fang'zu'si'ma'zhi'tong'gao	0
复合氨基酸	fu'he'an'ji'suan	0
妇康宁片	fu'kang'ning'pian	0
氟康唑胶囊	fu'kang'zuo'jiao'nang	0
妇科花红洗液	fu'ke'hua'hong'xi'ye	0
妇科千金洗液	fu'ke'qian'jin'xi'ye	0
妇科调经片	fu'ke'tiao'jing'pian	0
妇科止带胶囊	fu'ke'zhi'dai'jiao'nang	0
妇科止带片	fu'ke'zhi'dai'pian	0
妇科止血灵	fu'ke'zhi'xue'ling	0
富马酸酮替芬滴鼻液	fu'ma'suan'tong'ti'fen'di'bi'ye	0
腹痛水	fu'tong'shui	0
妇炎净片	fu'yan'jing'pian	0
妇炎康复片	fu'yan'kang'fu'pian	0
妇炎康片	fu'yan'kang'pian	0
妇炎康片丸	fu'yan'kang'pian'wan	0
钙葡萄糖	gai'pu'tao'tang	0
钙铁锌硒维生素	gai'tie'xin'xi'wei'sheng'su	0
钙铁锌硒维生素口服液	gai'tie'xin'xi'wei'sheng'su'kou'fu'ye	0
钙锌葡萄糖	gai'xin'pu'tao'tang	0
钙中钙葡萄糖	gai'zhong'gai'pu'tao'tang	0
甘草含片	gan'cao'han'pian	0
甘草片	gan'cao'pian	0
感冒安片	gan'mao'an'pian	0
感冒解毒灵颗粒	gan'mao'jie'du'ling'ke'li	0
感冒咳嗽颗粒	gan'mao'ke'sou'ke'li	0
感冒灵胶囊	gan'mao'ling'jiao'nang	0
感冒灵颗粒	gan'mao'ling'ke'li	0
感冒灵颗粒红	gan'mao'ling'ke'li'hong	0
感冒清胶囊	gan'mao'qing'jiao'nang	0
感冒清热颗粒	gan'mao'qing're'ke'li	0
感冒软胶囊	gan'mao'ruan'jiao'nang	0
感冒疏风颗粒	gan'mao'shu'feng'ke'li	0
感冒退烧片	gan'mao'tui'shao'pian	0
甘宁片	gan'ning'pian	0
甘油三酯	gan'you'san'zhi	0
高密度脂蛋白	gao'mi'du'zhi'dan'bai	0
革兰氏阴性	ge'lan'shi'yin'xing	0
弓形体抗体阳性定性	gong'xing'ti'kang'ti'yang'xing'ding'xing	0
汞溴红溶液	gong'xiu'hong'rong'ye	0
宫炎平胶囊	gong'yan'ping'jiao'nang	0
固本咳喘胶囊	gu'ben'ke'chuan'jiao'nang	0
谷丙转氨酶	gu'bing'zhuan'an'mei	0
谷草转氨酶	gu'cao'zhuan'an'mei	0
骨黄金高钙	gu'huang'jin'gao'gai	0
骨筋丸胶囊	gu'jin'wan'jiao'nang	0
固肾生发丸	gu'shen'sheng'fa'wan	0
骨髓巨核细胞定量计数分类分析	gu'sui'ju'he'xi'bao'ding'liang'ji'shu'fen'lei'fen'xi	0
骨髓细胞形态学诊断检查	gu'sui'xi'bao'xing'tai'xue'zhen'duan'jian'cha	0
骨质增生	gu'zhi'zeng'sheng	0
关节止痛膏	guan'jie'zhi'tong'gao	0
关节止痛膏精装	guan'jie'zhi'tong'gao'jing'zhuang	0
灌洗液常规检查	guan'xi'ye'chang'gui'jian'cha	0
广东凉茶	guang'dong'liang'cha	0
广东凉茶颗粒	guang'dong'liang'cha'ke'li	0
龟甲胶颗粒	gui'jia'jiao'ke'li	0
龟鹿驴三胶颗粒	gui'lu'lv'san'jiao'ke'li	0
归脾丸	gui'pi'wan	0
桂枝茯苓胶囊	gui'zhi'fu'ling'jiao'nang	0
桂枝茯苓丸	gui'zhi'fu'ling'wan	0
果茶抽油瘦	guo'cha'chou'you'shou	0
过岗龙片	guo'gang'long'pian	0
过敏原检测吸入组食物组	guo'min'yuan'jian'ce'xi'ru'zu'shi'wu'zu	0
过氧化物酶染色	guo'yang'hua'wu'mei'ran'se	0
海曲钠注射用头孢曲松钠	hai'qu'na'zhu'she'yong'tou'bao'qu'song'na	0
汗斑净	han'ban'jing	0
翰邦烧焊王	han'bang'shao'han'wang	0
合成鱼腥草素片	he'cheng'yu'xing'cao'su'pian	0
红霉素乳膏	hong'mei'su'ru'gao	0
红药片	hong'yao'pian	0
喉疾灵片	hou'ji'ling'pian	0
喉舒宁片	hou'shu'ning'pian	0
喉痛解毒丸	hou'tong'jie'du'wan	0
喉痛灵颗粒	hou'tong'ling'ke'li	0
喉痛灵片	hou'tong'ling'pian	0
猴头菌片	hou'tou'jun'pian	0
狐臭半月清	hu'chou'ban'yue'qing	0
护肝宁片	hu'gan'ning'pian	0
胡日查六味丸	hu'ri'cha'liu'wei'wan	0
呼吸道病毒检测	hu'xi'dao'bing'du'jian'ce	0
琥乙红霉素颗粒利君沙	hu'yi'hong'mei'su'ke'li'li'jun'sha	0
花斑菌镜检	hua'ban'jun'jing'jian	0
花红洗液	hua'hong'xi'ye	0
花蛇解痒片	hua'she'jie'yang'pian	0
化痰平喘片	hua'tan'ping'chuan'pian	0
华佗烧烫伤	hua'tuo'shao'tang'shang	0
华佗痔疮膏	hua'tuo'zhi'chuang'gao	0
槐角丸	huai'jiao'wan	0
黄柏胶囊	huang'bai'jiao'nang	0
黄大夫足光粉	huang'dai'fu'zu'guang'fen	0
黄金因子	huang'jin'yin'zi	0
黄金茵子口服液	huang'jin'yin'zi'kou'fu'ye	0
黄苦洗液	huang'ku'xi'ye	0
黄连上清片	huang'lian'shang'qing'pian	0
黄连上清丸	huang'lian'shang'qing'wan	0
黄芪精	huang'qi'jing	0
黄瑞香注射液	huang'rui'xiang'zhu'she'ye	0
黄藤素片	huang'teng'su'pian	0
黄体酮注射液	huang'ti'tong'zhu'she'ye	0
霍胆丸	huo'dan'wan	0
藿香清胃胶囊	huo'xiang'qing'wei'jiao'nang	0
藿香正气片	huo'xiang'zheng'qi'pian	0
藿香正气软胶囊	huo'xiang'zheng'qi'ruan'jiao'nang	0
藿香正气丸	huo'xiang'zheng'qi'wan	0
活血理伤丸	huo'xue'li'shang'wan	0
活血止痛膏	huo'xue'zhi'tong'gao	0
活血止痛胶囊	huo'xue'zhi'tong'jiao'nang	0
活血止痛片	huo'xue'zhi'tong'pian	0
肌钙蛋白	ji'gai'dan'bai	0
肌酐	ji'gan	0
肌酐清除率	ji'gan'qing'chu'lv	0
肌苷注射液	ji'gan'zhu'she'ye	0
激情大颗粒绿色	ji'qing'da'ke'li'lv'se	0
肌酸激酶	ji'suan'ji'mei	0
极致避孕套红色	ji'zhi'bi'yun'tao'hong'se	0
极致避孕套蓝色	ji'zhi'bi'yun'tao'lan'se	0
极致避孕套绿色	ji'zhi'bi'yun'tao'lv'se	0
急支糖浆	ji'zhi'tang'jiang	0
极致天然胶乳橡胶避孕套	ji'zhi'tian'ran'jiao'ru'xiang'jiao'bi'yun'tao	0
基质细胞源性因子	ji'zhi'xi'bao'yuan'xing'yin'zi	0
甲砜霉素胶囊	jia'feng'mei'su'jiao'nang	0
甲肝抗体	jia'gan'kang'ti	0
甲硝唑氯乙定洗剂	jia'xiao'zuo'lv'yi'ding'xi'ji	0
甲硝唑氯已定洗剂	jia'xiao'zuo'lv'yi'ding'xi'ji	0
甲硝唑片	jia'xiao'zuo'pian	0
甲硝唑注射液	jia'xiao'zuo'zhu'she'ye	0
甲状旁腺激素	jia'zhuang'pang'xian'ji'su	0
甲紫溶液	jia'zi'rong'ye	0
健儿排铅	jian'er'pai'qian	0
健儿三宝	jian'er'san'bao	0
间接胆红质	jian'jie'dan'hong'zhi	0
健脑安神片	jian'nao'an'shen'pian	0
尖锐湿疣醋酸白实验	jian'rui'shi'you'cu'suan'bai'shi'yan	0
健胃止痛片	jian'wei'zhi'tong'pian	0
碱性磷酸酶	jian'xing'lin'suan'mei	0
肩周炎	jian'zhou'yan	0
肩周炎贴	jian'zhou'yan'tie	0
降脂宁颗粒	jiang'zhi'ning'ke'li	0
交沙霉素片	jiao'sha'mei'su'pian	0
疥疮镜检	jie'chuang'jing'jian	0
结核杆菌	jie'he'gan'jun	0
结核印迹试验	jie'he'yin'ji'shi'yan	0
戒烟灵	jie'yan'ling	0
解郁安神颗粒	jie'yu'an'shen'ke'li	0
金刚藤胶囊	jin'gang'teng'jiao'nang	0
筋骨疼痛	jin'gu'teng'tong	0
金菊利咽含片	jin'ju'li'yan'han'pian	0
金菊罗汉果	jin'ju'luo'han'guo	0
金皮康王	jin'pi'kang'wang	0
金皮康王软膏	jin'pi'kang'wang'ruan'gao	0
金钱草	jin'qian'cao	0
金钱草颗粒	jin'qian'cao'ke'li	0
金嗓子喉片	jin'sang'zi'hou'pian	0
金维他	jin'wei'ta	0
金西瓜霜含片	jin'xi'gua'shuang'han'pian	0
金宵左炔诺孕酮片	jin'xiao'zuo'que'nuo'yun'tong'pian	0
金癣清	jin'xuan'qing	0
金银花含片	jin'yin'hua'han'pian	0
金银花颗粒	jin'yin'hua'ke'li	0
金银花露	jin'yin'hua'lu	0
净石灵胶囊	jing'shi'ling'jiao'nang	0
颈腰椎	jing'yao'zhui	0
精致狗皮膏	jing'zhi'gou'pi'gao	0
精制银翘解毒片	jing'zhi'yin'qiao'jie'du'pian	0
颈椎病	jing'zhui'bing	0
颈椎病贴	jing'zhui'bing'tie	0
酒仕康	jiu'shi'kang	0
九味羌活丸	jiu'wei'qiang'huo'wan	0
酒友	jiu'you	0
巨噬细胞感染趋化因子	ju'shi'xi'bao'gan'ran'qu'hua'yin'zi	0
聚维酮碘溶液	ju'wei'tong'dian'rong'ye	0
聚维酮碘栓	ju'wei'tong'dian'shuan	0
巨细胞病毒抗体定性	ju'xi'bao'bing'du'kang'ti'ding'xing	0
枸橼酸喷托维林片	ju'yuan'suan'pen'tuo'wei'lin'pian	0
军团菌抗原检测	jun'tuan'jun'kang'yuan'jian'ce	0
卡洛磺钠氯化钠注射液	ka'luo'huang'na'lv'hua'na'zhu'she'ye	0
卡通防水创可贴	ka'tong'fang'shui'chuang'ke'tie	0
开胃消食	kai'wei'xiao'shi	0
开胸顺气丸	kai'xiong'shun'qi'wan	0
抗扁桃腺炎合剂	kang'bian'tao'xian'yan'he'ji	0
抗病毒口服液	kang'bing'du'kou'fu'ye	0
抗病毒凉茶	kang'bing'du'liang'cha	0
抗骨增生片	kang'gu'zeng'sheng'pian	0
抗骨增生丸	kang'gu'zeng'sheng'wan	0
抗菌消炎胶囊	kang'jun'xiao'yan'jiao'nang	0
康乐鼻炎片	kang'le'bi'yan'pian	0
康乃馨抗菌洗剂	kang'nai'xin'kang'jun'xi'ji	0
康乃馨洗剂	kang'nai'xin'xi'ji	0
抗腿抽筋高钙片	kang'tui'chou'jin'gao'gai'pian	0
康旺消毒剂	kang'wang'xiao'du'ji	0
咳喘舒片	ke'chuan'shu'pian	0
克拉霉素胶囊	ke'la'mei'su'jiao'nang	0
克拉霉素片	ke'la'mei'su'pian	0
克林霉素磷酸酯注射液	ke'lin'mei'su'lin'suan'zhi'zhu'she'ye	0
克霉唑乳膏	ke'mei'zuo'ru'gao	0
克霉唑栓	ke'mei'zuo'shuan	0
克霉唑阴道片	ke'mei'zuo'yin'dao'pian	0
咳特灵胶囊	ke'te'ling'jiao'nang	0
克银丸	ke'yin'wan	0
口服葡萄糖	kou'fu'pu'tao'tang	0
苦参洗剂	ku'shen'xi'ji	0
苦参洗液	ku'shen'xi'ye	0
辣椒风湿膏	la'jiao'feng'shi'gao	0
兰索拉唑片	lan'suo'la'zuo'pian	0
了哥王胶囊	le'ge'wang'jiao'nang	0
乐力钙	le'li'gai	0
乐力钙百瑞祥	le'li'gai'bai'rui'xiang	0
乐旅晕车贴	le'lv'yun'che'tie	0
乐舒	le'shu	0
利巴韦林含片	li'ba'wei'lin'han'pian	0
利巴韦林注射液	li'ba'wei'lin'zhu'she'ye	0
利凡诺创伤膏	li'fan'nuo'chuang'shang'gao	0
利肺片	li'fei'pian	0
丽姝因银离子妇用凝胶剂	li'shu'yin'yin'li'zi'fu'yong'ning'jiao'ji	0
粒细胞刺激因子	li'xi'bao'ci'ji'yin'zi	0
利咽灵片	li'yan'ling'pian	0
联苯苄唑乳膏	lian'ben'bian'zuo'ru'gao	0
链球菌抗原	lian'qiu'jun'kang'yuan	0
莲芝消炎片	lian'zhi'xiao'yan'pian	0
亮甲	liang'jia	0
淋病快速检测	lin'bing'kuai'su'jian'ce	0
临床形态学诊断会诊	lin'chuang'xing'tai'xue'zhen'duan'hui'zhen	0
林可霉素利多卡因凝胶	lin'ke'mei'su'li'duo'ka'yin'ning'jiao	0
淋球菌	lin'qiu'jun	0
淋球菌培养取材	lin'qiu'jun'pei'yang'qu'cai	0
磷酸苯丙哌林片	lin'suan'ben'bing'pai'lin'pian	0
羚锐保湿护肤甘油	ling'rui'bao'shi'hu'fu'gan'you	0
羚锐儿童肤宝	ling'rui'er'tong'fu'bao	0
羚锐金康王	ling'rui'jin'kang'wang	0
羚锐止痒灵	ling'rui'zhi'yang'ling	0
硫酸阿米卡星注射液	liu'suan'a'mi'ka'xing'zhu'she'ye	0
硫酸阿托品注射液	liu'suan'a'tuo'pin'zhu'she'ye	0
硫酸镁注射液	liu'suan'mei'zhu'she'ye	0
硫酸庆大霉素注射液	liu'suan'qing'da'mei'su'zhu'she'ye	0
六味地黄丸	liu'wei'di'huang'wan	0
六味地黄丸铁盒	liu'wei'di'huang'wan'tie'he	0
六味地黄丸纸盒	liu'wei'di'huang'wan'zhi'he	0
龙胆泻肝丸	long'dan'xie'gan'wan	0
龙血竭胶囊	long'xue'jie'jiao'nang	0
炉甘石洗剂	lu'gan'shi'xi'ji	0
鹿龟驴三胶颗粒	lu'gui'lv'san'jiao'ke'li	0
六合定中丸	lu'he'ding'zhong'wan	0
芦荟胶囊	lu'hui'jiao'nang	0
芦荟排毒四季下火王凉茶	lu'hui'pai'du'si'ji'xia'huo'wang'liang'cha	0
芦荟清肠茶	lu'hui'qing'chang'cha	0
鹿角胶颗粒	lu'jiao'jiao'ke'li	0
罗汉果川贝枇杷膏	luo'han'guo'chuan'bei'pi'pa'gao	0
罗汉果含片	luo'han'guo'han'pian	0
罗汉果蜜炼枇杷膏	luo'han'guo'mi'lian'pi'pa'gao	0
罗汉果止咳胶囊	luo'han'guo'zhi'ke'jiao'nang	0
罗红霉素分散片	luo'hong'mei'su'fen'san'pian	0
罗红霉素胶囊	luo'hong'mei'su'jiao'nang	0
罗红霉素颗粒	luo'hong'mei'su'ke'li	0
罗红霉素片	luo'hong'mei'su'pian	0
螺旋藻软胶囊	luo'xuan'zao'ruan'jiao'nang	0
氯醋酸萘酚酶染色	lv'cu'suan'nai'fen'mei'ran'se	0
氯芬黄敏片	lv'fen'huang'min'pian	0
氯化钙溴化钠注射液	lv'hua'gai'xiu'hua'na'zhu'she'ye	0
氯化钠注射液	lv'hua'na'zhu'she'ye	0
率较颗粒	lv'jiao'ke'li	0
驴胶鹿茸补血颗粒平碗	lv'jiao'lu'rong'bu'xue'ke'li'ping'wan	0
氯雷他定片	lv'lei'ta'ding'pian	0
氯霉素滴眼液	lv'mei'su'di'yan'ye	0
氯霉素注射液	lv'mei'su'zhu'she'ye	0
氯诺昔康片	lv'nuo'xi'kang'pian	0
马来酸氯苯那敏片	ma'lai'suan'lv'ben'na'min'pian	0
马来酸左旋氨氯地平片	ma'lai'suan'zuo'xuan'an'lv'di'ping'pian	0
麻仁丸	ma'ren'wan	0
麻杏止咳糖浆	ma'xing'zhi'ke'tang'jiang	0
麦冬夏桑菊	mai'dong'xia'sang'ju	0
螨虫镜检	man'chong'jing'jian	0
毛囊虫镜检	mao'nang'chong'jing'jian	0
梅毒螺旋体	mei'du'luo'xuan'ti	0
美肤烧伤喷剂	mei'fu'shao'shang'pen'ji	0
梅花鹿茸血	mei'hua'lu'rong'xue	0
米非司酮片	mi'fei'si'tong'pian	0
蜜炼川贝枇杷膏	mi'lian'chuan'bei'pi'pa'gao	0
蜜炼川贝枇杷含片	mi'lian'chuan'bei'pi'pa'han'pian	0
密炼川贝枇杷含片	mi'lian'chuan'bei'pi'pa'han'pian	0
蜜炼橘红枇杷膏	mi'lian'ju'hong'pi'pa'gao	0
迷人红	mi'ren'hong	0
免疫球蛋白	mian'yi'qiu'dan'bai	0
免疫荧光检查	mian'yi'ying'guang'jian'cha	0
免疫组化验查	mian'yi'zu'hua'yan'cha	0
明目地黄丸	ming'mu'di'huang'wan	0
木香分气丸	mu'xiang'fen'qi'wan	0
木香顺气丸	mu'xiang'shun'qi'wan	0
奶伴侣钙铁锌硒清火宝	nai'ban'lv'gai'tie'xin'xi'qing'huo'bao	0
奶伴侣开胃消食清火宝	nai'ban'lv'kai'wei'xiao'shi'qing'huo'bao	0
奶伴侣免疫蛋白清火宝	nai'ban'lv'mian'yi'dan'bai'qing'huo'bao	0
奶伴侣双岐因子清火宝	nai'ban'lv'shuang'qi'yin'zi'qing'huo'bao	0
萘敏维滴眼液	nai'min'wei'di'yan'ye	0
萘普生钠麻黄碱缓释片	nai'pu'sheng'na'ma'huang'jian'huan'shi'pian	0
脑脊液生化糖	nao'ji'ye'sheng'hua'tang	0
脑脊液细胞学检查	nao'ji'ye'xi'bao'xue'jian'cha	0
脑络通胶囊	nao'luo'tong'jiao'nang	0
脑栓通胶囊	nao'shuan'tong'jiao'nang	0
脑心舒口服液	nao'xin'shu'kou'fu'ye	0
尼美舒利分散片	ni'mei'shu'li'fen'san'pian	0
尼美舒利胶囊	ni'mei'shu'li'jiao'nang	0
尼美舒利颗粒	ni'mei'shu'li'ke'li	0
廿十四味凉茶	nian'shi'si'wei'liang'cha	0
尿皮质醇	niao'pi'zhi'chun	0
尿绒毛膜促性肥腺液素	niao'rong'mao'mo'cu'xing'fei'xian'ye'su	0
尿塞通片	niao'sai'tong'pian	0
尿渗透压	niao'shen'tou'ya	0
尿素氮	niao'su'dan	0
尿酸	niao'suan	0
尿微量白蛋白排泄率	niao'wei'liang'bai'dan'bai'pai'xie'lv	0
牛初乳高钙片	niu'chu'ru'gao'gai'pian	0
牛黄解毒片	niu'huang'jie'du'pian	0
牛黄清胃丸	niu'huang'qing'wei'wan	0
牛黄上清片	niu'huang'shang'qing'pian	0
牛黄蛇胆川贝胶囊	niu'huang'she'dan'chuan'bei'jiao'nang	0
牛磺酸滴眼液	niu'huang'suan'di'yan'ye	0
牛黄消炎片	niu'huang'xiao'yan'pian	0
牛皮癣	niu'pi'xuan	0
暖宫七味丸	nuan'gong'qi'wei'wan	0
暖宫孕子丸	nuan'gong'yun'zi'wan	0
诺氟沙星胶囊	nuo'fu'sha'xing'jiao'nang	0
诺爽左烩诺孕酮片	nuo'shuang'zuo'hui'nuo'yun'tong'pian	0
女金丸	nv'jin'wan	0
女人春	nv'ren'chun	0
排毒美肤胶囊	pai'du'mei'fu'jiao'nang	0
排毒瘦身茶金芦荟	pai'du'shou'shen'cha'jin'lu'hui	0
排毒养颜茶	pai'du'yang'yan'cha	0
排毒养颜胶囊	pai'du'yang'yan'jiao'nang	0
排油茶	pai'you'cha	0
胖大海含片	pang'da'hai'han'pian	0
盆炎净片	pen'yan'jing'pian	0
皮毒清软膏	pi'du'qing'ruan'gao	0
皮肤病理活检	pi'fu'bing'li'huo'jian	0
皮炎平	pi'yan'ping	0
苹果醋减肥胶囊	ping'guo'cu'jian'fei'jiao'nang	0
破伤风人免疫球蛋白注射液	po'shang'feng'ren'mian'yi'qiu'dan'bai'zhu'she'ye	0
蒲地蓝消炎片	pu'di'lan'xiao'yan'pian	0
蒲公英片	pu'gong'ying'pian	0
葡萄糖氯化钠注射液	pu'tao'tang'lv'hua'na'zhu'she'ye	0
葡萄糖酸钙片	pu'tao'tang'suan'gai'pian	0
葡萄糖酸钙注射液	pu'tao'tang'suan'gai'zhu'she'ye	0
葡萄糖注射液	pu'tao'tang'zhu'she'ye	0
杞菊地黄丸	qi'ju'di'huang'wan	0
气血双补	qi'xue'shuang'bu	0
千金湿痒洗液	qian'jin'shi'yang'xi'ye	0
前列康舒胶囊	qian'lie'kang'shu'jiao'nang	0
前列舒乐胶囊	qian'lie'shu'le'jiao'nang	0
千美足光粉	qian'mei'zu'guang'fen	0
羟丁酸脱氢酶	qiang'ding'suan'tuo'qing'mei	0
强筋健骨	qiang'jin'jian'gu	0
强筋健骨百瑞祥	qiang'jin'jian'gu'bai'rui'xiang	0
强力皮康王	qiang'li'pi'kang'wang	0
强力枇杷胶囊	qiang'li'pi'pa'jiao'nang	0
强力枇杷露	qiang'li'pi'pa'lu	0
清肠乐麻仁润通饮	qing'chang'le'ma'ren'run'tong'yin	0
清肺抑火片	qing'fei'yi'huo'pian	0
清肺抑火丸	qing'fei'yi'huo'wan	0
清宫排毒丸	qing'gong'pai'du'wan	0
青果丸	qing'guo'wan	0
清火胶囊	qing'huo'jiao'nang	0
清火乐	qing'huo'le	0
清火栀麦片	qing'huo'zhi'mai'pian	0
清开灵注射液	qing'kai'ling'zhu'she'ye	0
青霉素钾片	qing'mei'su'jia'pian	0
清热暗疮丸	qing're'an'chuang'wan	0
清热解毒颗粒	qing're'jie'du'ke'li	0
清热祛湿茶	qing're'qu'shi'cha	0
清热通淋片	qing're'tong'lin'pian	0
清热银花糖浆	qing're'yin'hua'tang'jiang	0
轻身减肥片	qing'shen'jian'fei'pian	0
清胃黄连丸	qing'wei'huang'lian'wan	0
氢溴酸右美沙芬糖浆	qing'xiu'suan'you'mei'sha'fen'tang'jiang	0
驱虫消食	qu'chong'xiao'shi	0
祛湿下火颗粒	qu'shi'xia'huo'ke'li	0
全鹿丸	quan'lu'wan	0
全天麻片	quan'tian'ma'pian	0
全血黏度	quan'xue'nian'du	0
热痱水	re'fei'shui	0
热淋清片	re'lin'qing'pian	0
人工牛黄甲硝唑胶囊	ren'gong'niu'huang'jia'xiao'zuo'jiao'nang	0
人参蜂王浆	ren'shen'feng'wang'jiang	0
人参归脾丸	ren'shen'gui'pi'wan	0
人体免疫白蛋白儿童型	ren'ti'mian'yi'bai'dan'bai'er'tong'xing	0
人体免疫白蛋白颗粒	ren'ti'mian'yi'bai'dan'bai'ke'li	0
人体免疫白蛋白中老年型	ren'ti'mian'yi'bai'dan'bai'zhong'lao'nian'xing	0
人血白蛋白注射液	ren'xue'bai'dan'bai'zhu'she'ye	0
乳酶生片	ru'mei'sheng'pian	0
乳酸	ru'suan	0
乳酸脱氢酶	ru'suan'tuo'qing'mei	0
乳酸依沙吖啶溶液	ru'suan'yi'sha'a'ding'rong'ye	0
润肺膏	run'fei'gao	0
三黄片	san'huang'pian	0
三磷酸腺苷二钠注射液	san'lin'suan'xian'gan'er'na'zhu'she'ye	0
三蛇胆川贝糖浆	san'she'dan'chuan'bei'tang'jiang	0
桑菊感冒片	sang'ju'gan'mao'pian	0
沙丁胺醇气雾剂	sha'ding'an'chun'qi'wu'ji	0
山楂内消丸	shan'zha'nei'xiao'wan	0
伤科跌打片	shang'ke'die'da'pian	0
上皮细胞	shang'pi'xi'bao	0
伤湿祛痛膏精装	shang'shi'qu'tong'gao'jing'zhuang	0
伤湿止痛膏	shang'shi'zhi'tong'gao	0
伤痛酊	shang'tong'ding	0
烧亮烧焊滴眼液	shao'liang'shao'han'di'yan'ye	0
烧烫伤软膏	shao'tang'shang'ruan'gao	0
蛇胆川贝胶囊	she'dan'chuan'bei'jiao'nang	0
蛇胆川贝枇杷膏	she'dan'chuan'bei'pi'pa'gao	0
蛇胆川贝液	she'dan'chuan'bei'ye	0
蛇胆蜜炼川贝枇杷膏	she'dan'mi'lian'chuan'bei'pi'pa'gao	0
麝香风湿胶囊	she'xiang'feng'shi'jiao'nang	0
麝香接骨胶囊	she'xiang'jie'gu'jiao'nang	0
麝香镇痛膏	she'xiang'zhen'tong'gao	0
麝香壮骨膏	she'xiang'zhuang'gu'gao	0
肾宝糖浆	shen'bao'tang'jiang	0
肾脾双补口服液	shen'pi'shuang'bu'kou'fu'ye	0
参芪首乌补汁	shen'qi'shou'wu'bu'zhi	0
参茸鞭丸	shen'rong'bian'wan	0
参茸蛤蚧保肾丸	shen'rong'ge'jie'bao'shen'wan	0
参茸肾宝口服液	shen'rong'shen'bao'kou'fu'ye	0
肾上腺色腙片	shen'shang'xian'se'zong'pian	0
肾石通颗粒	shen'shi'tong'ke'li	0
参苏丸	shen'su'wan	0
生长激素	sheng'zhang'ji'su	0
湿毒清片	shi'du'qing'pian	0
湿毒清软膏	shi'du'qing'ruan'gao	0
视清	shi'qing	0
十全大补丸	shi'quan'da'bu'wan	0
湿热清	shi're'qing	0
湿痒洗液	shi'yang'xi'ye	0
首乌延寿片	shou'wu'yan'shou'pian	0
舒肝健胃丸	shu'gan'jian'wei'wan	0
舒筋活血片	shu'jin'huo'xue'pian	0
舒筋通络贴	shu'jin'tong'luo'tie	0
双黄连粉针剂	shuang'huang'lian'fen'zhen'ji	0
双黄连口服液	shuang'huang'lian'kou'fu'ye	0
双金胃疡胶囊	shuang'jin'wei'yang'jiao'nang	0
双氯芬酸钠肠溶片	shuang'lv'fen'suan'na'chang'rong'pian	0
双氯芬酸钠栓	shuang'lv'fen'suan'na'shuan	0
双岐杆菌活菌胶囊	shuang'qi'gan'jun'huo'jun'jiao'nang	0
双歧因子清火宝	shuang'qi'yin'zi'qing'huo'bao	0
双唑泰栓	shuang'zuo'tai'shuan	0
四季感冒茶	si'ji'gan'mao'cha	0
四季感冒胶囊	si'ji'gan'mao'jiao'nang	0
四季感冒片	si'ji'gan'mao'pian	0
四季清凉茶	si'ji'qing'liang'cha	0
四神丸	si'shen'wan	0
四项诱导血小板聚集功能测试	si'xiang'you'dao'xue'xiao'ban'ju'ji'gong'neng'ce'shi	0
四消丸	si'xiao'wan	0
苏丹黑染色	su'dan'hei'ran'se	0
速感宁胶囊	su'gan'ning'jiao'nang	0
酸性磷酸酶	suan'xing'lin'suan'mei	0
酸性磷酸酶和酒石酸	suan'xing'lin'suan'mei'he'jiu'shi'suan	0
髓鞘碱性蛋白	sui'qiao'jian'xing'dan'bai	0
髓鞘碱性蛋白抗体	sui'qiao'jian'xing'dan'bai'kang'ti	0
缩宫素注射液	suo'gong'su'zhu'she'ye	0
锁阳固精丸	suo'yang'gu'jing'wan	0
胎盘糖旦白	tai'pan'tang'dan'bai	0
坦度螺酮	tan'du'luo'tong	0
糖耐量实验	tang'nai'liang'shi'yan	0
糖皮质类固醇受体	tang'pi'zhi'lei'gu'chun'shou'ti	0
糖元染色	tang'yuan'ran'se	0
特效百草祛痛灵	te'xiao'bai'cao'qu'tong'ling	0
特异性酯酶双染色	te'yi'xing'zhi'mei'shuang'ran'se	0
体温计口腔用	ti'wen'ji'kou'qiang'yong	0
替硝唑注射液	ti'xiao'zuo'zhu'she'ye	0
天麻蜂王浆	tian'ma'feng'wang'jiang	0
天麻片	tian'ma'pian	0
天麻丸	tian'ma'wan	0
田七痛经胶囊	tian'qi'tong'jing'jiao'nang	0
天然维生素	tian'ran'wei'sheng'su	0
天然维生素胶丸	tian'ran'wei'sheng'su'jiao'wan	0
天然维生素咀嚼片	tian'ran'wei'sheng'su'ju'jue'pian	0
天然维生素软胶囊	tian'ran'wei'sheng'su'ruan'jiao'nang	0
天王补心丸	tian'wang'bu'xin'wan	0
调经促孕丸	tiao'jing'cu'yun'wan	0
铁染色	tie'ran'se	0
铁锌钙氨基酸	tie'xin'gai'an'ji'suan	0
通便灵胶囊	tong'bian'ling'jiao'nang	0
同工酶	tong'gong'mei	0
酮康唑乳膏	tong'kang'zuo'ru'gao	0
通窍耳聋丸	tong'qiao'er'long'wan	0
通宣理肺片	tong'xuan'li'fei'pian	0
通宣理肺丸	tong'xuan'li'fei'wan	0
头孢克肟颗粒	tou'bao'ke'wo'ke'li	0
头孢拉定干混悬剂	tou'bao'la'ding'gan'hun'xuan'ji	0
头孢拉定胶囊	tou'bao'la'ding'jiao'nang	0
头风痛丸	tou'feng'tong'wan	0
透气防水创可贴	tou'qi'fang'shui'chuang'ke'tie	0
途舒晕车贴	tu'shu'yun'che'tie	0
途爽晕车贴	tu'shuang'yun'che'tie	0
吐泻肚痛胶囊	tu'xie'du'tong'jiao'nang	0
退热贴	tui're'tie	0
退热帖	tui're'tie	0
退热贴半边天	tui're'tie'ban'bian'tian	0
妥布霉素地塞米松滴眼液	tuo'bu'mei'su'di'sai'mi'song'di'yan'ye	0
妥布霉素滴眼液	tuo'bu'mei'su'di'yan'ye	0
脱毛霜	tuo'mao'shuang	0
万通筋骨贴	wan'tong'jin'gu'tie	0
万痛筋骨贴	wan'tong'jin'gu'tie	0
维颠茄铝胶囊	wei'dian'qie'lv'jiao'nang	0
胃复宁胶囊	wei'fu'ning'jiao'nang	0
维果糖酸钙注射液	wei'guo'tang'suan'gai'zhu'she'ye	0
胃康灵胶囊	wei'kang'ling'jiao'nang	0
胃乐新胶囊	wei'le'xin'jiao'nang	0
维生素滴剂	wei'sheng'su'di'ji	0
维生素胶丸	wei'sheng'su'jiao'wan	0
维生素咀嚼片	wei'sheng'su'ju'jue'pian	0
维生素片	wei'sheng'su'pian	0
维生素注射液	wei'sheng'su'zhu'she'ye	0
维银翘片	wei'yin'qiao'pian	0
蚊不叮	wen'bu'ding	0
我牛避孕套黄色	wo'niu'bi'yun'tao'huang'se	0
我牛避孕套紫色	wo'niu'bi'yun'tao'zi'se	0
五花茶颗粒	wu'hua'cha'ke'li	0
乌鸡白凤丸	wu'ji'bai'feng'wan	0
无极膏	wu'ji'gao	0
乌鸡桂圆养血口服液	wu'ji'gui'yuan'yang'xue'kou'fu'ye	0
五淋化石胶囊	wu'lin'hua'shi'jiao'nang	0
五子衍宗丸	wu'zi'yan'zong'wan	0
细胞亚群测定	xi'bao'ya'qun'ce'ding	0
西吡氯铵含漱液	xi'bi'lv'an'han'shu'ye	0
西地磷酸苯丙哌林泡腾片	xi'di'lin'suan'ben'bing'pai'lin'pao'teng'pian	0
西瓜霜润喉片	xi'gua'shuang'run'hou'pian	0
溪黄草	xi'huang'cao	0
细菌培养	xi'jun'pei'yang	0
西施露	xi'shi'lu	0
下火王	xia'huo'wang	0
夏桑菊颗粒	xia'sang'ju'ke'li	0
夏怡露	xia'yi'lu	0
腺苷脱氨酸	xian'gan'tuo'an'suan	0
纤体清脂素	xian'ti'qing'zhi'su	0
香丹注射液	xiang'dan'zhu'she'ye	0
香砂养胃软胶囊	xiang'sha'yang'wei'ruan'jiao'nang	0
香砂养胃丸	xiang'sha'yang'wei'wan	0
小白雀爆拆灵	xiao'bai'que'bao'chai'ling	0
小白雀芦荟膏	xiao'bai'que'lu'hui'gao	0
小白雀蛇油	xiao'bai'que'she'you	0
小百消丹	xiao'bai'xiao'dan	0
小柴胡颗粒	xiao'chai'hu'ke'li	0
消痘霜	xiao'dou'shuang	0
小儿氨酚黄那敏颗粒	xiao'er'an'fen'huang'na'min'ke'li	0
小儿氨酚黄那敏片	xiao'er'an'fen'huang'na'min'pian	0
小儿肺炎散	xiao'er'fei'yan'san	0
小儿腹泻贴	xiao'er'fu'xie'tie	0
小儿钙铁锌硒维生素颗粒	xiao'er'gai'tie'xin'xi'wei'sheng'su'ke'li	0
小儿感冒颗粒	xiao'er'gan'mao'ke'li	0
小儿感冒散	xiao'er'gan'mao'san	0
小儿化痰止咳颗粒	xiao'er'hua'tan'zhi'ke'ke'li	0
小儿解惑片	xiao'er'jie'huo'pian	0
小儿咳喘灵胶囊	xiao'er'ke'chuan'ling'jiao'nang	0
小儿咳喘灵颗粒	xiao'er'ke'chuan'ling'ke'li	0
小儿咳喘灵口服液	xiao'er'ke'chuan'ling'kou'fu'ye	0
小儿免疫白蛋白	xiao'er'mian'yi'bai'dan'bai	0
小儿七星茶	xiao'er'qi'xing'cha	0
小儿清肺止咳片	xiao'er'qing'fei'zhi'ke'pian	0
小儿清火宝颗粒	xiao'er'qing'huo'bao'ke'li	0
小儿清热宁	xiao'er'qing're'ning	0
小儿清热止咳口服液	xiao'er'qing're'zhi'ke'kou'fu'ye	0
小儿生血颗粒	xiao'er'sheng'xue'ke'li	0
小儿湿热清颗粒	xiao'er'shi're'qing'ke'li	0
小儿吐泻宁	xiao'er'tu'xie'ning	0
小儿退热口服液	xiao'er'tui're'kou'fu'ye	0
小儿消咳片	xiao'er'xiao'ke'pian	0
小儿虚汗宁颗粒	xiao'er'xu'han'ning'ke'li	0
小儿咽扁颗粒	xiao'er'yan'bian'ke'li	0
小儿增食片	xiao'er'zeng'shi'pian	0
小儿止咳糖浆	xiao'er'zhi'ke'tang'jiang	0
小儿壮骨颗粒	xiao'er'zhuang'gu'ke'li	0
小活络片	xiao'huo'luo'pian	0
消糜阴道泡腾片	xiao'mi'yin'dao'pao'teng'pian	0
消食化积口服液	xiao'shi'hua'ji'kou'fu'ye	0
消食健胃片	xiao'shi'jian'wei'pian	0
消食十味丸	xiao'shi'shi'wei'wan	0
消食养胃片	xiao'shi'yang'wei'pian	0
硝酸毛果芸香碱滴眼液	xiao'suan'mao'guo'yun'xiang'jian'di'yan'ye	0
硝酸咪康唑乳膏	xiao'suan'mi'kang'zuo'ru'gao	0
硝酸咪康唑乳膏达克宁	xiao'suan'mi'kang'zuo'ru'gao'da'ke'ning	0
硝酸咪康唑栓	xiao'suan'mi'kang'zuo'shuan	0
消痛贴	xiao'tong'tie	0
消炎利胆片	xiao'yan'li'dan'pian	0
消炎灵胶囊	xiao'yan'ling'jiao'nang	0
消炎片	xiao'yan'pian	0
消炎镇痛膏	xiao'yan'zhen'tong'gao	0
消炎镇痛贴	xiao'yan'zhen'tong'tie	0
消炎止咳片	xiao'yan'zhi'ke'pian	0
消炎止痢灵片	xiao'yan'zhi'li'ling'pian	0
逍遥丸	xiao'yao'wan	0
消肿止痛灵	xiao'zhong'zhi'tong'ling	0
辛芳鼻炎胶囊	xin'fang'bi'yan'jiao'nang	0
新复方大青叶片	xin'fu'fang'da'qing'ye'pian	0
新钙中钙	xin'gai'zhong'gai	0
新钙中钙百瑞祥	xin'gai'zhong'gai'bai'rui'xiang	0
新黄金搭档	xin'huang'jin'da'dang	0
新脚气膏	xin'jiao'qi'gao	0
新眠乐	xin'mian'le	0
心脑康胶囊	xin'nao'kang'jiao'nang	0
新生化颗粒	xin'sheng'hua'ke'li	0
性病衣原体快速检测	xing'bing'yi'yuan'ti'kuai'su'jian'ce	0
性病支原体检测	xing'bing'zhi'yuan'ti'jian'ce	0
醒酒林	xing'jiu'lin	0
胸水	xiong'shui	0
癣克	xuan'ke	0
玄麦甘桔颗粒	xuan'mai'gan'ju'ke'li	0
血氨	xue'an	0
血管紧张素转化酶	xue'guan'jin'zhang'su'zhuan'hua'mei	0
血浆同型半胱氨酸	xue'jiang'tong'xing'ban'guang'an'suan	0
血浆维生素	xue'jiang'wei'sheng'su	0
血浆叶酸测定	xue'jiang'ye'suan'ce'ding	0
雪梨蜜炼川贝枇杷膏	xue'li'mi'lian'chuan'bei'pi'pa'gao	0
雪莲乌鸡口服液	xue'lian'wu'ji'kou'fu'ye	0
血镁	xue'mei	0
血尿铜	xue'niao'tong	0
血尿锌	xue'niao'xin	0
血皮质醇	xue'pi'zhi'chun	0
血气分析加离子分析	xue'qi'fen'xi'jia'li'zi'fen'xi	0
血清蛋白电泳	xue'qing'dan'bai'dian'yong	0
血渗透压	xue'shen'tou'ya	0
血糖	xue'tang	0
血涂片分类及形态学分析	xue'tu'pian'fen'lei'ji'xing'tai'xue'fen'xi	0
血小板聚集	xue'xiao'ban'ju'ji	0
血小板黏附	xue'xiao'ban'nian'fu	0
血液或尿液氨基酸分析	xue'ye'huo'niao'ye'an'ji'suan'fen'xi	0
荨麻疹丸	xun'ma'zhen'wan	0
雅彩甘油润肤液	ya'cai'gan'you'run'fu'ye	0
牙痛灵	ya'tong'ling	0
牙痛宁	ya'tong'ning	0
炎可宁片	yan'ke'ning'pian	0
延时装天然胶红色	yan'shi'zhuang'tian'ran'jiao'hong'se	0
延时装天然蓝色	yan'shi'zhuang'tian'ran'lan'se	0
咽速宁	yan'su'ning	0
盐酸多西环素片	yan'suan'duo'xi'huan'su'pian	0
盐酸环丙沙星片	yan'suan'huan'bing'sha'xing'pian	0
盐酸金刚乙胺颗粒太之奥	yan'suan'jin'gang'yi'an'ke'li'tai'zhi'ao	0
盐酸克拉霉素胶囊	yan'suan'ke'la'mei'su'jiao'nang	0
盐酸克林霉素胶囊	yan'suan'ke'lin'mei'su'jiao'nang	0
盐酸克林霉素注射液	yan'suan'ke'lin'mei'su'zhu'she'ye	0
盐酸雷尼替丁胶囊	yan'suan'lei'ni'ti'ding'jiao'nang	0
盐酸利多卡因注射液	yan'suan'li'duo'ka'yin'zhu'she'ye	0
盐酸林可霉素注射液	yan'suan'lin'ke'mei'su'zhu'she'ye	0
盐酸洛美沙星滴耳液	yan'suan'luo'mei'sha'xing'di'er'ye	0
盐酸洛美沙星滴眼液	yan'suan'luo'mei'sha'xing'di'yan'ye	0
盐酸吗啉胍片	yan'suan'ma'lin'gua'pian	0
盐酸帕乐西汀片	yan'suan'pa'le'xi'ting'pian	0
盐酸曲马多注射液	yan'suan'qu'ma'duo'zhu'she'ye	0
盐酸赛庚啶片	yan'suan'sai'geng'ding'pian	0
盐酸肾上腺素注射液	yan'suan'shen'shang'xian'su'zhu'she'ye	0
盐酸西替利嗪胶囊	yan'suan'xi'ti'li'qin'jiao'nang	0
盐酸左氧氟沙星胶囊	yan'suan'zuo'yang'fu'sha'xing'jiao'nang	0
盐酸左氧氟沙星氯化钠注射液	yan'suan'zuo'yang'fu'sha'xing'lv'hua'na'zhu'she'ye	0
盐酸左氧氟沙星片	yan'suan'zuo'yang'fu'sha'xing'pian	0
盐酸左氧沙星片	yan'suan'zuo'yang'sha'xing'pian	0
咽炎片	yan'yan'pian	0
氧氟沙星滴眼液	yang'fu'sha'xing'di'yan'ye	0
氧氟沙星氯化钠注射液	yang'fu'sha'xing'lv'hua'na'zhu'she'ye	0
氧合	yang'he	0
养生堂天然维生素软胶囊	yang'sheng'tang'tian'ran'wei'sheng'su'ruan'jiao'nang	0
养血安神片	yang'xue'an'shen'pian	0
养血当归糖浆	yang'xue'dang'gui'tang'jiang	0
养阴清肺丸	yang'yin'qing'fei'wan	0
腰肌劳损	yao'ji'lao'sun	0
腰痛片	yao'tong'pian	0
腰腿痛	yao'tui'tong	0
腰腿痛贴	yao'tui'tong'tie	0
腰椎间盘贴	yao'zhui'jian'pan'tie	0
腰椎间盘突出	yao'zhui'jian'pan'tu'chu	0
一步到位	yi'bu'dao'wei	0
一次性使用无菌注射器带针	yi'ci'xing'shi'yong'wu'jun'zhu'she'qi'dai'zhen	0
一次性使用自动止液输液器带针	yi'ci'xing'shi'yong'zi'dong'zhi'ye'shu'ye'qi'dai'zhen	0
胰岛素抗体	yi'dao'su'kang'ti	0
胰岛细胞抗体	yi'dao'xi'bao'kang'ti	0
乙肝表面抗原	yi'gan'biao'mian'kang'yuan	0
乙肝两对半	yi'gan'liang'dui'ban	0
乙肝宁颗粒	yi'gan'ning'ke'li	0
胰高糖素	yi'gao'tang'su	0
益母草冲剂	yi'mu'cao'chong'ji	0
益母草膏	yi'mu'cao'gao	0
益母草颗粒	yi'mu'cao'ke'li	0
伊诺沙星片	yi'nuo'sha'xing'pian	0
伊诺沙星乳膏	yi'nuo'sha'xing'ru'gao	0
益气养血	yi'qi'yang'xue	0
益气养血口服液	yi'qi'yang'xue'kou'fu'ye	0
益肾安神口服液	yi'shen'an'shen'kou'fu'ye	0
依托红霉素颗粒	yi'tuo'hong'mei'su'ke'li	0
乙型肝炎人免疫球蛋白注射液	yi'xing'gan'yan'ren'mian'yi'qiu'dan'bai'zhu'she'ye	0
衣原体	yi'yuan'ti	0
吲达帕胺片	yin'da'pa'an'pian	0
吲哚美辛三七冰片栓	yin'duo'mei'xin'san'qi'bing'pian'shuan	0
银尔通抗菌液	yin'er'tong'kang'jun'ye	0
银黄胶囊	yin'huang'jiao'nang	0
银黄片	yin'huang'pian	0
银翘解毒丸	yin'qiao'jie'du'wan	0
银翘伤风胶囊	yin'qiao'shang'feng'jiao'nang	0
银杏软胶囊	yin'xing'ruan'jiao'nang	0
银杏叶滴丸	yin'xing'ye'di'wan	0
婴宝维肤膏	ying'bao'wei'fu'gao	0
婴儿健脾颗粒	ying'er'jian'pi'ke'li	0
婴儿健脾散	ying'er'jian'pi'san	0
婴儿葡萄糖	ying'er'pu'tao'tang	0
油多多蓝色	you'duo'duo'lan'se	0
油多多绿色	you'duo'duo'lv'se	0
油多多紫色	you'duo'duo'zi'se	0
御迪通辣椒风湿膏	yu'di'tong'la'jiao'feng'shi'gao	0
玉叶清火胶囊	yu'ye'qing'huo'jiao'nang	0
玉簪清咽十五味丸	yu'zan'qing'yan'shi'wu'wei'wan	0
远红外消痛磁疗贴跌打型	yuan'hong'wai'xiao'tong'ci'liao'tie'die'da'xing	0
远红外消痛磁疗贴风湿型	yuan'hong'wai'xiao'tong'ci'liao'tie'feng'shi'xing	0
云南白药创可贴	yun'nan'bai'yao'chuang'ke'tie	0
载脂蛋白	zai'zhi'dan'bai	0
栽脂蛋白	zai'zhi'dan'bai	0
藏青果颗粒	zang'qing'guo'ke'li	0
早老素	zao'lao'su	0
真菌镜检	zhen'jun'jing'jian	0
真菌培养取材	zhen'jun'pei'yang'qu'cai	0
镇咳糖浆	zhen'ke'tang'jiang	0
珍珠芦荟	zhen'zhu'lu'hui	0
珍珠芦荟排毒肠润茶	zhen'zhu'lu'hui'pai'du'chang'run'cha	0
正胃整肠丸	zheng'wei'zheng'chang'wan	0
至爱避孕套黄色	zhi'ai'bi'yun'tao'huang'se	0
至爱避孕套蓝色	zhi'ai'bi'yun'tao'lan'se	0
至爱避孕套绿色	zhi'ai'bi'yun'tao'lv'se	0
知柏地黄丸	zhi'bai'di'huang'wan	0
痔疮膏	zhi'chuang'gao	0
脂肪酶	zhi'fang'mei	0
治感灵颗粒	zhi'gan'ling'ke'li	0
直接胆红质	zhi'jie'dan'hong'zhi	0
止咳片	zhi'ke'pian	0
质控	zhi'kong	0
治偏痛胶囊	zhi'pian'tong'jiao'nang	0
止嗽立效丸	zhi'sou'li'xiao'wan	0
止泻颗粒	zhi'xie'ke'li	0
痔炎消胶囊	zhi'yan'xiao'jiao'nang	0
支原体	zhi'yuan'ti	0
止晕贴	zhi'yun'tie	0
栀子金花丸	zhi'zi'jin'hua'wan	0
中耳炎滴剂	zhong'er'yan'di'ji	0
重感灵胶囊	zhong'gan'ling'jiao'nang	0
仲景冻疮膏	zhong'jing'dong'chuang'gao	0
中老年高钙片	zhong'lao'nian'gao'gai'pian	0
中老年高钙片百瑞祥	zhong'lao'nian'gao'gai'pian'bai'rui'xiang	0
中老年葡萄糖	zhong'lao'nian'pu'tao'tang	0
肿瘤标记抗原	zhong'liu'biao'ji'kang'yuan	0
众生胶囊	zhong'sheng'jiao'nang	0
中性粒细胞碱性磷酸酶染色	zhong'xing'li'xi'bao'jian'xing'lin'suan'mei'ran'se	0
注射用氨苄西林钠	zhu'she'yong'an'bian'xi'lin'na	0
注射用重组人白介素	zhu'she'yong'chong'zu'ren'bai'jie'su	0
注射用重组人干扰素	zhu'she'yong'chong'zu'ren'gan'rao'su	0
注射用辅酶	zhu'she'yong'fu'mei	0
注射用甲磺酸罗哌卡因	zhu'she'yong'jia'huang'suan'luo'pai'ka'yin	0
注射用加替沙星	zhu'she'yong'jia'ti'sha'xing	0
注射用赖氨匹林	zhu'she'yong'lai'an'pi'lin	0
注射用磷霉素钠	zhu'she'yong'lin'mei'su'na	0
注射用哌拉西林钠他唑巴坦钠	zhu'she'yong'pai'la'xi'lin'na'ta'zuo'ba'tan'na	0
注射用水溶性维生素	zhu'she'yong'shui'rong'xing'wei'sheng'su	0
注射用头孢拉定	zhu'she'yong'tou'bao'la'ding	0
注射用头孢孟多酯钠	zhu'she'yong'tou'bao'meng'duo'zhi'na	0
注射用头孢曲松钠	zhu'she'yong'tou'bao'qu'song'na	0
注射用头孢替唑钠	zhu'she'yong'tou'bao'ti'zuo'na	0
注射用头孢唑啉钠先锋号针	zhu'she'yong'tou'bao'zuo'lin'na'xian'feng'hao'zhen	0
注射用头孢唑林钠易拉盖	zhu'she'yong'tou'bao'zuo'lin'na'yi'la'gai	0
注射用炎琥宁	zhu'she'yong'yan'hu'ning	0
注射用盐酸纳洛酮	zhu'she'yong'yan'suan'na'luo'tong	0
注射用盐酸头孢吡肟	zhu'she'yong'yan'suan'tou'bao'bi'wo	0
转肽酶	zhuan'tai'mei	0
转移因子胶囊	zhuan'yi'yin'zi'jiao'nang	0
转移因子口服液	zhuan'yi'yin'zi'kou'fu'ye	0
壮骨助长高钙片	zhuang'gu'zhu'zhang'gao'gai'pian	0
壮筋续骨丸	zhuang'jin'xu'gu'wan	0
壮阳春胶囊	zhuang'yang'chun'jiao'nang	0
壮腰健肾片	zhuang'yao'jian'shen'pian	0
壮腰健肾丸	zhuang'yao'jian'shen'wan	0
总蛋白	zong'dan'bai	0
总胆红质	zong'dan'hong'zhi	0
组分区带	zu'fen'qu'dai	0
足光粉	zu'guang'fen	0
足光散	zu'guang'san	0
足轻松	zu'qing'song	0
足轻松鸡眼贴	zu'qing'song'ji'yan'tie	0
坐骨神经痛	zuo'gu'shen'jing'tong	0
左氧氟沙星片	zuo'yang'fu'sha'xing'pian	0
