不连续劈理	bu'lian'xu'pi'li	0
侧伏向与侧伏角	ce'fu'xiang'yu'ce'fu'jiao	0
单位面积的附加应力	dan'wei'mian'ji'de'fu'jia'ying'li	0
第二章	di'er'zhang	0
第三章	di'san'zhang	0
第四章	di'si'zhang	0
非共轴递进变形	fei'gong'zhou'di'jin'bian'xing	0
非均匀应变	fei'jun'yun'ying'bian	0
非透入性构造	fei'tou'ru'xing'gou'zao	0
非旋转变形	fei'xuan'zhuan'bian'xing	0
各个应力状态的连线	ge'ge'ying'li'zhuang'tai'de'lian'xian	0
共轭剪裂角	gong'e'jian'lie'jiao	0
共轴递进变形	gong'zhou'di'jin'bian'xing	0
构造盆地岩层从四周向中心倾斜	gou'zao'pen'di'yan'ceng'cong'si'zhou'xiang'zhong'xin'qing'xie	0
剪节理由剪应力作用形成的节理	jian'jie'li'you'jian'ying'li'zuo'yong'xing'cheng'de'jie'li	0
剪裂角	jian'lie'jiao	0
剪裂面与最大主应力的夹角	jian'lie'mian'yu'zui'da'zhu'ying'li'de'jia'jiao	0
剪应变	jian'ying'bian	0
剪应变内角度的变化量	jian'ying'bian'nei'jiao'du'de'bian'hua'liang	0
交面线理	jiao'mian'xian'li	0
均匀应变	jun'yun'ying'bian	0
矿物生长线理	kuang'wu'sheng'zhang'xian'li	0
拉伸线理	la'shen'xian'li	0
连续劈理	lian'xu'pi'li	0
劈理	pi'li	0
劈理域	pi'li'yu	0
倾伏向与倾伏角	qing'fu'xiang'yu'qing'fu'jiao	0
蠕变	ru'bian	0
视倾角	shi'qing'jiao	0
石香肠构造	shi'xiang'chang'gou'zao	0
透入性构造	tou'ru'xing'gou'zao	0
微劈石	wei'pi'shi	0
线应变	xian'ying'bian	0
旋转变形	xuan'zhuan'bian'xing	0
应变椭球体	ying'bian'tuo'qiu'ti	0
应变物体变形程度的量度	ying'bian'wu'ti'bian'xing'cheng'du'de'liang'du	0
应力	ying'li	0
应力单位面积上附加内力称应力	ying'li'dan'wei'mian'ji'shang'fu'jia'nei'li'cheng'ying'li	0
应力轨迹	ying'li'gui'ji	0
有限应变	you'xian'ying'bian	0
增量应变	zeng'liang'ying'bian	0
张节理由张应力作用形成的节理	zhang'jie'li'you'zhang'ying'li'zuo'yong'xing'cheng'de'jie'li	0
真倾角	zhen'qing'jiao	0
皱纹线理	zhou'wen'xian'li	0
