草变青鱼儿新草变黄鱼儿忙	cao'bian'qing'yu'er'xin'cao'bian'huang'yu'er'mang	0
草角银边金中央	cao'jiao'yin'bian'jin'zhong'yang	0
赤日当空万物峥嵘柳荫垂钓人在画中	chi'ri'dang'kong'wan'wu'zheng'rong'liu'yin'chui'diao'ren'zai'hua'zhong	0
垂钓垂钓切忌烦躁	chui'diao'chui'diao'qie'ji'fan'zao	0
春虫夏面秋蚯蚓冬钓唯有用红虫	chun'chong'xia'mian'qiu'qiu'yin'dong'diao'wei'you'yong'hong'chong	0
春钓鲫鱼夏钓鲤黄梅季节钓白鱼夏秋之交钓白条冬季收竿莫下钓	chun'diao'ji'yu'xia'diao'li'huang'mei'ji'jie'diao'bai'yu'xia'qiu'zhi'jiao'diao'bai'tiao'dong'ji'shou'gan'mo'xia'diao	0
春钓滩流钓湾下雨钓中间	chun'diao'tan'liu'diao'wan'xia'yu'diao'zhong'jian	0
春钓滩夏钓潭秋钓阴冬钓阳	chun'diao'tan'xia'diao'tan'qiu'diao'yin'dong'diao'yang	0
春钓桃花开秋钓桂花鱼	chun'diao'tao'hua'kai'qiu'diao'gui'hua'yu	0
春钓阳冬钓午夏天钓两头秋天钓全天	chun'diao'yang'dong'diao'wu'xia'tian'diao'liang'tou'qiu'tian'diao'quan'tian	0
春钓雨雾夏钓早秋钓黄昏冬钓草	chun'diao'yu'wu'xia'diao'zao'qiu'diao'huang'hun'dong'diao'cao	0
春风送暖柳绿花红举竿垂钓旷身怡情	chun'feng'song'nuan'liu'lv'hua'hong'ju'gan'chui'diao'kuang'shen'yi'qing	0
春风送暖柳绿花红举竿垂钓旷神怡情	chun'feng'song'nuan'liu'lv'hua'hong'ju'gan'chui'diao'kuang'shen'yi'qing	0
春末夏初爬水滩三伏炎夏歇树间九月重阳入水底寒冬腊月钻深潭	chun'mo'xia'chu'pa'shui'tan'san'fu'yan'xia'xie'shu'jian'jiu'yue'chong'yang'ru'shui'di'han'dong'la'yue'zuan'shen'tan	0
春天鱼儿满塘奔金秋时节小阳盛夏鱼儿深水藏冬天滩边来翻身	chun'tian'yu'er'man'tang'ben'jin'qiu'shi'jie'xiao'yang'sheng'xia'yu'er'shen'shui'cang'dong'tian'tan'bian'lai'fan'shen	0
春雨满塘鱼夏雨不上钩	chun'yu'man'tang'yu'xia'yu'bu'shang'gou	0
春雨之后钓鱼丰收	chun'yu'zhi'hou'diao'yu'feng'shou	0
大麦须须亮鲤鱼遍沟放	da'mai'xu'xu'liang'li'yu'bian'gou'fang	0
钓鲫三大巧竿软线细鱼钩小	diao'ji'san'da'qiao'gan'ruan'xian'xi'yu'gou'xiao	0
钓山钓水钓花鸟钓江钓海钓情怀	diao'shan'diao'shui'diao'hua'niao'diao'jiang'diao'hai'diao'qing'huai	0
钓星钓月钓太阳钓情钓趣钓健康	diao'xing'diao'yue'diao'tai'yang'diao'qing'diao'qu'diao'jian'kang	0
钓鱼不钓午钓午白辛苦	diao'yu'bu'diao'wu'diao'wu'bai'xin'ku	0
钓鱼不撒窝不如回家搂老婆	diao'yu'bu'sa'wo'bu'ru'hui'jia'lou'lao'po	0
钓鱼钓顶风顺风必落空	diao'yu'diao'ding'feng'shun'feng'bi'luo'kong	0
钓鱼钓静切忌动多蹲下少站立背身影钓得鱼儿没处藏	diao'yu'diao'jing'qie'ji'dong'duo'dun'xia'shao'zhan'li'bei'shen'ying'diao'de'yu'er'mei'chu'cang	0
钓鱼钓兴怡情养性	diao'yu'diao'xing'yi'qing'yang'xing	0
钓鱼雕意心神专一	diao'yu'diao'yi'xin'shen'zhuan'yi	0
钓鱼钓娱垂钓垂调一竿在手烦恼全走	diao'yu'diao'yu'chui'diao'chui'tiao'yi'gan'zai'shou'fan'nao'quan'zou	0
钓鱼钓鱼烦恼离去	diao'yu'diao'yu'fan'nao'li'qu	0
钓鱼钓鱼十钓九误	diao'yu'diao'yu'shi'diao'jiu'wu	0
钓鱼钓鱼十钓九娱	diao'yu'diao'yu'shi'diao'jiu'yu	0
钓鱼面对风鱼竿弯弯动	diao'yu'mian'dui'feng'yu'gan'wan'wan'dong	0
钓鱼有益老少皆宜	diao'yu'you'yi'lao'shao'jie'yi	0
方池钓四角长池钓两腰	fang'chi'diao'si'jiao'chang'chi'diao'liang'yao	0
风动鱼儿动风停鱼儿静	feng'dong'yu'er'dong'feng'ting'yu'er'jing	0
风前雨后钓鱼丰收	feng'qian'yu'hou'diao'yu'feng'shou	0
浮子横着爬不是螃蟹就是虾	fu'zi'heng'zhe'pa'bu'shi'pang'xie'jiu'shi'xia	0
浮子频点头准要上泥鳅	fu'zi'pin'dian'tou'zhun'yao'shang'ni'qiu	0
过了谷雨百鱼近岸	guo'le'gu'yu'bai'yu'jin'an	0
河边水腥气钓者好运气	he'bian'shui'xing'qi'diao'zhe'hao'yun'qi	0
和风细雨钓鱼最佳	he'feng'xi'yu'diao'yu'zui'jia	0
会看风向鱼儿勤上	hui'kan'feng'xiang'yu'er'qin'shang	0
浑中寻清清中找浑	hun'zhong'xun'qing'qing'zhong'zhao'hun	0
急抖竿慢引遛钓得大鱼不会动	ji'dou'gan'man'yin'liu'diao'de'da'yu'bu'hui'dong	0
姜太公钓鱼愿者上钩子陵钓鱼自得其乐	jiang'tai'gong'diao'yu'yuan'zhe'shang'gou'zi'ling'diao'yu'zi'de'qi'le	0
金风飒飒鱼肥水清静坐凝视胜似练功	jin'feng'sa'sa'yu'fei'shui'qing'jing'zuo'ning'shi'sheng'si'lian'gong	0
进水口鱼上走	jin'shui'kou'yu'shang'zou	0
惊蛰鱼儿动鲫鱼吃钩勤	jing'zhe'yu'er'dong'ji'yu'chi'gou'qin	0
跨进钓鱼的境界为钓鱼跨出钓鱼的境界为钓意	kua'jin'diao'yu'de'jing'jie'wei'diao'yu'kua'chu'diao'yu'de'jing'jie'wei'diao'yi	0
宽钓窄窄钓宽不宽不窄钓中间	kuan'diao'zhai'zhai'diao'kuan'bu'kuan'bu'zhai'diao'zhong'jian	0
老手凭经验新手图方便	lao'shou'ping'jing'yan'xin'shou'tu'fang'bian	0
雷阵雨前钓鱼空空雷阵雨后钓鱼丰收	lei'zhen'yu'qian'diao'yu'kong'kong'lei'zhen'yu'hou'diao'yu'feng'shou	0
烈日当午钓鱼气鼓鼓早晚钓一阵回家吃一顿	lie'ri'dang'wu'diao'yu'qi'gu'gu'zao'wan'diao'yi'zhen'hui'jia'chi'yi'dun	0
遛鱼遛鱼千万莫急	liu'yu'liu'yu'qian'wan'mo'ji	0
慢提鱼饵动鱼儿上钩多	man'ti'yu'er'dong'yu'er'shang'gou'duo	0
梅雨钓鱼越钓越喜	mei'yu'diao'yu'yue'diao'yue'xi	0
拿起鱼竿丢掉药罐	na'qi'yu'gan'diu'diao'yao'guan	0
宁钓活水不钓死潭	ning'diao'huo'shui'bu'diao'si'tan	0
宁钓日落后不钓雷雨前	ning'diao'ri'luo'hou'bu'diao'lei'yu'qian	0
宁钓下风不钓平静	ning'diao'xia'feng'bu'diao'ping'jing	0
僻静处树桥边深水浅处钓浅水深处钓	pi'jing'chu'shu'qiao'bian'shen'shui'qian'chu'diao'qian'shui'shen'chu'diao	0
清明到钓翁笑麦子黄钓鱼忙	qing'ming'dao'diao'weng'xiao'mai'zi'huang'diao'yu'mang	0
清明前后鲫鱼抢钩	qing'ming'qian'hou'ji'yu'qiang'gou	0
清明一滴水河里一条鱼	qing'ming'yi'di'shui'he'li'yi'tiao'yu	0
清水钓素饵深水钓荤饵静水钓素饵流水钓荤饵	qing'shui'diao'su'er'shen'shui'diao'hun'er'jing'shui'diao'su'er'liu'shui'diao'hun'er	0
轻提钓饵动一动鱼儿上钩勤又勤	qing'ti'diao'er'dong'yi'dong'yu'er'shang'gou'qin'you'qin	0
秋雨寒潭水更清钓竿袅袅一丝轻	qiu'yu'han'tan'shui'geng'qing'diao'gan'niao'niao'yi'si'qing	0
人穿棉袄鱼不动人穿夹袄鱼儿动人穿单衣鱼直蹦	ren'chuan'mian'ao'yu'bu'dong'ren'chuan'jia'ao'yu'er'dong'ren'chuan'dan'yi'yu'zhi'beng	0
人人都说神仙乐我说垂钓乐更高	ren'ren'dou'shuo'shen'xian'le'wo'shuo'chui'diao'le'geng'gao	0
日出胭脂红无雨即是风	ri'chu'yan'zhi'hong'wu'yu'ji'shi'feng	0
日晕好钓鱼月晕一场空	ri'yun'hao'diao'yu'yue'yun'yi'chang'kong	0
日晕三更雨月晕午时风	ri'yun'san'geng'yu'yue'yun'wu'shi'feng	0
软钓竿细钓线小钩小漂配小坠	ruan'diao'gan'xi'diao'xian'xiao'gou'xiao'piao'pei'xiao'zhui	0
三月三鲤鱼上河滩	san'yue'san'li'yu'shang'he'tan	0
上午钓西下午钓东要想多钓钓下风	shang'wu'diao'xi'xia'wu'diao'dong'yao'xiang'duo'diao'diao'xia'feng	0
深浑可钓近清浅宜钓远	shen'hun'ke'diao'jin'qing'qian'yi'diao'yuan	0
食饵不对口鱼儿摇尾走	shi'er'bu'dui'kou'yu'er'yao'wei'zou	0
手竿钓鲫一年为宜	shou'gan'diao'ji'yi'nian'wei'yi	0
霜下东南风十钓九放空	shuang'xia'dong'nan'feng'shi'diao'jiu'fang'kong	0
水呈泥汤钓鱼泡汤	shui'cheng'ni'tang'diao'yu'pao'tang	0
水底泛青苔必有大鱼在	shui'di'fan'qing'tai'bi'you'da'yu'zai	0
水库钓沟汊浮钓钓靠坝深浅钓交会陡坡钓坡下	shui'ku'diao'gou'cha'fu'diao'diao'kao'ba'shen'qian'diao'jiao'hui'dou'po'diao'po'xia	0
水面多鱼浪定是有鱼相	shui'mian'duo'yu'lang'ding'shi'you'yu'xiang	0
水面有鱼浪鱼在水中藏	shui'mian'you'yu'lang'yu'zai'shui'zhong'cang	0
水面鱼泛花钓鱼不想家	shui'mian'yu'fan'hua'diao'yu'bu'xiang'jia	0
水清捉螺蛳浑水钓大鱼	shui'qing'zhuo'luo'si'hun'shui'diao'da'yu	0
水深钓浅浅钓深水缓钓急急钓缓	shui'shen'diao'qian'qian'diao'shen'shui'huan'diao'ji'ji'diao'huan	0
水下瓦砾多钓鱼不打窝	shui'xia'wa'li'duo'diao'yu'bu'da'wo	0
水下小鱼多大鱼不在窝	shui'xia'xiao'yu'duo'da'yu'bu'zai'wo	0
水涨钓浅水退钓深水浑钓浅水清钓深	shui'zhang'diao'qian'shui'tui'diao'shen'shui'hun'diao'qian'shui'qing'diao'shen	0
水至清无鱼水太浑走人	shui'zhi'qing'wu'yu'shui'tai'hun'zou'ren	0
天悠悠地悠悠钓鱼的人儿无忧愁	tian'you'you'di'you'you'diao'yu'de'ren'er'wu'you'chou	0
唯鱼是鱼不得鱼随鱼而鱼处处鱼	wei'yu'shi'yu'bu'de'yu'sui'yu'er'yu'chu'chu'yu	0
无风不钓鱼	wu'feng'bu'diao'yu	0
无月钓鲶月夜钓鲤	wu'yue'diao'nian'yue'ye'diao'li	0
西朝阳没身影钓的鱼儿没处藏	xi'chao'yang'mei'shen'ying'diao'de'yu'er'mei'chu'cang	0
细其线小其钩垂钓鲫鱼必丰收	xi'qi'xian'xiao'qi'gou'chui'diao'ji'yu'bi'feng'shou	0
溪水响动鱼儿活动溪水流动鱼儿欢动	xi'shui'xiang'dong'yu'er'huo'dong'xi'shui'liu'dong'yu'er'huan'dong	0
夕阳西下钓鱼最佳	xi'yang'xi'xia'diao'yu'zui'jia	0
夏季鱼找食冬季食找鱼	xia'ji'yu'zhao'shi'dong'ji'shi'zhao'yu	0
夏天不钓草等于瞎胡跑	xia'tian'bu'diao'cao'deng'yu'xia'hu'pao	0
小麦黄钓鱼忙	xiao'mai'huang'diao'yu'mang	0
小鱼惊慌跳大鱼快来到	xiao'yu'jing'huang'tiao'da'yu'kuai'lai'dao	0
一方江水一方鱼一方鱼吃一方饵	yi'fang'jiang'shui'yi'fang'yu'yi'fang'yu'chi'yi'fang'er	0
一竿在手延年益寿	yi'gan'zai'shou'yan'nian'yi'shou	0
一日三迁早晚钓边	yi'ri'san'qian'zao'wan'diao'bian	0
一日三迁早晚遛边	yi'ri'san'qian'zao'wan'liu'bian	0
阴天钓鲶收获可观	yin'tian'diao'nian'shou'huo'ke'guan	0
银装素裹凛冽寒风深潭钓鱼其乐无穷	yin'zhuang'su'guo'lin'lie'han'feng'shen'tan'diao'yu'qi'le'wu'qiong	0
鱼儿顶浪游钓鱼要钓风浪口	yu'er'ding'lang'you'diao'yu'yao'diao'feng'lang'kou	0
鱼儿嚼水下竿白费	yu'er'jiao'shui'xia'gan'bai'fei	0
鱼儿露头收竿快走	yu'er'lu'tou'shou'gan'kuai'zou	0
雨后放光钓鱼辰光	yu'hou'fang'guang'diao'yu'chen'guang	0
雨后放光给垂钓帮忙	yu'hou'fang'guang'gei'chui'diao'bang'mang	0
雨季鱼靠边打窝撒池边	yu'ji'yu'kao'bian'da'wo'sa'chi'bian	0
雨季鱼靠边撒米应撒边	yu'ji'yu'kao'bian'sa'mi'ying'sa'bian	0
鱼食不对口回家必空手	yu'shi'bu'dui'kou'hui'jia'bi'kong'shou	0
早钓鱼晚钓虾中午钓个大王八	zao'diao'yu'wan'diao'xia'zhong'wu'diao'ge'da'wang'ba	0
早晚钓近午钓远天明下雨黑夜钓边边	zao'wan'diao'jin'wu'diao'yuan'tian'ming'xia'yu'hei'ye'diao'bian'bian	0
早晚钓近午钓远天阴下雨钓边边	zao'wan'diao'jin'wu'diao'yuan'tian'yin'xia'yu'diao'bian'bian	0
增氧机响得欢鱼儿爱向那里钻	zeng'yang'ji'xiang'de'huan'yu'er'ai'xiang'na'li'zuan	0
直鱼竿细鱼线快钩挂饵不露尖	zhi'yu'gan'xi'yu'xian'kuai'gou'gua'er'bu'lu'jian	0
昼钓鲫鱼夜钓鳖鲶	zhou'diao'ji'yu'ye'diao'bie'nian	0
