八叶禅杖灵蛇剑酒壶玄罗仙袖	ba'ye'chan'zhang'ling'she'jian'jiu'hu'xuan'luo'xian'xiu	0
保险枪技回枪飞甩天将降临	bao'xian'qiang'ji'hui'qiang'fei'shuai'tian'jiang'jiang'lin	0
冰狱寒岚玄凛冰煞冰系咒术天法	bing'yu'han'lan'xuan'lin'bing'sha'bing'xi'zhou'shu'tian'fa	0
补血道具大补丸体力九花玉露	bu'xue'dao'ju'da'bu'wan'ti'li'jiu'hua'yu'lu	0
补血命中回避神临烈阵	bu'xue'ming'zhong'hui'bi'shen'lin'lie'zhen	0
沉碧剑青钢剑辟邪玉佩朱绸法衣	chen'bi'jian'qing'gang'jian'bi'xie'yu'pei'zhu'chou'fa'yi	0
赤炼鬼剑邪蚩尤狂暴	chi'lian'gui'jian'xie'chi'you'kuang'bao	0
第一幕第三十三幕凛仪寒凛阴气	di'yi'mu'di'san'shi'san'mu'lin'yi'han'lin'yin'qi	0
电射星驰自身小十字幻月神剑	dian'she'xing'chi'zi'shen'xiao'shi'zi'huan'yue'shen'jian	0
独行夜魑双仪逆转时轮	du'xing'ye'chi'shuang'yi'ni'zhuan'shi'lun	0
断龙斩破魔杵金刚法轮鬼神灭破	duan'long'zhan'po'mo'chu'jin'gang'fa'lun'gui'shen'mie'po	0
封禅明杵降魔杵七环钢杖莲华杵	feng'shan'ming'chu'xiang'mo'chu'qi'huan'gang'zhang'lian'hua'chu	0
佛教唐朝北宋曹贤顺	fo'jiao'tang'chao'bei'song'cao'xian'shun	0
佛珠紫檀数珠琥珀佛珠黑木佛珠	fo'zhu'zi'tan'shu'zhu'hu'po'fo'zhu'hei'mu'fo'zhu	0
扶桑精古青莲古太守萧太守	fu'sang'jing'gu'qing'lian'gu'tai'shou'xiao'tai'shou	0
罡风刚岚煞气封魔九字印法封咒	gang'feng'gang'lan'sha'qi'feng'mo'jiu'zi'yin'fa'feng'zhou	0
刚烈破天将奔烈分天斩鬼冥剑	gang'lie'po'tian'jiang'ben'lie'fen'tian'zhan'gui'ming'jian	0
刚磐鬼血涸之触血炼鬼噬魂鬼	gang'pan'gui'xue'he'zhi'chu'xue'lian'gui'shi'hun'gui	0
钢战戟朱缨枪黑玉短戈火铜矛	gang'zhan'ji'zhu'ying'qiang'hei'yu'duan'ge'huo'tong'mao	0
葛梅尔杨云佐幽寰天书汉堂国际	ge'mei'er'yang'yun'zuo'you'huan'tian'shu'han'tang'guo'ji	0
古剑干将轰雷符故人炼血珠	gu'jian'gan'jiang'hong'lei'fu'gu'ren'lian'xue'zhu	0
瓜州沙州肃州河西之地	gua'zhou'sha'zhou'su'zhou'he'xi'zhi'di	0
鬼叉刃刀凛鬼无方鬼影火莲子	gui'cha'ren'dao'lin'gui'wu'fang'gui'ying'huo'lian'zi	0
鬼魄尸王分身地诀地象焚炎之气	gui'po'shi'wang'fen'shen'di'jue'di'xiang'fen'yan'zhi'qi	0
汉堂剧情物品精石诸物	han'tang'ju'qing'wu'pin'jing'shi'zhu'wu	0
韩无砂内魄元丹神武观桥山黄陵	han'wu'sha'nei'po'yuan'dan'shen'wu'guan'qiao'shan'huang'ling	0
耗力战练功战战斗力火象	hao'li'zhan'lian'gong'zhan'zhan'dou'li'huo'xiang	0
翯号伥魂血咒解臾封豨	he'hao'chang'hun'xue'zhou'jie'yu'feng'xi	0
河西四郡叶明璋凉州武威	he'xi'si'jun'ye'ming'zhang'liang'zhou'wu'wei	0
黑龙血咒之繁太渊隐逸汾阳古墓	hei'long'xue'zhou'zhi'fan'tai'yuan'yin'yi'fen'yang'gu'mu	0
恒山悬空寺华山嵩阳门	heng'shan'xuan'kong'si'hua'shan'song'yang'men	0
幻魂刃影天玄门前锋型饰品	huan'hun'ren'ying'tian'xuan'men'qian'feng'xing'shi'pin	0
寰神武英仲初段御剑之法	huan'shen'wu'ying'zhong'chu'duan'yu'jian'zhi'fa	0
黄山皇甫申紫杳峰银票	huang'shan'huang'fu'shen'zi'yao'feng'yin'piao	0
辉日圣华光系咒术魔道妖煞之力	hui'ri'sheng'hua'guang'xi'zhou'shu'mo'dao'yao'sha'zhi'li	0
火焰巨剑天象星华关底级人物	huo'yan'ju'jian'tian'xiang'xing'hua'guan'di'ji'ren'wu	0
祭天塔长剑紫金剑封阵剑	ji'tian'ta'chang'jian'zi'jin'jian'feng'zhen'jian	0
剑魔煌熇幽垠魄力神华天舞	jian'mo'huang'he'you'yin'po'li'shen'hua'tian'wu	0
经验值剑击妖将凶罗	jing'yan'zhi'jian'ji'yao'jiang'xiong'luo	0
景佑元年萧达览澶渊之役辽圣宗	jing'you'yuan'nian'xiao'da'lan'chan'yuan'zhi'yi'liao'sheng'zong	0
聚气迅烈神	ju'qi'xun'lie'shen	0
枯明杵铁爪裂钢铁手龙爪手	ku'ming'chu'tie'zhua'lie'gang'tie'shou'long'zhua'shou	0
狂雷电刃千煌雷烈雷系咒术圣烨	kuang'lei'dian'ren'qian'huang'lei'lie'lei'xi'zhou'shu'sheng'ye	0
狂魔夺魄鬼百眼翼魔鬼颅弹	kuang'mo'duo'po'gui'bai'yan'yi'mo'gui'lu'dan	0
雷禁诛天剑阵秦惟刚封铃笙	lei'jin'zhu'tian'jian'zhen'qin'wei'gang'feng'ling'sheng	0
雷荧烨光魔厉化相	lei'ying'ye'guang'mo'li'hua'xiang	0
李德明李元昊西夏显道元年	li'de'ming'li'yuan'hao'xi'xia'xian'dao'yuan'nian	0
两仪玄石燧石紫云战衣明王军铠	liang'yi'xuan'shi'sui'shi'zi'yun'zhan'yi'ming'wang'jun'kai	0
烈光戟鬼烈枪啸风枪龙王叉	lie'guang'ji'gui'lie'qiang'xiao'feng'qiang'long'wang'cha	0
灵剑朱雀古剑龙形雷荧剑铁枪	ling'jian'zhu'que'gu'jian'long'xing'lei'ying'jian'tie'qiang	0
灵鼩毛发灵鼩青铜锈剑时幻沙	ling'qu'mao'fa'ling'qu'qing'tong'xiu'jian'shi'huan'sha	0
灵泉玉露迅神五书披甲符烈法符	ling'quan'yu'lu'xun'shen'wu'shu'pi'jia'fu'lie'fa'fu	0
罗鬼无方剑气萤火埋伏	luo'gui'wu'fang'jian'qi'ying'huo'mai'fu	0
罗睺神禁法揽月阁天山	luo'hou'shen'jin'fa'lan'yue'ge'tian'shan	0
蟒神甲赤炼火铜镔铁重剑锁子甲	mang'shen'jia'chi'lian'huo'tong'bin'tie'zhong'jian'suo'zi'jia	0
猛鬼冲破回光华斩潜地蛰伏沙虫	meng'gui'chong'po'hui'guang'hua'zhan'qian'di'zhe'fu'sha'chong	0
密法幻界似真如幻无敌之身	mi'fa'huan'jie'si'zhen'ru'huan'wu'di'zhi'shen	0
敏捷等法轮之阵飞燕门刀轮绝技	min'jie'deng'fa'lun'zhi'zhen'fei'yan'men'dao'lun'jue'ji	0
魔魂朱焰魔火必杀	mo'hun'zhu'yan'mo'huo'bi'sha	0
魔天降临死灭之咒冥系咒术神通	mo'tian'jiang'lin'si'mie'zhi'zhou'ming'xi'zhou'shu'shen'tong	0
魔血眼八裂旋刃黑血阵青煞鬼	mo'xue'yan'ba'lie'xuan'ren'hei'xue'zhen'qing'sha'gui	0
磐天岭灵山四象门人第零幕	pan'tian'ling'ling'shan'si'xiang'men'ren'di'ling'mu	0
破魔朱绫布衣雪羽披风软革里衣	po'mo'zhu'ling'bu'yi'xue'yu'pi'feng'ruan'ge'li'yi	0
黔洲镇地界双双应奉仁	qian'zhou'zhen'di'jie'shuang'shuang'ying'feng'ren	0
瞿牧之神农架葛云衣斋女	qu'mu'zhi'shen'nong'jia'ge'yun'yi'zhai'nv	0
如意珠翠金创药商店战场	ru'yi'zhu'cui'jin'chuang'yao'shang'dian'zhan'chang	0
沙漠盗贼磐沙众群豪离魂唤丧	sha'mo'dao'zei'pan'sha'zhong'qun'hao'li'hun'huan'sang	0
上官远紫电金戟风雷冠云龙珠	shang'guan'yuan'zi'dian'jin'ji'feng'lei'guan'yun'long'zhu	0
烧鸡高戚黑熊精	shao'ji'gao'qi'hei'xiong'jing	0
射程攻击范围使用条件无方飞剑	she'cheng'gong'ji'fan'wei'shi'yong'tiao'jian'wu'fang'fei'jian	0
神冥玄刀破甲重剑鬼斩刃金刚杖	shen'ming'xuan'dao'po'jia'zhong'jian'gui'zhan'ren'jin'gang'zhang	0
神魔至尊传炼化天地劫战棋游戏	shen'mo'zhi'zun'zhuan'lian'hua'tian'di'jie'zhan'qi'you'xi	0
圣睿愚钝幽剑鬼狱灭剑血胧	sheng'rui'yu'dun'you'jian'gui'yu'mie'jian'xue'long	0
尸虫腐蝺邪光妖眼羽魅	shi'chong'fu'yu'xie'guang'yao'yan'yu'mei	0
式符召唤妖界式鬼	shi'fu'zhao'huan'yao'jie'shi'gui	0
水灵珠花黑玉蛇戒空明流转幽城	shui'ling'zhu'hua'hei'yu'she'jie'kong'ming'liu'zhuan'you'cheng	0
死藤澪花非天死潭渊吞鬼角驰冲	si'teng'ling'hua'fei'tian'si'tan'yuan'tun'gui'jiao'chi'chong	0
泰山襄阳应灵华崆峒派	tai'shan'xiang'yang'ying'ling'hua'kong'tong'pai	0
天动仪九浑天动仪血龙璧古伦德	tian'dong'yi'jiu'hun'tian'dong'yi'xue'long'bi'gu'lun'de	0
天烈五剑魂力修炼五像诸气	tian'lie'wu'jian'hun'li'xiu'lian'wu'xiang'zhu'qi	0
天女舞姿索带罡风盈索	tian'nv'wu'zi'suo'dai'gang'feng'ying'suo	0
天瑞仙舞毒瘫麻封玄经精灵	tian'rui'xian'wu'du'tan'ma'feng'xuan'jing'jing'ling	0
土魉蓄劲回气连珠箭雨	tu'liang'xu'jin'hui'qi'lian'zhu'jian'yu	0
王恢神将相胤霍雍洛阳	wang'hui'shen'jiang'xiang'yin'huo'yong'luo'yang	0
武防具殷剑平古剑龙皇翡翠碧沙	wu'fang'ju'yin'jian'ping'gu'jian'long'huang'fei'cui'bi'sha	0
五内抗性焚火冰凛	wu'nei'kang'xing'fen'huo'bing'lin	0
析魂外法计都荒寰朱兽魂石	xi'hun'wai'fa'ji'du'huang'huan'zhu'shou'hun'shi	0
西瀛客栈穷兵黩武敦煌郡莫高窟	xi'ying'ke'zhan'qiong'bing'du'wu'dun'huang'jun'mo'gao'ku	0
西域苏州中原武林慕容璇玑	xi'yu'su'zhou'zhong'yuan'wu'lin'mu'rong'xuan'ji	0
鲜于超古剑天罡古剑巨阙破金符	xian'yu'chao'gu'jian'tian'gang'gu'jian'ju'que'po'jin'fu	0
弦月刀双仪天弧匕首精钢短剑	xian'yue'dao'shuang'yi'tian'hu'bi'shou'jing'gang'duan'jian	0
新科忍把浮名换了浅斟低唱萧熇	xin'ke'ren'ba'fu'ming'huan'le'qian'zhen'di'chang'xiao'he	0
续命神药十圣金丹返气丸聚元散	xu'ming'shen'yao'shi'sheng'jin'dan'fan'qi'wan'ju'yuan'san	0
玄魔法袍法袍白绢舞袖缀玉华装	xuan'mo'fa'pao'fa'pao'bai'juan'wu'xiu'zhui'yu'hua'zhuang	0
旋斩气刃麻痹千魔啸夜魔骇	xuan'zhan'qi'ren'ma'bi'qian'mo'xiao'ye'mo'hai	0
玄真剑狮吼剑辉日之剑古印剑	xuan'zhen'jian'shi'hou'jian'hui'ri'zhi'jian'gu'yin'jian	0
血婴冥葵绝煞剑妄幻铁藤缠护	xue'ying'ming'kui'jue'sha'jian'wang'huan'tie'teng'chan'hu	0
炎罗鬼化血毒沫化蛇血翼乌虺	yan'luo'gui'hua'xue'du'mo'hua'she'xue'yi'wu'hui	0
炎杀弹赤壳蜈蚣冰破飞锥冰蜈蚣	yan'sha'dan'chi'ke'wu'gong'bing'po'fei'zhui'bing'wu'gong	0
妖骨胄铜鳞甲青铜战甲僧袍	yao'gu'zhou'tong'lin'jia'qing'tong'zhan'jia'seng'pao	0
妖骨爪毒龙爪燕返刃星幻子	yao'gu'zhua'du'long'zhua'yan'fan'ren'xing'huan'zi	0
幽魉罗睺煌舞罗睺阳罗睺阴	you'liang'luo'hou'huang'wu'luo'hou'yang'luo'hou'yin	0
元凤四年柳永进士及第宋仁宗	yuan'feng'si'nian'liu'yong'jin'shi'ji'di'song'ren'zong	0
月牙泉殷千炀高皇君胧夜	yue'ya'quan'yin'qian'yang'gao'huang'jun'long'ye	0
战力召唤兽宝箱无方变幻	zhan'li'zhao'huan'shou'bao'xiang'wu'fang'bian'huan	0
斩马刀钢煞剑玄铁剑幽煌罗剑	zhan'ma'dao'gang'sha'jian'xuan'tie'jian'you'huang'luo'jian	0
战阵两百块帝国幕回复	zhan'zhen'liang'bai'kuai'di'guo'mu'hui'fu	0
张掖酒泉敦煌回鹘	zhang'ye'jiu'quan'dun'huang'hui'hu	0
真胤无相法杵雷光天铠韩千秀	zhen'yin'wu'xiang'fa'chu'lei'guang'tian'kai'han'qian'xiu	0
周崇朱浩天瑶派掌门	zhou'chong'zhu'hao'tian'yao'pai'zhang'men	0
周身单人术力行动力	zhou'shen'dan'ren'shu'li'xing'dong'li	0
朱慎瘟疫赫兰铁罕冰璃	zhu'shen'wen'yi'he'lan'tie'han'bing'li	0
紫枫七色彩绢七岳神剑天瑞华绫	zi'feng'qi'se'cai'juan'qi'yue'shen'jian'tian'rui'hua'ling	0
紫冥大挂弥勒垢衣绝技咒法	zi'ming'da'gua'mi'le'gou'yi'jue'ji'zhou'fa	0
紫琰飞煌宿玉泼风枪炎杀戟	zi'yan'fei'huang'su'yu'po'feng'qiang'yan'sha'ji	0
紫云派河北苍岩山太原	zi'yun'pai'he'bei'cang'yan'shan'tai'yuan	0
