包着红头巾的奶奶	bao'zhe'hong'tou'jin'de'nai'nai	0
并结为连理的浪漫情怀	bing'jie'wei'lian'li'de'lang'man'qing'huai	0
不顾曾祖父	bu'gu'zeng'zu'fu	0
常常让我在观她时亦如痴如醉	chang'chang'rang'wo'zai'guan'ta'shi'yi'ru'chi'ru'zui	0
穿着白色裙裾	chuan'zhe'bai'se'qun'ju	0
从此便过起俭朴的日子	cong'ci'bian'guo'qi'jian'pu'de'ri'zi	0
从此住在一幢大房子里	cong'ci'zhu'zai'yi'zhuang'da'fang'zi'li	0
但是	dan'shi	0
第二天早上醒来层里不见奶奶	di'er'tian'zao'shang'xing'lai'ceng'li'bu'jian'nai'nai	0
而是说给那个已随岁月远去的人	er'shi'shuo'gei'na'ge'yi'sui'sui'yue'yuan'qu'de'ren	0
光景不长	guang'jing'bu'chang	0
化作一个小红点	hua'zuo'yi'ge'xiao'hong'dian	0
几分凄婉地搁在那里	ji'fen'qi'wan'di'ge'zai'na'li	0
几分优美	ji'fen'you'mei	0
家里人都没去惊动她	jia'li'ren'dou'mei'qu'jing'dong'ta	0
见一行脚印孤零零地伸向雪野	jian'yi'hang'jiao'yin'gu'ling'ling'de'shen'xiang'xue'ye	0
具有双重坏出身的父亲	ju'you'shuang'chong'huai'chu'shen'de'fu'qin	0
开门后	kai'men'hou	0
明早可以睡个懒觉了	ming'zao'ke'yi'shui'ge'lan'jiao'le	0
奶奶的房产被政府没收	nai'nai'de'fang'chan'bei'zheng'fu'mo'shou	0
奶奶和父亲开始了流浪生涯	nai'nai'he'fu'qin'kai'shi'le'liu'lang'sheng'ya	0
奶奶临去前的那个冬天	nai'nai'lin'qu'qian'de'na'ge'dong'tian	0
奶奶是一部极富传奇的大书	nai'nai'shi'yi'bu'ji'fu'chuan'qi'de'da'shu	0
奶奶一生对雪如痴如醉	nai'nai'yi'sheng'dui'xue'ru'chi'ru'zui	0
翩翩迈进女子师范学校时的风姿	pian'pian'mai'jin'nv'zi'shi'fan'xue'xiao'shi'de'feng'zi	0
潜心培育着父亲	qian'xin'pei'yu'zhe'fu'qin	0
任软茸茸的一串小小脚窝	ren'ruan'rong'rong'de'yi'chuan'xiao'xiao'jiao'wo	0
甚至连她踏过的雪地也不去打扰	shen'zhi'lian'ta'ta'guo'de'xue'di'ye'bu'qu'da'rao	0
失去了爷爷的奶奶	shi'qu'le'ye'ye'de'nai'nai	0
她搬进平民区	ta'ban'jin'ping'min'qu	0
望着鹅毛雪片	wang'zhe'e'mao'xue'pian	0
我曾白去流水似的想象	wo'ceng'bai'qu'liu'shui'shi'de'xiang'xiang	0
我甚至大胆地假设	wo'shen'zhi'da'dan'de'jia'she	0
我相信这话不是对我们说的	wo'xiang'xin'zhe'hua'bu'shi'dui'wo'men'shuo'de	0
无声无息地伫立着	wu'sheng'wu'xi'di'zhu'li'zhe	0
下了一场几十年不遇的大雪	xia'le'yi'chang'ji'shi'nian'bu'yu'de'da'xue	0
下雪的那个早上	xia'xue'de'na'ge'zao'shang	0
雪是从头天傍晚时开始落下的	xue'shi'cong'tou'tian'bang'wan'shi'kai'shi'luo'xia'de	0
在脚印的那一端	zai'jiao'yin'de'na'yi'duan	0
在我的感觉里	zai'wo'de'gan'jue'li	0
曾祖母的反对	zeng'zu'mu'de'fan'dui	0
这部传奇不仅在于她的非凡经历	zhe'bu'chuan'qi'bu'jin'zai'yu'ta'de'fei'fan'jing'li	0
直到解放后	zhi'dao'jie'fang'hou	0
