靶环征胃小区胃小沟激惹	ba'huan'zheng'wei'xiao'qu'wei'xiao'gou'ji're	0
半月综合征环堤肩胛征粘膜脱垂	ban'yue'zong'he'zheng'huan'di'jian'jia'zheng'nian'mo'tuo'chui	0
贲门食道裂孔疝疝囊食管胃环	ben'men'shi'dao'lie'kong'shan'shan'nang'shi'guan'wei'huan	0
超声核素体层显像	chao'sheng'he'su'ti'ceng'xian'xiang	0
超声心动图放射柯氏位瓦氏位	chao'sheng'xin'dong'tu'fang'she'ke'shi'wei'wa'shi'wei	0
磁共振成像术磁共振成像断层	ci'gong'zhen'cheng'xiang'shu'ci'gong'zhen'cheng'xiang'duan'ceng	0
碘海醇伊索显西甲硅油鼻骨侧位	dian'hai'chun'yi'suo'xian'xi'jia'gui'you'bi'gu'ce'wei	0
返流性腐蚀性食管炎漏斗状	fan'liu'xing'fu'shi'xing'shi'guan'yan'lou'dou'zhuang	0
放射状花边状葱皮状条索状	fang'she'zhuang'hua'bian'zhuang'cong'pi'zhuang'tiao'suo'zhuang	0
肺大泡纤维化肺不张肺水肿	fei'da'pao'xian'wei'hua'fei'bu'zhang'fei'shui'zhong	0
肺段左上肺左下肺右上肺	fei'duan'zuo'shang'fei'zuo'xia'fei'you'shang'fei	0
肥厚粘连致密影钙化灶	fei'hou'zhan'lian'zhi'mi'ying'gai'hua'zao	0
肺静脉水平裂斜裂气管	fei'jing'mai'shui'ping'lie'xie'lie'qi'guan	0
分房双边征水上百合征飘带征	fen'fang'shuang'bian'zheng'shui'shang'bai'he'zheng'piao'dai'zheng	0
分叶状结节状虫蚀状结节影	fen'ye'zhuang'jie'jie'zhuang'chong'shi'zhuang'jie'jie'ying	0
钙化影高密度影模糊影包裹性	gai'hua'ying'gao'mi'du'ying'mo'hu'ying'bao'guo'xing	0
肝门钩突胰体胰头	gan'men'gou'tu'yi'ti'yi'tou	0
肝脓肿脾大肝大门静脉高压	gan'nong'zhong'pi'da'gan'da'men'jing'mai'gao'ya	0
肝淤血肝短静脉晕环征脓肿壁	gan'yu'xue'gan'duan'jing'mai'yun'huan'zheng'nong'zhong'bi	0
高信号低信号等信号自旋回波	gao'xin'hao'di'xin'hao'deng'xin'hao'zi'xuan'hui'bo	0
骨破坏骨硬化骨膜反应骨赘	gu'po'huai'gu'ying'hua'gu'mo'fan'ying'gu'zhui	0
骨质破坏骨皮质不连续两肺门	gu'zhi'po'huai'gu'pi'zhi'bu'lian'xu'liang'fei'men	0
黑化度阳极效应球管实时成像	hei'hua'du'yang'ji'xiao'ying'qiu'guan'shi'shi'cheng'xiang	0
横轴型山字形三叶形葫芦形	heng'zhou'xing'shan'zi'xing'san'ye'xing'hu'lu'xing	0
灰度灰阶窗宽窗位	hui'du'hui'jie'chuang'kuan'chuang'wei	0
会厌谿吞钡胸中段胸上段	hui'yan'xi'tun'bei'xiong'zhong'duan'xiong'shang'duan	0
积液胸腔叶间积液肺底积液	ji'ye'xiong'qiang'ye'jian'ji'ye'fei'di'ji'ye	0
间隔线充盈缺损憩室粘膜线	jian'ge'xian'chong'ying'que'sun'qi'shi'nian'mo'xian	0
结肠袋球部降段水平段	jie'chang'dai'qiu'bu'jiang'duan'shui'ping'duan	0
局限性膈膨出波浪膈膨隆胸膜	ju'xian'xing'ge'peng'chu'bo'lang'ge'peng'long'xiong'mo	0
蝌蚪状软藤征枯枝征肝硬化	ke'dou'zhuang'ruan'teng'zheng'ku'zhi'zheng'gan'ying'hua	0
空气半月征树芽征空洞空腔	kong'qi'ban'yue'zheng'shu'ya'zheng'kong'dong'kong'qiang	0
括约肌胃溃疡指压征皮革胃	kuo'yue'ji'wei'kui'yang'zhi'ya'zheng'pi'ge'wei	0
隆起型凹陷型混合型静脉曲张	long'qi'xing'ao'xian'xing'hun'he'xing'jing'mai'qu'zhang	0
卵石征线样征肠套叠回盲部	luan'shi'zheng'xian'yang'zheng'chang'tao'die'hui'mang'bu	0
梅氏位许氏位斑片状网格状	mei'shi'wei'xu'shi'wei'ban'pian'zhuang'wang'ge'zhuang	0
囊袋状牛角型钩型长钩型	nang'dai'zhuang'niu'jiao'xing'gou'xing'chang'gou'xing	0
内段上段背段前基底段	nei'duan'shang'duan'bei'duan'qian'ji'di'duan	0
鸟嘴状潴留液平滑肌瘤环形征	niao'zui'zhuang'zhu'liu'ye'ping'hua'ji'liu'huan'xing'zheng	0
胼胝性穿透性穿孔性浸润溃疡型	pian'zhi'xing'chuan'tou'xing'chuan'kong'xing'jin'run'kui'yang'xing	0
平扫增强造影剂对比剂	ping'sao'zeng'qiang'zao'ying'ji'dui'bi'ji	0
气胸液气胸膈膨隆肺实变	qi'xiong'ye'qi'xiong'ge'peng'long'fei'shi'bian	0
奇叶副叶肺门肺动脉	qi'ye'fu'ye'fei'men'fei'dong'mai	0
前段上舌段下舌段外段	qian'duan'shang'she'duan'xia'she'duan'wai'duan	0
前纵隔中纵隔后纵隔横膈	qian'zong'ge'zhong'zong'ge'hou'zong'ge'heng'ge	0
腔内型蕈伞型浸润型平坦型	qiang'nei'xing'xun'san'xing'jin'run'xing'ping'tan'xing	0
升段蠕动波羽毛状锯齿状	sheng'duan'ru'dong'bo'yu'mao'zhuang'ju'chi'zhuang	0
食道癌髓质型溃疡型硬化型	shi'dao'ai'sui'zhi'xing'kui'yang'xing'ying'hua'xing	0
双肺野清晰胸廓胸廓对称肋骨	shuang'fei'ye'qing'xi'xiong'kuo'xiong'kuo'dui'chen'lei'gu	0
顺磁性影像医学影像学影像学	shun'ci'xing'ying'xiang'yi'xue'ying'xiang'xue'ying'xiang'xue	0
粟粒样磨玻璃样肺叶肺野	su'li'yang'mo'bo'li'yang'fei'ye'fei'ye	0
条片状片状斑条状片絮状	tiao'pian'zhuang'pian'zhuang'ban'tiao'zhuang'pian'xu'zhuang	0
胃底胃体胃窦幽门	wei'di'wei'ti'wei'dou'you'men	0
胃扭转器官轴型网膜轴型纵轴型	wei'niu'zhuan'qi'guan'zhou'xing'wang'mo'zhou'xing'zong'zhou'xing	0
尾叶方叶外侧段内侧段	wei'ye'fang'ye'wai'ce'duan'nei'ce'duan	0
无力型瀑布型胃小弯胃大弯	wu'li'xing'pu'bu'xing'wei'xiao'wan'wei'da'wan	0
项圈征狭颈征蚯蚓状串珠状	xiang'quan'zheng'xia'jing'zheng'qiu'yin'zhuang'chuan'zhu'zhuang	0
胸下段压迹主动脉弓主动脉结	xiong'xia'duan'ya'ji'zhu'dong'mai'gong'zhu'dong'mai'jie	0
许梅氏位劳伦氏位顶颏位切线位	xu'mei'shi'wei'lao'lun'shi'wei'ding'ke'wei'qie'xian'wei	0
血流显像重建数字化分辨力	xue'liu'xian'xiang'chong'jian'shu'zi'hua'fen'bian'li	0
液气平面壁较薄囊状囊肿	ye'qi'ping'mian'bi'jiao'bo'nang'zhuang'nang'zhong	0
壅积笔杆样克罗恩病跳跃征	yong'ji'bi'gan'yang'ke'luo'en'bing'tiao'yue'zheng	0
右肺下叶尖段后段尖后段	you'fei'xia'ye'jian'duan'hou'duan'jian'hou'duan	0
右下肺肋膈角膈面肋间隙	you'xia'fei'lei'ge'jiao'ge'mian'lei'jian'xi	0
增多增粗增多增粗增多紊乱	zeng'duo'zeng'cu'zeng'duo'zeng'cu'zeng'duo'wen'luan	0
增厚肋膈角变钝	zeng'hou'lei'ge'jiao'bian'dun	0
脂肪肝肝叶光亮肝布加综合征	zhi'fang'gan'gan'ye'guang'liang'gan'bu'jia'zong'he'zheng	0
支气管气相间质性肺泡性袖口征	zhi'qi'guan'qi'xiang'jian'zhi'xing'fei'pao'xing'xiu'kou'zheng	0
轴位层面电影显示多平面重建	zhou'wei'ceng'mian'dian'ying'xian'shi'duo'ping'mian'chong'jian	0
走行肋骨走行自然未见骨质增生	zou'xing'lei'gu'zou'xing'zi'ran'wei'jian'gu'zhi'zeng'sheng	0
左支右支肝左叶肝右叶	zuo'zhi'you'zhi'gan'zuo'ye'gan'you'ye	0
