安住无量诸行中了达一切神通力	an'zhu'wu'liang'zhu'xing'zhong'le'da'yi'qie'shen'tong'li	0
八者常随佛学	ba'zhe'chang'sui'fo'xue	0
百分不及一千分不及一	bai'fen'bu'ji'yi'qian'fen'bu'ji'yi	0
百千俱胝那由他分	bai'qian'ju'zhi'na'you'ta'fen	0
比法供养一念功德	bi'fa'gong'yang'yi'nian'gong'de	0
彼佛众会咸清净我时于胜莲华生	bi'fo'zhong'hui'xian'qing'jing'wo'shi'yu'sheng'lian'hua'sheng	0
遍净庄严胜福力无著无依智慧力	bian'jing'zhuang'yan'sheng'fu'li'wu'zhu'wu'yi'zhi'hui'li	0
遍于法界极微尘刹	bian'yu'fa'jie'ji'wei'chen'sha	0
不久当如普贤菩萨	bu'jiu'dang'ru'pu'xian'pu'sa	0
不离菩提心供养	bu'li'pu'ti'xin'gong'yang	0
不舍菩萨业供养	bu'she'pu'sa'ye'gong'yang	0
布施尔所一切世界所有众生	bu'shi'er'suo'yi'qie'shi'jie'suo'you'zhong'sheng	0
常得出家修净戒无垢无破无穿漏	chang'de'chu'jia'xiu'jing'jie'wu'gou'wu'po'wu'chuan'lou	0
常修礼敬一一佛所	chang'xiu'li'jing'yi'yi'fo'suo	0
常愿与我同集会于我常生欢喜心	chang'yuan'yu'wo'tong'ji'hui'yu'wo'chang'sheng'huan'xi'xin	0
成等正觉转法輪普利一切诸含识	cheng'deng'zheng'jue'zhuan'fa'lun'pu'li'yi'qie'zhu'han'shi	0
成就诸佛无上菩提	cheng'jiu'zhu'fo'wu'shang'pu'ti	0
称叹如来胜功德已	cheng'tan'ru'lai'sheng'gong'de'yi	0
诚心忏悔后不复造	cheng'xin'chan'hui'hou'bu'fu'zao	0
称扬赞叹一切如来诸功德海	cheng'yang'zan'tan'yi'qie'ru'lai'zhu'gong'de'hai	0
处于种种村营聚落城邑宫殿	chu'yu'zhong'zhong'cun'ying'ju'luo'cheng'yi'gong'dian	0
此广大最胜供养	ci'guang'da'zui'sheng'gong'yang	0
此人不久当成就如彼普贤菩萨行	ci'ren'bu'jiu'dang'cheng'jiu'ru'bi'pu'xian'pu'sa'xing	0
此人善得胜寿命此人善来人中生	ci'ren'shan'de'sheng'shou'ming'ci'ren'shan'lai'ren'zhong'sheng	0
此善男子善得人身	ci'shan'nan'zi'shan'de'ren'shen	0
此诸菩萨色相端严功德具足	ci'zhu'pu'sa'se'xiang'duan'yan'gong'de'ju'zu	0
从初发心为一切智	cong'chu'fa'xin'wei'yi'qie'zhi	0
从初礼拜乃至随顺所有功德	cong'chu'li'bai'nai'zhi'sui'shun'suo'you'gong'de	0
从身语意之所生一切我今皆忏悔	cong'shen'yu'yi'zhi'suo'sheng'yi'qie'wo'jin'jie'chan'hui	0
大圣云何礼敬乃至回向	da'sheng'yun'he'li'jing'nai'zhi'hui'xiang	0
代众生苦供养	dai'zhong'sheng'ku'gong'yang	0
到已即见阿弥陀佛	dao'yi'ji'jian'e'mi'tuo'fo	0
定慧方便及解脱获诸无尽功德藏	ding'hui'fang'bian'ji'jie'tuo'huo'zhu'wu'jin'gong'de'cang	0
定慧方便威神力普能积集菩提力	ding'hui'fang'bian'wei'shen'li'pu'neng'ji'ji'pu'ti'li	0
尔时普贤菩萨摩诃萨	er'shi'pu'xian'pu'sa'mo'he'sa	0
尔时世尊与诸圣者菩萨摩诃萨	er'shi'shi'zun'yu'zhu'sheng'zhe'pu'sa'mo'he'sa	0
而为利益不久当坐菩提道场	er'wei'li'yi'bu'jiu'dang'zuo'pu'ti'dao'chang	0
而我悉以身口意业	er'wo'xi'yi'shen'kou'yi'ye	0
而虚空界乃至烦恼不可尽故	er'xu'kong'jie'nai'zhi'fan'nao'bu'ke'jin'gu	0
而虚空界乃至众生烦恼不可尽故	er'xu'kong'jie'nai'zhi'zhong'sheng'fan'nao'bu'ke'jin'gu	0
二者称赞如来	er'zhe'cheng'zan'ru'lai	0
而众生界乃至烦恼无有尽故	er'zhong'sheng'jie'nai'zhi'fan'nao'wu'you'jin'gu	0
佛海及与国土海我遍修行经劫海	fo'hai'ji'yu'guo'tu'hai'wo'bian'xiu'xing'jing'jie'hai	0
复次善男子言忏悔业障者	fu'ci'shan'nan'zi'yan'chan'hui'ye'zhang'zhe	0
复次善男子言常随佛学者	fu'ci'shan'nan'zi'yan'chang'sui'fo'xue'zhe	0
复次善男子言称赞如来者	fu'ci'shan'nan'zi'yan'cheng'zan'ru'lai'zhe	0
复次善男子言广修供养者	fu'ci'shan'nan'zi'yan'guang'xiu'gong'yang'zhe	0
复次善男子言恒顺众生者	fu'ci'shan'nan'zi'yan'heng'shun'zhong'sheng'zhe	0
复次善男子言普皆回向者	fu'ci'shan'nan'zi'yan'pu'jie'hui'xiang'zhe	0
复次善男子言请佛住世者	fu'ci'shan'nan'zi'yan'qing'fo'zhu'shi'zhe	0
复次善男子言请转法輪者	fu'ci'shan'nan'zi'yan'qing'zhuan'fa'lun'zhe	0
复次善男子言随喜功德者	fu'ci'shan'nan'zi'yan'sui'xi'gong'de'zhe	0
辅相大臣宫城内外	fu'xiang'da'chen'gong'cheng'nei'wai	0
告诸菩萨及善财言	gao'zhu'pu'sa'ji'shan'cai'yan	0
各以出过辩才天女微妙舌根	ge'yi'chu'guo'bian'cai'tian'nv'wei'miao'she'gen	0
各以一切音声海普出无尽妙言辞	ge'yi'yi'qie'yin'sheng'hai'pu'chu'wu'jin'miao'yan'ci	0
供养尔所一切世界诸佛菩萨	gong'yang'er'suo'yi'qie'shi'jie'zhu'fo'pu'sa	0
供养过去诸如来及与现在十方佛	gong'yang'guo'qu'zhu'ru'lai'ji'yu'xian'zai'shi'fang'fo	0
广大功德我皆随喜	guang'da'gong'de'wo'jie'sui'xi	0
果报唯佛能证知决定获胜菩提道	guo'bao'wei'fo'neng'zheng'zhi'jue'ding'huo'sheng'pu'ti'dao	0
何等为十	he'deng'wei'shi	0
何以故菩萨若能随顺众生	he'yi'gu'pu'sa'ruo'neng'sui'shun'zhong'sheng	0
何以故以诸如来尊重法故	he'yi'gu'yi'zhu'ru'lai'zun'zhong'fa'gu	0
何以故诸佛如来	he'yi'gu'zhu'fo'ru'lai	0
恒修普贤广大行圆满无上大菩提	heng'xiu'pu'xian'guang'da'xing'yuan'man'wu'shang'da'pu'ti	0
恒住净戒一切功德	heng'zhu'jing'jie'yi'qie'gong'de	0
恒转理趣妙法輪我深智力普能入	heng'zhuan'li'qu'miao'fa'lun'wo'shen'zhi'li'pu'neng'ru	0
或处声闻及辟支佛众会道场	huo'chu'sheng'wen'ji'pi'zhi'fo'zhong'hui'dao'chang	0
或处一切诸大菩萨众会道场	huo'chu'yi'qie'zhu'da'pu'sa'zhong'hui'dao'chang	0
或处转轮圣王小王眷属众会道场	huo'chu'zhuan'lun'sheng'wang'xiao'wang'juan'shu'zhong'hui'dao'chang	0
获得甚深正法利灭除烦恼尽无余	huo'de'shen'shen'zheng'fa'li'mie'chu'fan'nao'jin'wu'yu	0
或复有人以深信心	huo'fu'you'ren'yi'shen'xin'xin	0
或有依空及诸卉木而生住者	huo'you'yi'kong'ji'zhu'hui'mu'er'sheng'zhu'zhe	0
或有依于地水火风而生住者	huo'you'yi'yu'di'shui'huo'feng'er'sheng'zhu'zhe	0
及阿罗汉乃至如来等无有异	ji'a'luo'han'nai'zhi'ru'lai'deng'wu'you'yi	0
及般涅槃分布舍利	ji'ban'nie'pan'fen'bu'she'li	0
及彼十方一切世界	ji'bi'shi'fang'yi'qie'shi'jie	0
即常远离恶知识永离一切诸恶道	ji'chang'yuan'li'e'zhi'shi'yong'li'yi'qie'zhu'e'dao	0
极微尘数诸佛如来	ji'wei'chen'shu'zhu'fo'ru'lai	0
极微尘数诸佛世尊	ji'wei'chen'shu'zhu'fo'shi'zun	0
及余十方种种世界普来集会	ji'yu'shi'fang'zhong'zhong'shi'jie'pu'lai'ji'hui	0
及诸菩萨声闻缘觉	ji'zhu'pu'sa'sheng'wen'yuan'jue	0
及诸人天最胜安乐	ji'zhu'ren'tian'zui'sheng'an'le	0
迦罗分算分数分喻分	jia'luo'fen'suan'fen'shu'fen'yu'fen	0
假使十方一切诸佛	jia'shi'shi'fang'yi'qie'zhu'fo	0
将欲示现般涅槃者	jiang'yu'shi'xian'ban'nie'pan'zhe	0
皆得往生阿弥陀佛极乐世界	jie'de'wang'sheng'e'mi'tuo'fo'ji'le'shi'jie	0
皆有一切世界极微尘数佛	jie'you'yi'qie'shi'jie'ji'wei'chen'shu'fo	0
尽虚空界不能容受	jin'xu'kong'jie'bu'neng'rong'shou	0
尽于法界无不周遍	jin'yu'fa'jie'wu'bu'zhou'bian	0
尽于未来一切劫赞佛甚深功德海	jin'yu'wei'lai'yi'qie'jie'zan'fo'shen'shen'gong'de'hai	0
经不可说不可说佛刹极微尘数劫	jing'bu'ke'shuo'bu'ke'shuo'fo'sha'ji'wei'chen'shu'jie	0
经尔所佛刹极微尘数劫相续不断	jing'er'suo'fo'sha'ji'wei'chen'shu'jie'xiang'xu'bu'duan	0
经于无数百千万亿那由他劫	jing'yu'wu'shu'bai'qian'wan'yi'na'you'ta'jie	0
经于一切佛刹极微尘数劫	jing'yu'yi'qie'fo'sha'ji'wei'chen'shu'jie	0
究竟佛事示涅槃我皆往诣而亲近	jiu'jing'fo'shi'shi'nie'pan'wo'jie'wang'yi'er'qin'jin	0
究竟清净普贤道尽未来劫常修习	jiu'jing'qing'jing'pu'xian'dao'jin'wei'lai'jie'chang'xiu'xi	0
九者恒顺众生	jiu'zhe'heng'shun'zhong'sheng	0
具三十二大丈夫相	ju'san'shi'er'da'zhang'fu'xiang	0
堪受一切众生供养	kan'shou'yi'qie'zhong'sheng'gong'yang	0
利益众生供养	li'yi'zhong'sheng'gong'yang	0
六趣四生一切种类	liu'qu'si'sheng'yi'qie'zhong'lei	0
六者请转法輪	liu'zhe'qing'zhuan'fa'lun	0
满彼事业尽无余未来际劫恒无倦	man'bi'shi'ye'jin'wu'yu'wei'lai'ji'jie'heng'wu'juan	0
蒙彼如来授记已化身无数百俱胝	meng'bi'ru'lai'shou'ji'yi'hua'shen'wu'shu'bai'ju'zhi	0
蒙佛授记得授记已	meng'fo'shou'ji'de'shou'ji'yi	0
面见彼佛阿弥陀即得往生安乐刹	mian'jian'bi'fo'a'mi'tuo'ji'de'wang'sheng'an'le'sha	0
灭除障垢无有余一切妙行皆成就	mie'chu'zhang'gou'wu'you'yu'yi'qie'miao'xing'jie'cheng'jiu	0
莫生疑念应当谛受受已能读	mo'sheng'yi'nian'ying'dang'di'shou'shou'yi'neng'du	0
乃至虚空世界尽众生及业烦恼尽	nai'zhi'xu'kong'shi'jie'jin'zhong'sheng'ji'ye'fan'nao'jin	0
乃至一切天龙八部人非人等	nai'zhi'yi'qie'tian'long'ba'bu'ren'fei'ren'deng	0
念念相续无有间断	nian'nian'xiang'xu'wu'you'jian'duan	0
毗卢遮那如来从初发心精进不退	pi'lu'zhe'na'ru'lai'cong'chu'fa'xin'jing'jin'bu'tui	0
譬如旷野沙碛之中	pi'ru'kuang'ye'sha'qi'zhi'zhong	0
普尽十方诸刹海一一毛端三世海	pu'jin'shi'fang'zhu'cha'hai'yi'yi'mao'duan'san'shi'hai	0
普能清净诸行海圆满一切诸愿海	pu'neng'qing'jing'zhu'xing'hai'yuan'man'yi'qie'zhu'yuan'hai	0
普能严净诸刹海解脱一切众生海	pu'neng'yan'jing'zhu'cha'hai'jie'tuo'yi'qie'zhong'sheng'hai	0
菩萨如是平等饶益一切众生	pu'sa'ru'shi'ping'deng'rao'yi'yi'qie'zhong'sheng	0
菩萨如是随顺众生	pu'sa'ru'shi'sui'shun'zhong'sheng	0
菩萨如是所修回向	pu'sa'ru'shi'suo'xiu'hui'xiang	0
菩萨自念我于过去无始劫中	pu'sa'zi'nian'wo'yu'guo'qu'wu'shi'jie'zhong	0
普贤菩萨告善财言	pu'xian'pu'sa'gao'shan'cai'yan	0
普贤行愿威神力普现一切如来前	pu'xian'xing'yuan'wei'shen'li'pu'xian'yi'qie'ru'lai'qian	0
普于十方不可说不可说世界	pu'yu'shi'fang'bu'ke'shuo'bu'ke'shuo'shi'jie	0
普愿沉溺诸众生速往无量光佛刹	pu'yuan'chen'ni'zhu'zhong'sheng'su'wang'wu'liang'guang'fo'sha	0
七者请佛住世	qi'zhe'qing'fo'zhu'shi	0
亲睹如来无量光现前授我菩提记	qin'du'ru'lai'wu'liang'guang'xian'qian'shou'wo'pu'ti'ji	0
亲近供养诸佛海修行无倦经劫海	qin'jin'gong'yang'zhu'fo'hai'xiu'xing'wu'juan'jing'jie'hai	0
勤修福聚不惜身命	qin'xiu'fu'ju'bu'xi'shen'ming	0
勤修清净波罗密恒不忘失菩提心	qin'xiu'qing'jing'bo'luo'mi'heng'bu'wang'shi'pu'ti'xin	0
勤修善根供养	qin'xiu'shan'gen'gong'yang	0
清净一切善业力摧灭一切烦恼力	qing'jing'yi'qie'shan'ye'li'cui'mie'yi'qie'fan'nao'li	0
穷未来际相续不断	qiong'wei'lai'ji'xiang'xu'bu'duan	0
求胜菩提心渴仰获胜功德过于彼	qiu'sheng'pu'ti'xin'ke'yang'huo'sheng'gong'de'guo'yu'bi	0
然种种灯酥灯油灯诸香油灯	ran'zhong'zhong'deng'su'deng'you'deng'zhu'xiang'you'deng	0
如此娑婆世界	ru'ci'suo'po'shi'jie	0
如敬父母如奉师长	ru'jing'fu'mu'ru'feng'shi'zhang	0
如空中月出于云翳	ru'kong'zhong'yue'chu'yu'yun'yi	0
如来赞言善哉善哉	ru'lai'zan'yan'shan'zai'shan'zai	0
如是等云一一量如须弥山王	ru'shi'deng'yun'yi'yi'liang'ru'xu'mi'shan'wang	0
如是尽法界虚空界	ru'shi'jin'fa'jie'xu'kong'jie	0
如是经于刹尘劫十方利益恒无尽	ru'shi'jing'yu'sha'chen'jie'shi'fang'li'yi'heng'wu'jin	0
如是乃至众生界尽	ru'shi'nai'zhi'zhong'sheng'jie'jin	0
如是修行是真供养故	ru'shi'xiu'xing'shi'zhen'gong'yang'gu	0
如是虚空界尽	ru'shi'xu'kong'jie'jin	0
如是一切难行苦行	ru'shi'yi'qie'nan'xing'ku'xing	0
如是一切无尽时我愿究竟恒无尽	ru'shi'yi'qie'wu'jin'shi'wo'yuan'jiu'jing'heng'wu'jin	0
如是智慧号普贤愿我与彼皆同等	ru'shi'zhi'hui'hao'pu'xian'yuan'wo'yu'bi'jie'tong'deng	0
如师子王摧伏羣兽	ru'shi'zi'wang'cui'fu'qun'shou	0
如是最胜庄严具我以供养诸如来	ru'shi'zui'sheng'zhuang'yan'ju'wo'yi'gong'yang'zhu'ru'lai	0
若此恶业有体相者	ruo'ci'e'ye'you'ti'xiang'zhe	0
若复有人闻此愿王一经于耳	ruo'fu'you'ren'wen'ci'yuan'wang'yi'jing'yu'er	0
若令众生生欢喜者	ruo'ling'zhong'sheng'sheng'huan'xi'zhe	0
若人诵此普贤愿我说少分之善根	ruo'ren'song'ci'pu'xian'yuan'wo'shuo'shao'fen'zhi'shan'gen	0
若人于此普贤愿读诵受持及演说	ruo'ren'yu'ci'pu'xian'yuan'du'song'shou'chi'ji'yan'shuo	0
若人于此胜愿王一经于耳能生信	ruo'ren'yu'ci'sheng'yuan'wang'yi'jing'yu'er'neng'sheng'xin	0
若生人天所在之处常居胜族	ruo'sheng'ren'tian'suo'zai'zhi'chu'chang'ju'sheng'zu	0
若有善男子善女人	ruo'you'shan'nan'zi'shan'nv'ren	0
若欲成就此功德门	ruo'yu'cheng'jiu'ci'gong'de'men	0
若于众生尊重承事	ruo'yu'zhong'sheng'zun'zhong'cheng'shi	0
若诸菩萨行法供养	ruo'zhu'pu'sa'xing'fa'gong'yang	0
若诸众生因其积集诸恶业故	ruo'zhu'zhong'sheng'yin'qi'ji'ji'zhu'e'ye'gu	0
三世所有一切劫为一念际我皆入	san'shi'suo'you'yi'qie'jie'wei'yi'nian'ji'wo'jie'ru	0
三世一切诸如来于彼无尽语言海	san'shi'yi'qie'zhu'ru'lai'yu'bi'wu'jin'yu'yan'hai	0
三世一切诸如来最胜菩提诸行愿	san'shi'yi'qie'zhu'ru'lai'zui'sheng'pu'ti'zhu'xing'yuan	0
三世诸佛所称叹如是最胜诸大愿	san'shi'zhu'fo'suo'cheng'tan'ru'shi'zui'sheng'zhu'da'yuan	0
三者广修供养	san'zhe'guang'xiu'gong'yang	0
善财白言	shan'cai'bai'yan	0
善财童子踊跃无量	shan'cai'tong'zi'yong'yue'wu'liang	0
善男子如来功德	shan'nan'zi'ru'lai'gong'de	0
善男子如前供养无量功德	shan'nan'zi'ru'qian'gong'yang'wu'liang'gong'de	0
善男子汝于此义应如是解	shan'nan'zi'ru'yu'ci'yi'ying'ru'shi'jie	0
善男子是为菩萨摩诃萨十种大愿	shan'nan'zi'shi'wei'pu'sa'mo'he'sa'shi'zhong'da'yuan	0
善男子言礼敬诸佛者	shan'nan'zi'yan'li'jing'zhu'fo'zhe	0
善男子诸供养中法供养最	shan'nan'zi'zhu'gong'yang'zhong'fa'gong'yang'zui	0
善能分别诸法海能甚深入智慧海	shan'neng'fen'bie'zhu'fa'hai'neng'shen'shen'ru'zhi'hui'hai	0
摄受众生供养	she'shou'zhong'sheng'gong'yang	0
身口意业皆同等一切行愿同修学	shen'kou'yi'ye'jie'tong'deng'yi'qie'xing'yuan'tong'xiu'xue	0
深心信解如对目前	shen'xin'xin'jie'ru'dui'mu'qian	0
身语意业无有疲厌	shen'yu'yi'ye'wu'you'pi'yan	0
生死旷野菩提树王	sheng'si'kuang'ye'pu'ti'shu'wang	0
十方刹海所有众生	shi'fang'cha'hai'suo'you'zhong'sheng	0
十方尘刹诸毛端我皆深入而严净	shi'fang'chen'sha'zhu'mao'duan'wo'jie'shen'ru'er'yan'jing	0
十方三世一切佛刹	shi'fang'san'shi'yi'qie'fo'sha	0
十方三世一切佛刹极微尘中	shi'fang'san'shi'yi'qie'fo'sha'ji'wei'chen'zhong	0
十方三世一切刹土	shi'fang'san'shi'yi'qie'sha'tu	0
十方三世一切声闻	shi'fang'san'shi'yi'qie'sheng'wen	0
十方所有世间灯最初成就菩提者	shi'fang'suo'you'shi'jian'deng'zui'chu'cheng'jiu'pu'ti'zhe	0
十方所有无边刹庄严众宝供如来	shi'fang'suo'you'wu'bian'sha'zhuang'yan'zhong'bao'gong'ru'lai	0
十方所有诸众生愿离忧患常安乐	shi'fang'suo'you'zhu'zhong'sheng'yuan'li'you'huan'chang'an'le	0
十方一切诸众生二乘有学及无学	shi'fang'yi'qie'zhu'zhong'sheng'er'cheng'you'xue'ji'wu'xue	0
是故菩提属于众生	shi'gu'pu'ti'shu'yu'zhong'sheng	0
是故汝等闻此愿王	shi'gu'ru'deng'wen'ci'yuan'wang	0
是故善男子汝于此义应如是知	shi'gu'shan'nan'zi'ru'yu'ci'yi'ying'ru'shi'zhi	0
十者普皆回向	shi'zhe'pu'jie'hui'xiang	0
四者忏悔业障	si'zhe'chan'hui'ye'zhang	0
诵此普贤大愿王一念速疾皆消灭	song'ci'pu'xian'da'yuan'wang'yi'nian'su'ji'jie'xiao'mie	0
速得成就微妙色身	su'de'cheng'jiu'wei'miao'se'shen	0
速疾周遍神通力普门遍入大乘力	su'ji'zhou'bian'shen'tong'li'pu'men'bian'ru'da'cheng'li	0
速见如来无量光具此普贤最胜愿	su'jian'ru'lai'wu'liang'guang'ju'ci'pu'xian'zui'sheng'yuan	0
速能除灭五无间业	su'neng'chu'mie'wu'wu'jian'ye	0
速诣菩提大树王坐已降服诸魔众	su'yi'pu'ti'da'shu'wang'zuo'yi'xiang'fu'zhu'mo'zhong	0
随其根性教化成熟	sui'qi'gen'xing'jiao'hua'cheng'shu	0
随喜忏悔诸善根回向众生及佛道	sui'xi'chan'hui'zhu'shan'gen'hui'xiang'zhong'sheng'ji'fo'dao	0
随诸众生意乐音一一流佛辩才海	sui'zhu'zhong'sheng'yi'yue'yin'yi'yi'liu'fo'bian'cai'hai	0
所得功德	suo'de'gong'de	0
所感一切极重苦果我皆代受	suo'gan'yi'qie'ji'zhong'ku'guo'wo'jie'dai'shou	0
所共围绕其人自见生莲华中	suo'gong'wei'rao'qi'ren'zi'jian'sheng'lian'hua'zhong	0
所获福聚无量无边	suo'huo'fu'ju'wu'liang'wu'bian	0
所谓华云鬘云天音乐云	suo'wei'hua'yun'man'yun'tian'yin'yue'yun	0
所谓如说修行供养	suo'wei'ru'shuo'xiu'xing'gong'yang	0
所有尘中一切如来	suo'you'chen'zhong'yi'qie'ru'lai	0
所有功德乃至一尘我皆随喜	suo'you'gong'de'nai'zhi'yi'chen'wo'jie'sui'xi	0
所有极微一一尘中	suo'you'ji'wei'yi'yi'chen'zhong	0
所有尽法界虚空界	suo'you'jin'fa'jie'xu'kong'jie	0
所有礼赞供养福请佛住世转法輪	suo'you'li'zan'gong'yang'fu'qing'fo'zhu'shi'zhuan'fa'lun	0
所有善根我皆随喜	suo'you'shan'gen'wo'jie'sui'xi	0
所有十方世界中三世一切人师子	suo'you'shi'fang'shi'jie'zhong'san'shi'yi'qie'ren'shi'zi	0
所有十方一切刹广大清净妙庄严	suo'you'shi'fang'yi'qie'sha'guang'da'qing'jing'miao'zhuang'yan	0
所有世间身心等病	suo'you'shi'jian'shen'xin'deng'bing	0
所有未来照世灯成道转法悟群有	suo'you'wei'lai'zhao'shi'deng'cheng'dao'zhuan'fa'wu'qun'you	0
所有一切众生语悉以诸音而说法	suo'you'yi'qie'zhong'sheng'yu'xi'yi'zhu'yin'er'shuo'fa	0
所有益我善知识为我显示普贤行	suo'you'yi'wo'shan'zhi'shi'wei'wo'xian'shi'pu'xian'xing	0
所有与我同行者于一切处同集会	suo'you'yu'wo'tong'xing'zhe'yu'yi'qie'chu'tong'ji'hui	0
唐罽宾国三藏般若奉诏译	tang'ji'bin'guo'san'zang'bo're'feng'zhao'yi	0
天龙夜叉鸠槃茶乃至人与非人等	tian'long'ye'cha'jiu'pan'cha'nai'zhi'ren'yu'fei'ren'deng	0
往昔由无智慧力所造极恶五无间	wang'xi'you'wu'zhi'hui'li'suo'zao'ji'e'wu'wu'jian	0
谓尽法界虚空界	wei'jin'fa'jie'xu'kong'jie	0
未来一切天人师一切意乐皆圆满	wei'lai'yi'qie'tian'ren'shi'yi'qie'yi'le'jie'yuan'man	0
为欲利乐一切众生	wei'yu'li'le'yi'qie'zhong'sheng	0
唯愿久住刹尘劫利乐一切诸众生	wei'yuan'jiu'zhu'sha'chen'jie'li'le'yi'qie'zhu'zhong'sheng	0
文殊师利菩萨而为上首	wen'shu'shi'li'pu'sa'er'wei'shang'shou	0
文殊师利勇猛智普贤慧行亦复然	wen'shu'shi'li'yong'meng'zhi'pu'xian'hui'xing'yi'fu'ran	0
我常随顺诸众生尽于未来一切劫	wo'chang'sui'shun'zhu'zhong'sheng'jin'yu'wei'lai'yi'qie'jie	0
我此忏悔无有穷尽	wo'ci'chan'hui'wu'you'qiong'jin	0
我此供养亦无有尽	wo'ci'gong'yang'yi'wu'you'jin	0
我此礼敬无有穷尽	wo'ci'li'jing'wu'you'qiong'jin	0
我此普贤殊胜行无边胜福皆回向	wo'ci'pu'xian'shu'sheng'xing'wu'bian'sheng'fu'jie'hui'xiang	0
我当悉以甚深胜解现前知见	wo'dang'xi'yi'shen'shen'sheng'jie'xian'qian'zhi'jian	0
我既往生彼国已现前成就此大愿	wo'ji'wang'sheng'bi'guo'yi'xian'qian'cheng'jiu'ci'da'yuan	0
我皆供养圆满修以普贤行悟菩提	wo'jie'gong'yang'yuan'man'xiu'yi'pu'xian'xing'wu'pu'ti	0
我皆于彼随顺而转	wo'jie'yu'bi'sui'shun'er'zhuan	0
我今回向诸善根随彼一切常修学	wo'jin'hui'xiang'zhu'shan'gen'sui'bi'yi'qie'chang'xiu'xue	0
我今回向诸善根为得普贤殊胜行	wo'jin'hui'xiang'zhu'shan'gen'wei'de'pu'xian'shu'sheng'xing	0
我今回向诸善根愿诸智行悉同彼	wo'jin'hui'xiang'zhu'shan'gen'yuan'zhu'zhi'xing'xi'tong'bi	0
我今悉以清净三业	wo'jin'xi'yi'qing'jing'san'ye	0
我今一切皆劝请转于无上妙法輪	wo'jin'yi'qie'jie'quan'qing'zhuan'yu'wu'shang'miao'fa'lun	0
我能深入于未来尽一切劫为一念	wo'neng'shen'ru'yu'wei'lai'jin'yi'qie'jie'wei'yi'nian	0
我随一切如来学修习普贤圆满行	wo'sui'yi'qie'ru'lai'xue'xiu'xi'pu'xian'yuan'man'xing	0
我所修行无有量获得无量诸功德	wo'suo'xiu'xing'wu'you'liang'huo'de'wu'liang'zhu'gong'de	0
我为遍净普贤行文殊师利诸大愿	wo'wei'bian'jing'pu'xian'xing'wen'shu'shi'li'zhu'da'yuan	0
我为菩提修行时一切趣中成宿命	wo'wei'pu'ti'xiu'xing'shi'yi'qie'qu'zhong'cheng'su'ming	0
我悉劝请莫入涅槃	wo'xi'quan'qing'mo'ru'nie'pan	0
我昔所造诸恶业皆由无始贪嗔痴	wo'xi'suo'zao'zhu'e'ye'jie'you'wu'shi'tan'chen'chi	0
我以广大胜解心深信一切三世佛	wo'yi'guang'da'sheng'jie'xin'shen'xin'yi'qie'san'shi'fo	0
我以普贤行愿力故	wo'yi'pu'xian'xing'yuan'li'gu	0
我以清净身语意一切遍礼尽无余	wo'yi'qing'jing'shen'yu'yi'yi'qie'bian'li'jin'wu'yu	0
我于一念见三世所有一切人师子	wo'yu'yi'nian'jian'san'shi'suo'you'yi'qie'ren'shi'zi	0
我于一切诸有中所修福智恒无尽	wo'yu'yi'qie'zhu'you'zhong'suo'xiu'fu'zhi'heng'wu'jin	0
我愿普随三世学速得成就大菩提	wo'yuan'pu'sui'san'shi'xue'su'de'cheng'jiu'da'pu'ti	0
无尽法界尘亦然深信诸佛皆充满	wu'jin'fa'jie'chen'yi'ran'shen'xin'zhu'fo'jie'chong'man	0
无有穷尽念念相续无有间断	wu'you'qiong'jin'nian'nian'xiang'xu'wu'you'jian'duan	0
五者随喜功德	wu'zhe'sui'xi'gong'de	0
无足二足四足多足有色无色	wu'zu'er'zu'si'zu'duo'zu'you'se'wu'se	0
悉除一切恶道苦等与一切群生乐	xi'chu'yi'qie'e'dao'ku'deng'yu'yi'qie'qun'sheng'le	0
悉皆回向尽法界虚空界	xi'jie'hui'xiang'jin'fa'jie'xu'kong'jie	0
悉以普贤行愿力普遍供养诸如来	xi'yi'pu'xian'xing'yuan'li'pu'bian'gong'yang'zhu'ru'lai	0
悉以清净身语意业	xi'yi'qing'jing'shen'yu'yi'ye	0
悉以上妙诸供养具而为供养	xi'yi'shang'miao'zhu'gong'yang'ju'er'wei'gong'yang	0
降服魔军成等正觉转妙法輪	xiang'fu'mo'jun'cheng'deng'zheng'jue'zhuan'miao'fa'lun	0
降服一切诸魔力圆满普贤诸行力	xiang'fu'yi'qie'zhu'mo'li'yuan'man'pu'xian'zhu'xing'li	0
象马车乘珍宝伏藏	xiang'ma'che'cheng'zhen'bao'fu'cang	0
相续演说不可穷尽	xiang'xu'yan'shuo'bu'ke'qiong'jin	0
虚空界尽我礼乃尽	xu'kong'jie'jin'wo'li'nai'jin	0
以不可说不可说身命而为布施	yi'bu'ke'shuo'bu'ke'shuo'shen'ming'er'wei'bu'shi	0
亦常入佛境界中如幻解脱及威力	yi'chang'ru'fo'jing'jie'zhong'ru'huan'jie'tuo'ji'wei'li	0
一尘中有尘数刹一一刹有难思佛	yi'chen'zhong'you'chen'shu'sha'yi'yi'cha'you'nan'si'fo	0
以大悲水饶益众生	yi'da'bei'shui'rao'yi'zhong'sheng	0
以大悲心而为体故	yi'da'bei'xin'er'wei'ti'gu	0
以大悲心随众生故	yi'da'bei'xin'sui'zhong'sheng'gu	0
亦复如是	yi'fu'ru'shi	0
亦皆如是于念念中我皆随学	yi'jie'ru'shi'yu'nian'nian'zhong'wo'jie'sui'xue	0
一念一切悉皆圆成就众生清净愿	yi'nian'yi'qie'xi'jie'yuan'cheng'jiu'zhong'sheng'qing'jing'yuan	0
一切魔军夜叉罗刹若鸠槃荼	yi'qie'mo'jun'ye'cha'luo'cha'ruo'jiu'pan'tu	0
一切菩萨海会围绕	yi'qie'pu'sa'hai'hui'wei'rao	0
一切菩萨皆大欢喜	yi'qie'pu'sa'jie'da'huan'xi	0
一切菩萨所修无量难行苦行	yi'qie'pu'sa'suo'xiu'wu'liang'nan'xing'ku'xing	0
一切亲属悉皆舍离	yi'qie'qin'shu'xi'jie'she'li	0
一切人天皆应礼敬	yi'qie'ren'tian'jie'ying'li'jing	0
一切如来有长子彼名号曰普贤尊	yi'qie'ru'lai'you'zhang'zi'bi'ming'hao'yue'pu'xian'zun	0
一切如来与菩萨所有功德皆随喜	yi'qie'ru'lai'yu'pu'sa'suo'you'gong'de'jie'sui'xi	0
一切如来语清净一言具众音声海	yi'qie'ru'lai'yu'qing'jing'yi'yan'ju'zhong'yin'sheng'hai	0
一切威势悉皆退失	yi'qie'wei'shi'xi'jie'tui'shi	0
一切圆满尽无余利乐一切众生界	yi'qie'yuan'man'jin'wu'yu'li'le'yi'qie'zhong'sheng'jie	0
一切众生而为树根	yi'qie'zhong'sheng'er'wei'shu'gen	0
一切众生悉应供养	yi'qie'zhong'sheng'xi'ying'gong'yang	0
一切众生愿令众生常得安乐	yi'qie'zhong'sheng'yuan'ling'zhong'sheng'chang'de'an'le	0
一切诸佛菩萨众前	yi'qie'zhu'fo'pu'sa'zhong'qian	0
以如是等诸供养具常为供养	yi'ru'shi'deng'zhu'gong'yang'ju'chang'wei'gong'yang	0
以如说行出生诸佛故	yi'ru'shuo'xing'chu'sheng'zhu'fo'gu	0
一身复现刹尘身一一遍礼刹尘佛	yi'shen'fu'xian'sha'chen'shen'yi'yi'bian'li'sha'chen'fo	0
一生补处住灌顶位诸大菩萨	yi'sheng'bu'chu'zhu'guan'ding'wei'zhu'da'pu'sa	0
以虚空界不可尽故	yi'xu'kong'jie'bu'ke'jin'gu	0
一一佛处众会中我见恒演菩提行	yi'yi'fo'chu'zhong'hui'zhong'wo'jian'heng'yan'pu'ti'xing	0
一一佛所皆有菩萨海会围绕	yi'yi'fo'suo'jie'you'pu'sa'hai'hui'wei'rao	0
一一佛所种种菩萨海会围绕	yi'yi'fo'suo'zhong'zhong'pu'sa'hai'hui'wei'rao	0
一一各有一切世界极微尘数佛	yi'yi'ge'you'yi'qie'shi'jie'ji'wei'chen'shu'fo	0
一一皆如妙高聚我悉供养诸如来	yi'yi'jie'ru'miao'gao'ju'wo'xi'gong'yang'zhu'ru'lai	0
一一舌根出无尽音声海	yi'yi'she'gen'chu'wu'jin'yin'sheng'hai	0
一一音声出一切言辞海	yi'yi'yin'sheng'chu'yi'qie'yan'ci'hai	0
以于众生心平等故	yi'yu'zhong'sheng'xin'ping'deng'gu	0
一者礼敬诸佛	yi'zhe'li'jing'zhu'fo	0
以智慧力随众生心	yi'zhi'hui'li'sui'zhong'sheng'xin	0
以诸最胜妙华鬘伎乐涂香及伞盖	yi'zhu'zui'sheng'miao'hua'man'ji'yue'tu'xiang'ji'san'gai	0
因菩提心成等正觉	yin'pu'ti'xin'cheng'deng'zheng'jue	0
因于大悲生菩提心	yin'yu'da'bei'sheng'pu'ti'xin	0
因于众生而起大悲	yin'yu'zhong'sheng'er'qi'da'bei	0
应修十种广大行愿	ying'xiu'shi'zhong'guang'da'xing'yuan	0
优波尼沙陀分亦不及一	you'bo'ni'sha'tuo'fen'yi'bu'ji'yi	0
又复是人临命终时	you'fu'shi'ren'lin'ming'zhong'shi	0
犹如莲华不著水亦如日月不住空	you'ru'lian'hua'bu'zhu'shui'yi'ru'ri'yue'bu'zhu'kong	0
由贪嗔痴发身口意	you'tan'chen'chi'fa'shen'kou'yi	0
有想无想非有想非无想如是等类	you'xiang'wu'xiang'fei'you'xiang'fei'wu'xiang'ru'shi'deng'lei	0
有学无学乃至一切诸善知识	you'xue'wu'xue'nai'zhi'yi'qie'zhu'shan'zhi'shi	0
于闇夜中为作光明	yu'an'ye'zhong'wei'zuo'guang'ming	0
于彼皆兴广大供尽未来劫无疲厌	yu'bi'jie'xing'guang'da'gong'jin'wei'lai'jie'wu'pi'yan	0
于贫穷者令得伏藏	yu'pin'qiong'zhe'ling'de'fu'cang	0
于失道者示其正路	yu'shi'dao'zhe'shi'qi'zheng'lu	0
于一尘中尘数佛各处菩萨众会中	yu'yi'chen'zhong'chen'shu'fo'ge'chu'pu'sa'zhong'hui'zhong	0
于一毛端极微中出现三世庄严刹	yu'yi'mao'duan'ji'wei'zhong'chu'xian'san'shi'zhuang'yan'sha	0
欲重宣此义普观十方而说偈言	yu'zhong'xuan'ci'yi'pu'guan'shi'fang'er'shuo'ji'yan	0
于诸病苦为作良医	yu'zhu'bing'ku'wei'zuo'liang'yi	0
于诸惑业及魔境世间道中得解脱	yu'zhu'huo'ye'ji'mo'jing'shi'jian'dao'zhong'de'jie'tuo	0
愿常面见诸如来及诸佛子众围绕	yuan'chang'mian'jian'zhu'ru'lai'ji'zhu'fo'zi'zhong'wei'rao	0
愿持诸佛微妙法光显一切菩提行	yuan'chi'zhu'fo'wei'miao'fa'guang'xian'yi'qie'pu'ti'xing	0
圆满普贤所有功德	yuan'man'pu'xian'suo'you'gong'de	0
圆满种种波罗蜜门	yuan'man'zhong'zhong'bo'luo'mi'men	0
愿身口意恒清净诸行刹土亦复然	yuan'shen'kou'yi'heng'qing'jing'zhu'xing'sha'tu'yi'fu'ran	0
愿我离欲命终时尽除一切诸障碍	yuan'wo'li'yu'ming'zhong'shi'jin'chu'yi'qie'zhu'zhang'ai	0
则得成就供养如来	ze'de'cheng'jiu'gong'yang'ru'lai	0
则令一切如来欢喜	ze'ling'yi'qie'ru'lai'huan'xi	0
则能成就阿耨多罗三藐三菩提故	ze'neng'cheng'jiu'a'nou'duo'luo'san'miao'san'pu'ti'gu	0
则能成就供养如来	ze'neng'cheng'jiu'gong'yang'ru'lai	0
则能成就圆满大悲	ze'neng'cheng'jiu'yuan'man'da'bei	0
则能成就诸佛菩萨智慧华果	ze'neng'cheng'jiu'zhu'fo'pu'sa'zhi'hui'hua'guo	0
则能成满普贤菩萨诸行愿海	ze'neng'cheng'man'pu'xian'pu'sa'zhu'xing'yuan'hai	0
则为随顺供养诸佛	ze'wei'sui'shun'gong'yang'zhu'fo	0
则为尊重承事如来	ze'wei'zun'zhong'cheng'shi'ru'lai	0
证入种种菩萨智地	zheng'ru'zhong'zhong'pu'sa'zhi'di	0
智力广大遍十方普利一切众生界	zhi'li'guang'da'bian'shi'fang'pu'li'yi'qie'zhong'sheng'jie	0
志求无上正等菩提	zhi'qiu'wu'shang'zheng'deng'pu'ti	0
智行普修功德力威神普覆大慈力	zhi'xing'pu'xiu'gong'de'li'wei'shen'pu'fu'da'ci'li	0
众会围绕诸如来悉在菩提树王下	zhong'hui'wei'rao'zhu'ru'lai'xi'zai'pu'ti'shu'wang'xia	0
众生业尽众生烦恼尽我礼乃尽	zhong'sheng'ye'jin'zhong'sheng'fan'nao'jin'wo'li'nai'jin	0
种种差别所谓卵生胎生湿生化生	zhong'zhong'cha'bie'suo'wei'luan'sheng'tai'sheng'shi'sheng'hua'sheng	0
种种承事种种供养	zhong'zhong'cheng'shi'zhong'zhong'gong'yang	0
种种方便殷勤劝请转妙法輪	zhong'zhong'fang'bian'yin'qin'quan'qing'zhuan'miao'fa'lun	0
种种苦恼	zhong'zhong'ku'nao	0
诸大菩萨及所成熟六千比丘	zhu'da'pu'sa'ji'suo'cheng'shu'liu'qian'bi'qiu	0
诸大声闻并诸人天一切世主	zhu'da'sheng'wen'bing'zhu'ren'tian'yi'qie'shi'zhu	0
诸佛菩萨而为华果	zhu'fo'pu'sa'er'wei'hua'guo	0
诸佛菩萨之所称赞	zhu'fo'pu'sa'zhi'suo'cheng'zan	0
诸佛若欲示涅槃我悉至诚而劝请	zhu'fo'ruo'yu'shi'nie'pan'wo'xi'zhi'cheng'er'quan'qing	0
诸魔外道不能摧堪为三界所应供	zhu'mo'wai'dao'bu'neng'cui'kan'wei'san'jie'suo'ying'gong	0
族姓种类及容色相好智慧咸圆满	zu'xing'zhong'lei'ji'rong'se'xiang'hao'zhi'hui'xian'yuan'man	0
最后刹那一切诸根悉皆散坏	zui'hou'cha'na'yi'qie'zhu'gen'xi'jie'san'huai	0
最胜安乐施天人经一切刹微尘劫	zui'sheng'an'le'shi'tian'ren'jing'yi'qie'sha'wei'chen'jie	0
最胜衣服最胜香末香烧香与灯烛	zui'sheng'yi'fu'zui'sheng'xiang'mo'xiang'shao'xiang'yu'deng'zhu	0
作诸恶业无量无边	zuo'zhu'e'ye'wu'liang'wu'bian	0
