白帝在历史上是指答案公孙述	bai'di'zai'li'shi'shang'shi'zhi'da'an'gong'sun'shu	0
百二关河是指答案山河险固	bai'er'guan'he'shi'zhi'da'an'shan'he'xian'gu	0
白玉龙冠是多少级的帽子答案	bai'yu'long'guan'shi'duo'shao'ji'de'mao'zi'da'an	0
半耕半读猜一字答案讲	ban'geng'ban'du'cai'yi'zi'da'an'jiang	0
抱关击柝的含义是答案职位低下	bao'guan'ji'tuo'de'han'yi'shi'da'an'zhi'wei'di'xia	0
被称为荷月的月份是答案六月	bei'cheng'wei'he'yue'de'yue'fen'shi'da'an'liu'yue	0
扁鹊的本名是答案秦越人	bian'que'de'ben'ming'shi'da'an'qin'yue'ren	0
部位相反猜一字答案陪	bu'wei'xiang'fan'cai'yi'zi'da'an'pei	0
曹操的字是答案孟德	cao'cao'de'zi'shi'da'an'meng'de	0
程咬金被封为答案卢公	cheng'yao'jin'bei'feng'wei'da'an'lu'gong	0
春种一粒粟中的粟指答案谷子	chun'zhong'yi'li'su'zhong'de'su'zhi'da'an'gu'zi	0
大雁塔几层没有超级巫医答案	da'yan'ta'ji'ceng'mei'you'chao'ji'wu'yi'da'an	0
大夫在我国古代指答案官职	dai'fu'zai'wo'guo'gu'dai'zhi'da'an'guan'zhi	0
道德经全文大约答案五千字	dao'de'jing'quan'wen'da'yue'da'an'wu'qian'zi	0
道德经是谁写的答案太上老君	dao'de'jing'shi'shui'xie'de'da'an'tai'shang'lao'jun	0
导游猜一成语答案引人入胜	dao'you'cai'yi'cheng'yu'da'an'yin'ren'ru'sheng	0
地藏王是谁的弟子答案佛祖	di'zang'wang'shi'shui'de'di'zi'da'an'fo'zu	0
顶破天打一字答案夫	ding'po'tian'da'yi'zi'da'an'fu	0
东海龙王叫什么名字答案敖广	dong'hai'long'wang'jiao'shen'me'ming'zi'da'an'ao'guang	0
观音姐姐的家在哪答案潮音洞	guan'yin'jie'jie'de'jia'zai'na'da'an'chao'yin'dong	0
汉光武帝叫什么答案刘秀	han'guang'wu'di'jiao'shen'me'da'an'liu'xiu	0
汉武帝叫什么答案刘彻	han'wu'di'jiao'shen'me'da'an'liu'che	0
汉字卅表示答案三十	han'zi'sa'biao'shi'da'an'san'shi	0
虎骨酒的原料主要是答案虎骨	hu'gu'jiu'de'yuan'liao'zhu'yao'shi'da'an'hu'gu	0
火猜一成语答案灭顶之灾	huo'cai'yi'cheng'yu'da'an'mie'ding'zhi'zai	0
急猜一成语答案争先恐后	ji'cai'yi'cheng'yu'da'an'zheng'xian'kong'hou	0
己所不欲下一句是答案勿施于人	ji'suo'bu'yu'xia'yi'ju'shi'da'an'wu'shi'yu'ren	0
举重比赛猜一成语答案斤斤计较	ju'zhong'bi'sai'cai'yi'cheng'yu'da'an'jin'jin'ji'jiao	0
李靖的表字是答案药师	li'jing'de'biao'zi'shi'da'an'yao'shi	0
李渊是从那里起兵的答案太原	li'yuan'shi'cong'na'li'qi'bing'de'da'an'tai'yuan	0
龙井茶的产地是答案杭州	long'jing'cha'de'chan'di'shi'da'an'hang'zhou	0
马革裹尸的典故出于答案马援	ma'ge'guo'shi'de'dian'gu'chu'yu'da'an'ma'yuan	0
盲人摸象猜一成语答案不识大体	mang'ren'mo'xiang'cai'yi'cheng'yu'da'an'bu'shi'da'ti	0
灭掉唐朝的人是答案朱温	mie'diao'tang'chao'de'ren'shi'da'an'zhu'wen	0
木神句芒是谁的后裔答案少昊	mu'shen'gou'mang'shi'shui'de'hou'yi'da'an'shao'hao	0
男子的弱冠之年是指答案二十岁	nan'zi'de'ruo'guan'zhi'nian'shi'zhi'da'an'er'shi'sui	0
酿酒业传说的祖师爷是答案杜康	niang'jiu'ye'chuan'shuo'de'zu'shi'ye'shi'da'an'du'kang	0
女儿红是哪里的特产答案绍兴	nv'er'hong'shi'na'li'de'te'chan'da'an'shao'xing	0
蚍蜉撼树的含义是答案自不量力	pi'fu'han'shu'de'han'yi'shi'da'an'zi'bu'liang'li	0
三国时期割须弃袍的是答案曹操	san'guo'shi'qi'ge'xu'qi'pao'de'shi'da'an'cao'cao	0
三国演义中的凤雏是谁答案庞统	san'guo'yan'yi'zhong'de'feng'chu'shi'shui'da'an'pang'tong	0
山坡羊属于答案曲牌	shan'po'yang'shu'yu'da'an'qu'pai	0
社稷的原意是指答案土神和谷神	she'ji'de'yuan'yi'shi'zhi'da'an'tu'shen'he'gu'shen	0
十月十日猜一字答案朝	shi'yue'shi'ri'cai'yi'zi'da'an'chao	0
手无寸铁猜一字答案控	shou'wu'cun'tie'cai'yi'zi'da'an'kong	0
谁是孙悟空的师父答案菩提祖师	shui'shi'sun'wu'kong'de'shi'fu'da'an'pu'ti'zu'shi	0
司空见惯中的司空是指答案官职	si'kong'jian'guan'zhong'de'si'kong'shi'zhi'da'an'guan'zhi	0
丝竹是指答案琴与箫	si'zhu'shi'zhi'da'an'qin'yu'xiao	0
宋词是一种答案诗	song'ci'shi'yi'zhong'da'an'shi	0
孙悟空的原形是答案通灵石猴	sun'wu'kong'de'yuan'xing'shi'da'an'tong'ling'shi'hou	0
唐朝诗人李白被尊为答案诗仙	tang'chao'shi'ren'li'bai'bei'zun'wei'da'an'shi'xian	0
唐三藏的真名叫什么答案陈玄奘	tang'san'zang'de'zhen'ming'jiao'shen'me'da'an'chen'xuan'zang	0
唐太宗的名讳是答案李世民	tang'tai'zong'de'ming'hui'shi'da'an'li'shi'min	0
唐太宗的年号是什么答案贞观	tang'tai'zong'de'nian'hao'shi'shen'me'da'an'zhen'guan	0
陶渊明号答案五柳先生	tao'yuan'ming'hao'da'an'wu'liu'xian'sheng	0
田猜一成语答案挖空心思	tian'cai'yi'cheng'yu'da'an'wa'kong'xin'si	0
晚来日沉星点稀字谜答案兔	wan'lai'ri'chen'xing'dian'xi'zi'mi'da'an'tu	0
我国农历有多少个节气答案	wo'guo'nong'li'you'duo'shao'ge'jie'qi'da'an	0
悟空使用的兵器是答案金箍棒	wu'kong'shi'yong'de'bing'qi'shi'da'an'jin'gu'bang	0
五粮液酒原产于哪个省答案四川	wu'liang'ye'jiu'yuan'chan'yu'na'ge'sheng'da'an'si'chuan	0
五岳中被称为北岳的是答案恒山	wu'yue'zhong'bei'cheng'wei'bei'yue'de'shi'da'an'heng'shan	0
亚猜一成语答案有口难言	ya'cai'yi'cheng'yu'da'an'you'kou'nan'yan	0
一口吃掉牛尾巴猜一字答案告	yi'kou'chi'diao'niu'wei'ba'cai'yi'zi'da'an'gao	0
以下武器不属于鞭的是答案冷月	yi'xia'wu'qi'bu'shu'yu'bian'de'shi'da'an'leng'yue	0
以下武器不属于枪的是答案肃魂	yi'xia'wu'qi'bu'shu'yu'qiang'de'shi'da'an'su'hun	0
云南名茶普洱茶属于答案黑茶	yun'nan'ming'cha'pu'er'cha'shu'yu'da'an'hei'cha	0
指南车的发明者是答案黄帝	zhi'nan'che'de'fa'ming'zhe'shi'da'an'huang'di	0
中国面积最大的省份是答案新疆	zhong'guo'mian'ji'zui'da'de'sheng'fen'shi'da'an'xin'jiang	0
中国最大的湖泊是答案青海湖	zhong'guo'zui'da'de'hu'po'shi'da'an'qing'hai'hu	0
钟馗是怎么死的答案自己撞死	zhong'kui'shi'zen'me'si'de'da'an'zi'ji'zhuang'si	0
中药里的雄黄属于答案矿物	zhong'yao'li'de'xiong'huang'shu'yu'da'an'kuang'wu	0
