阿里山龙胆	a'li'shan'long'dan	0
阿修罗城	a'xiu'luo'cheng	0
矮牵牛	ai'qian'niu	0
矮樱	ai'ying	0
爱之蔓	ai'zhi'man	0
暗紫脆蒴报春	an'zi'cui'shuo'bao'chun	0
安祖花	an'zu'hua	0
八宝	ba'bao	0
巴豆	ba'dou	0
八角茴香	ba'jiao'hui'xiang	0
八角金盘	ba'jiao'jin'pan	0
霸王鞭	ba'wang'bian	0
白佛甲	bai'fo'jia	0
百合	bai'he	0
白鹤芋	bai'he'yu	0
白花藿香蓟	bai'hua'huo'xiang'ji	0
白花蛇舌草	bai'hua'she'she'cao	0
白芨	bai'ji	0
败酱草	bai'jiang'cao	0
白肋虎尾兰	bai'lei'hu'wei'lan	0
白马城	bai'ma'cheng	0
白蚂蚁花	bai'ma'yi'hua	0
百脉根	bai'mai'gen	0
白毛杜鹃	bai'mao'du'juan	0
百慕达蓝眼草	bai'mu'da'lan'yan'cao	0
白菩提	bai'pu'ti	0
白屈菜	bai'qu'cai	0
百日草	bai'ri'cao	0
白檀	bai'tan	0
白头翁	bai'tou'weng	0
白网纹草	bai'wang'wen'cao	0
白纹竹芋	bai'wen'zhu'yu	0
白心秋花报春	bai'xin'qiu'hua'bao'chun	0
白雪姬	bai'xue'ji	0
白英	bai'ying	0
白玉兰	bai'yu'lan	0
百子莲	bai'zi'lian	0
半边莲	ban'bian'lian	0
斑唇马先蒿	ban'chun'ma'xian'hao	0
斑点虎耳草	ban'dian'hu'er'cao	0
斑点橐吾	ban'dian'tuo'wu	0
板栗	ban'li	0
斑马萝摩	ban'ma'luo'mo	0
斑叶唇柱苣苔	ban'ye'chun'zhu'ju'tai	0
斑叶凤梨	ban'ye'feng'li	0
斑叶马醉木	ban'ye'ma'zui'mu	0
半支莲	ban'zhi'lian	0
棒棰树	bang'chui'shu	0
棒叶虎尾兰	bang'ye'hu'wei'lan	0
棒叶花	bang'ye'hua	0
棒叶落地生根	bang'ye'luo'di'sheng'gen	0
报春花	bao'chun'hua	0
宝莲花	bao'lian'hua	0
宝绿	bao'lv	0
苞叶雪莲	bao'ye'xue'lian	0
北细辛	bei'xi'xin	0
碧桃	bi'tao	0
笔筒草	bi'tong'cao	0
扁豆	bian'dou	0
扁蓄	bian'xu	0
变叶木	bian'ye'mu	0
滨旋花	bin'xuan'hua	0
薄荷	bo'he	0
菠萝	bo'luo	0
般若	bo're	0
波斯菊	bo'si'ju	0
补骨脂	bu'gu'zhi	0
布纹球	bu'wen'qiu	0
彩苞凤梨	cai'bao'feng'li	0
彩虹竹芋	cai'hong'zhu'yu	0
彩色马蹄莲	cai'se'ma'ti'lian	0
彩叶草	cai'ye'cao	0
彩云球	cai'yun'qiu	0
藏波罗花	cang'bo'luo'hua	0
苍耳子	cang'er'zi	0
苍山虎耳草	cang'shan'hu'er'cao	0
藏玄参	cang'xuan'shen	0
草甸马先蒿	cao'dian'ma'xian'hao	0
草莓果	cao'mei'guo	0
草玉梅	cao'yu'mei	0
侧花钓钟柳	ce'hua'diao'zhong'liu	0
长瓣瑞香	chang'ban'rui'xiang	0
长鞭红景天	chang'bian'hong'jing'tian	0
长柄岩黄芪	chang'bing'yan'huang'qi	0
长春花	chang'chun'hua	0
昌都点地梅	chang'du'dian'di'mei	0
长梗蓼	chang'geng'liao	0
长裂乌头	chang'lie'wu'tou	0
常青藤	chang'qing'teng	0
长蕊万寿竹	chang'rui'wan'shou'zhu	0
长寿花	chang'shou'hua	0
长筒石蒜	chang'tong'shi'suan	0
长尾婆婆纳	chang'wei'po'po'na	0
长行天南星	chang'xing'tian'nan'xing	0
巢蕨	chao'jue	0
车前草	che'qian'cao	0
沉香	chen'xiang	0
秤锤树	cheng'chui'shu	0
橙黄棒叶花	cheng'huang'bang'ye'hua	0
齿时忍冬	chi'shi'ren'dong	0
齿叶忍冬	chi'ye'ren'dong	0
臭草	chou'cao	0
臭党参	chou'dang'shen	0
丑角花	chou'jue'hua	0
臭牡丹	chou'mu'dan	0
雏菊	chu'ju	0
楮实子	chu'shi'zi	0
川滇杓兰	chuan'dian'biao'lan	0
川滇蔷薇	chuan'dian'qiang'wei	0
川楝子	chuan'lian'zi	0
穿心莲	chuan'xin'lian	0
穿心莛子藨	chuan'xin'ting'zi'biao	0
川藏沙参	chuan'zang'sha'shen	0
垂红忍冬	chui'hong'ren'dong	0
垂盆草	chui'pen'cao	0
吹上	chui'shang	0
垂悬大戟	chui'xuan'da'ji	0
春峰锦	chun'feng'jin	0
刺蓬花	ci'peng'hua	0
粗毛肉果草	cu'mao'rou'guo'cao	0
粗毛薯藤	cu'mao'shu'teng	0
翠菊	cui'ju	0
翠雀	cui'que	0
翠云草	cui'yun'cao	0
大百合	da'bai'he	0
大草寇	da'cao'kou	0
大缠	da'chan	0
大萼蓝钟花	da'e'lan'zhong'hua	0
大和锦	da'he'jin	0
大花葱	da'hua'cong	0
大花芙蓉葵	da'hua'fu'rong'kui	0
大花黄牡丹	da'hua'huang'mu'dan	0
大花蕙兰	da'hua'hui'lan	0
大花剪秋罗	da'hua'jian'qiu'luo	0
大花老鹤草	da'hua'lao'he'cao	0
大花肋柱花	da'hua'lei'zhu'hua	0
大花蔓龙胆	da'hua'man'long'dan	0
大花曼陀罗	da'hua'man'tuo'luo	0
大花犀角	da'hua'xi'jiao	0
大花延龄草	da'hua'yan'ling'cao	0
打火草	da'huo'cao	0
大戟阁锦	da'ji'ge'jin	0
大理花	da'li'hua	0
大丽菊	da'li'ju	0
大瘤瓣兰	da'liu'ban'lan	0
大轮柱	da'lun'zhu	0
打破碗花花	da'po'wan'hua'hua	0
大王黛粉叶	da'wang'dai'fen'ye	0
大象牙参	da'xiang'ya'can	0
大岩桐	da'yan'tong	0
大叶黄杨	da'ye'huang'yang	0
大叶碎米荞	da'ye'sui'mi'qiao	0
大枣	da'zao	0
代代花枳	dai'dai'hua'zhi	0
带叶兜兰	dai'ye'dou'lan	0
淡竹叶	dan'zhu'ye	0
倒挂金钟	dao'gua'jin'zhong	0
灯笼花	deng'long'hua	0
地肤子	di'fu'zi	0
帝冠	di'guan	0
地椒	di'jiao	0
地锦草	di'jin'cao	0
地念	di'nian	0
滴水观音	di'shui'guan'yin	0
地涌金莲	di'yong'jin'lian	0
垫状点地梅	dian'zhuang'dian'di'mei	0
吊兰	diao'lan	0
丁香	ding'xiang	0
东方罂粟	dong'fang'ying'su	0
冬瓜皮	dong'gua'pi	0
东陵八仙花	dong'ling'ba'xian'hua	0
豆瓣绿	dou'ban'lv	0
杜鹃	du'juan	0
独蒜兰	du'suan'lan	0
独一味	du'yi'wei	0
短梗重楼	duan'geng'chong'lou	0
短叶虎尾兰	duan'ye'hu'wei'lan	0
多刺绿融蒿	duo'ci'lv'rong'hao	0
多花报春	duo'hua'bao'chun	0
多花孔雀葵	duo'hua'kong'que'kui	0
多花亚菊	duo'hua'ya'ju	0
多蕊金丝桃	duo'rui'jin'si'tao	0
鹅毛玉凤兰	e'mao'yu'feng'lan	0
峨嵋蔷薇	e'mei'qiang'wei	0
鹅掌柴	e'zhang'chai	0
鹅掌揪	e'zhang'jiu	0
二叶独蒜兰	er'ye'du'suan'lan	0
发财树	fa'cai'shu	0
翻白草	fan'bai'cao	0
番红花	fan'hong'hua	0
反曲景天	fan'qu'jing'tian	0
繁星花	fan'xing'hua	0
方茎青紫葛	fang'jing'qing'zi'ge	0
费菜	fei'cai	0
翡翠景天	fei'cui'jing'tian	0
翡翠珠	fei'cui'zhu	0
绯牡丹	fei'mu'dan	0
非洲霸王树	fei'zhou'ba'wang'shu	0
非洲霸王树缀化	fei'zhou'ba'wang'shu'zhui'hua	0
非洲凤仙花	fei'zhou'feng'xian'hua	0
非洲紫罗兰	fei'zhou'zi'luo'lan	0
粉背野丁香	fen'bei'ye'ding'xiang	0
粉藤	fen'teng	0
风车	feng'che	0
风车草	feng'che'cao	0
凤尾兰	feng'wei'lan	0
佛肚树	fo'du'shu	0
佛甲草	fo'jia'cao	0
辐冠党参	fu'guan'dang'shen	0
扶郎花	fu'lang'hua	0
覆盆子	fu'pen'zi	0
馥郁滇丁香	fu'yu'dian'ding'xiang	0
柑橘	gan'ju	0
甘肃棘豆	gan'su'ji'dou	0
甘肃荚迷	gan'su'jia'mi	0
甘遂	gan'sui	0
甘西鼠尾草	gan'xi'shu'wei'cao	0
杠板归	gang'ban'gui	0
高山白珠树	gao'shan'bai'zhu'shu	0
高文鹰爪	gao'wen'ying'zhao	0
宫灯长寿花	gong'deng'chang'shou'hua	0
珙桐	gong'tong	0
拱形绣线菊	gong'xing'xiu'xian'ju	0
构骨	gou'gu	0
枸桔	gou'ju	0
狗尾红	gou'wei'hong	0
古代稀	gu'dai'xi	0
姑婆芋	gu'po'yu	0
孤挺花	gu'ting'hua	0
瓜栗	gua'li	0
瓜叶菊	gua'ye'ju	0
瓜子金	gua'zi'jin	0
观赏椒	guan'shang'jiao	0
贯叶忍冬	guan'ye'ren'dong	0
观音竹	guan'yin'zhu	0
广东万年青	guang'dong'wan'nian'qing	0
光棍树	guang'gun'shu	0
光核桃	guang'he'tao	0
广藿香	guang'huo'xiang	0
广玉兰	guang'yu'lan	0
龟背竹	gui'bei'zhu	0
桂花	gui'hua	0
龟甲龙	gui'jia'long	0
鬼箭锦鸡儿	gui'jian'jin'ji'er	0
鬼角子	gui'jiao'zi	0
贵青玉	gui'qing'yu	0
龟纹木棉	gui'wen'mu'mian	0
桂竹香	gui'zhu'xiang	0
过手香	guo'shou'xiang	0
哈密瓜	ha'mi'gua	0
海角樱草	hai'jiao'ying'cao	0
海棠花	hai'tang'hua	0
海桐	hai'tong	0
海芋	hai'yu	0
海州常山	hai'zhou'chang'shan	0
旱菜	han'cai	0
韩国草	han'guo'cao	0
旱金莲	han'jin'lian	0
含笑	han'xiao	0
含羞草	han'xiu'cao	0
褐斑伽蓝	he'ban'qie'lan	0
荷包牡丹	he'bao'mu'dan	0
何布景天	he'bu'jing'tian	0
合果芋	he'guo'yu	0
荷花	he'hua	0
荷花木兰	he'hua'mu'lan	0
合欢	he'huan	0
鹤虱	he'shi	0
何氏凤仙	he'shi'feng'xian	0
核桃	he'tao	0
禾叶竹叶兰	he'ye'zhu'ye'lan	0
诃子	he'zi	0
黑法师	hei'fa'shi	0
黑蕊老鹳草	hei'rui'lao'guan'cao	0
黑眼菊	hei'yan'ju	0
红豆蔻	hong'dou'kou	0
红果仔	hong'guo'zai	0
红花	hong'hua	0
红花葱兰	hong'hua'cong'lan	0
红花山牵牛	hong'hua'shan'qian'niu	0
红花石蒜	hong'hua'shi'suan	0
红花酢浆草	hong'hua'zuo'jiang'cao	0
红姜花	hong'jiang'hua	0
红蕉	hong'jiao	0
红龙骨	hong'long'gu	0
红怒涛	hong'nu'tao	0
红千层	hong'qian'ceng	0
红雀珊瑚	hong'que'shan'hu	0
红桑	hong'sang	0
红丝姜花	hong'si'jiang'hua	0
红叶之秋	hong'ye'zhi'qiu	0
红紫桂竹香	hong'zi'gui'zhu'xiang	0
喉斑杜鹃	hou'ban'du'juan	0
厚叶雀舌兰	hou'ye'que'she'lan	0
虎刺梅	hu'ci'mei	0
忽地笑	hu'di'xiao	0
蝴蝶花	hu'die'hua	0
蝴蝶兰	hu'die'lan	0
蝴蝶石斛	hu'die'shi'hu	0
蝴蝶戏珠花	hu'die'xi'zhu'hua	0
虎耳草	hu'er'cao	0
虎耳兰	hu'er'lan	0
虎尾兰	hu'wei'lan	0
虎眼万年青	hu'yan'wan'nian'qing	0
互叶铁线莲	hu'ye'tie'xian'lian	0
化橘红	hua'ju'hong	0
华丽景天	hua'li'jing'tian	0
华丽龙胆	hua'li'long'dan	0
花叶爱之蔓	hua'ye'ai'zhi'man	0
花月夜	hua'yue'ye	0
华中五味子	hua'zhong'wu'wei'zi	0
槐米	huai'mi	0
幻蝶蔓	huan'die'man	0
换锦花	huan'jin'hua	0
黄杯杜鹃	huang'bei'du'juan	0
黄蝉	huang'chan	0
黄蝉兰	huang'chan'lan	0
黄菖蒲	huang'chang'pu	0
黄刺玫	huang'ci'mei	0
黄花凤仙花	huang'hua'feng'xian'hua	0
黄花鹤顶兰	huang'hua'he'ding'lan	0
黄花胡麻	huang'hua'hu'ma	0
黄花酢酱草	huang'hua'zuo'jiang'cao	0
黄荆子	huang'jing'zi	0
黄韭兰	huang'jiu'lan	0
黄连木	huang'lian'mu	0
黄毛掌	huang'mao'zhang	0
黄秋葵	huang'qiu'kui	0
黄山紫荆	huang'shan'zi'jing	0
黄蜀葵	huang'shu'kui	0
黄雪光	huang'xue'guang	0
喙毛马先蒿	hui'mao'ma'xian'hao	0
火把花	huo'ba'hua	0
火红杜鹃	huo'hong'du'juan	0
火棘	huo'ji	0
火祭	huo'ji	0
火剑凤梨	huo'jian'feng'li	0
火炬花	huo'ju'hua	0
火麻仁	huo'ma'ren	0
藿香	huo'xiang	0
藿香叶绿绒蒿	huo'xiang'ye'lv'rong'hao	0
火星花	huo'xing'hua	0
火秧勒	huo'yang'le	0
荠菜	ji'cai	0
鸡蛋花	ji'dan'hua	0
姬凤梨	ji'feng'li	0
鸡冠花	ji'guan'hua	0
蓟花山龙眼	ji'hua'shan'long'yan	0
疾藜	ji'li	0
鸡矢藤	ji'shi'teng	0
姬星美人	ji'xing'mei'ren	0
嘉德利亚兰	jia'de'li'ya'lan	0
假茉莉	jia'mo'li	0
架棚假俭草	jia'peng'jia'jian'cao	0
假昙花	jia'tan'hua	0
假吐金菊	jia'tu'jin'ju	0
夹竹桃	jia'zhu'tao	0
建兰	jian'lan	0
剑麻	jian'ma	0
尖子木	jian'zi'mu	0
姜花	jiang'hua	0
将军	jiang'jun	0
将军阁	jiang'jun'ge	0
降香	jiang'xiang	0
绞股蓝	jiao'gu'lan	0
接骨木	jie'gu'mu	0
睫穗蓼	jie'sui'liao	0
结香花	jie'xiang'hua	0
金边短叶虎尾兰	jin'bian'duan'ye'hu'wei'lan	0
金边凤梨	jin'bian'feng'li	0
金边富贵竹	jin'bian'fu'gui'zhu	0
金边虎尾兰	jin'bian'hu'wei'lan	0
金边龙舌兰	jin'bian'long'she'lan	0
金边千手兰	jin'bian'qian'shou'lan	0
金边石菖蒲	jin'bian'shi'chang'pu	0
锦带花	jin'dai'hua	0
锦灯笼	jin'deng'long	0
金凤花	jin'feng'hua	0
筋骨草	jin'gu'cao	0
金红花	jin'hong'hua	0
金琥	jin'hu	0
金花茶	jin'hua'cha	0
金黄脆蒴报春	jin'huang'cui'shuo'bao'chun	0
金鸡菊	jin'ji'ju	0
金莲花	jin'lian'hua	0
金露花	jin'lu'hua	0
金脉单药花	jin'mai'dan'yao'hua	0
金脉爵床	jin'mai'jue'chuang	0
金脉鸢尾	jin'mai'yuan'wei	0
金钱草	jin'qian'cao	0
金心胡颓子	jin'xin'hu'tui'zi	0
金心香龙血树	jin'xin'xiang'long'xue'shu	0
金银花	jin'yin'hua	0
金樱子	jin'ying'zi	0
金玉菊	jin'yu'ju	0
金盏菊	jin'zhan'ju	0
荆芥	jing'jie	0
镜面草	jing'mian'cao	0
景天	jing'tian	0
景天三七	jing'tian'san'qi	0
九里香	jiu'li'xiang	0
九轮塔	jiu'lun'ta	0
酒瓶兰	jiu'ping'lan	0
菊花	ju'hua	0
菊花桃	ju'hua'tao	0
巨伞钟报春	ju'san'zhong'bao'chun	0
菊水	ju'shui	0
菊叶穗花报春	ju'ye'sui'hua'bao'chun	0
苣叶秃疮花	ju'ye'tu'chuang'hua	0
巨紫荆	ju'zi'jing	0
卷鞘鸢尾	juan'qiao'yuan'wei	0
卷叶黄精	juan'ye'huang'jing	0
蕨麻委陵菜	jue'ma'wei'ling'cai	0
君子兰	jun'zi'lan	0
卡特兰	ka'te'lan	0
康乃馨	kang'nai'xin	0
孔雀草	kong'que'cao	0
孔雀木	kong'que'mu	0
空心莲子草	kong'xin'lian'zi'cao	0
口红花	kou'hong'hua	0
苦木	ku'mu	0
快刀乱麻	kuai'dao'luan'ma	0
宽裂掌叶报春	kuan'lie'zhang'ye'bao'chun	0
宽叶吊兰	kuan'ye'diao'lan	0
宽叶落地生根	kuan'ye'luo'di'sheng'gen	0
宽叶仙女木	kuan'ye'xian'nv'mu	0
宽柱鸢尾	kuan'zhu'yuan'wei	0
盔檐南星	kui'yan'nan'xing	0
阔瓣嘉兰	kuo'ban'jia'lan	0
阔叶大十功劳	kuo'ye'da'shi'gong'lao	0
喇叭水仙	la'ba'shui'xian	0
蜡瓣花	la'ban'hua	0
拉康龙胆	la'kang'long'dan	0
腊梅	la'mei	0
辣木	la'mu	0
拉萨小檗	la'sa'xiao'bo	0
蓝刺头	lan'ci'tou	0
兰花	lan'hua	0
蓝玉簪龙胆	lan'yu'zan'long'dan	0
老虎须	lao'hu'xu	0
荔枝草	li'zhi'cao	0
莲花草	lian'hua'cao	0
连钱草	lian'qian'cao	0
连翘	lian'qiao	0
量天尺	liang'tian'chi	0
列当	lie'dang	0
裂毛雪山杜鹃	lie'mao'xue'shan'du'juan	0
裂膜蔓龙胆	lie'mo'man'long'dan	0
鳞秕泽米铁	lin'bi'ze'mi'tie	0
鳞腺杜鹃	lin'xian'du'juan	0
林芝报春花	lin'zhi'bao'chun'hua	0
林芝杜鹃	lin'zhi'du'juan	0
令箭茶花	ling'jian'cha'hua	0
令箭荷花	ling'jian'he'hua	0
铃兰	ling'lan	0
凌霄	ling'xiao	0
六出花	liu'chu'hua	0
柳兰	liu'lan	0
留兰香	liu'lan'xiang	0
柳条杜鹃	liu'tiao'du'juan	0
龙柏	long'bai	0
龙船花	long'chuan'hua	0
龙凤牡丹	long'feng'mu'dan	0
龙骨	long'gu	0
龙葵	long'kui	0
龙女花	long'nv'hua	0
龙舌兰	long'she'lan	0
龙吐珠	long'tu'zhu	0
龙眼	long'yan	0
耧斗菜	lou'dou'cai	0
芦荟	lu'hui	0
鹿角海棠	lu'jiao'hai'tang	0
鹿角蕨	lu'jiao'jue	0
路路通	lu'lu'tong	0
陆英	lu'ying	0
卵萼红景天	luan'e'hong'jing'tian	0
卵萼花锚	luan'e'hua'mao	0
萝卜秦艽	luo'bo'qin'jiao	0
罗汉果	luo'han'guo	0
罗汉松	luo'han'song	0
落葵	luo'kui	0
马鞭草	ma'bian'cao	0
马齿苋树	ma'chi'xian'shu	0
马兜铃	ma'dou'ling	0
麻黄	ma'huang	0
马拉巴栗	ma'la'ba'li	0
马蹄莲	ma'ti'lian	0
蟆叶秋海棠	ma'ye'qiu'hai'tang	0
麻叶绣球	ma'ye'xiu'qiu	0
蔓荆子	man'jing'zi	0
毛汉十二卷	mao'han'shi'er'juan	0
毛花忍冬	mao'hua'ren'dong	0
毛盔马先蒿	mao'kui'ma'xian'hao	0
茅莓	mao'mei	0
毛麝香	mao'she'xiang	0
毛叶莲花掌	mao'ye'lian'hua'zhang	0
毛叶山梅花	mao'ye'shan'mei'hua	0
梅花	mei'hua	0
美丽棱子芹	mei'li'leng'zi'qin	0
美女樱	mei'nv'ying	0
美人蕉	mei'ren'jiao	0
梅子	mei'zi	0
密蒙花	mi'meng'hua	0
绵刺头菊	mian'ci'tou'ju	0
绵头蓟	mian'tou'ji	0
冥楂	ming'zha	0
墨旱莲	mo'han'lian	0
茉莉	mo'li	0
墨脱玉叶金花	mo'tuo'yu'ye'jin'hua	0
木兰杜鹃	mu'lan'du'juan	0
穆坪紫堇	mu'ping'zi'jin	0
纳里花	na'li'hua	0
南美水仙	nan'mei'shui'xian	0
南天竹	nan'tian'zhu	0
南洋杉	nan'yang'sha	0
闹羊花	nao'yang'hua	0
尼泊尔香青	ni'bo'er'xiang'qing	0
泥鳅掌	ni'qiu'zhang	0
鸟羽玉	niao'yu'yu	0
聂拉木独活	nie'la'mu'du'huo	0
牛蒡子	niu'bang'zi	0
牛顿草	niu'dun'cao	0
浓香探春	nong'xiang'tan'chun	0
糯米条	nuo'mi'tiao	0
女贞子	nv'zhen'zi	0
欧洲卫矛	ou'zhou'wei'mao	0
欧洲银莲花	ou'zhou'yin'lian'hua	0
爬山虎	pa'shan'hu	0
螃蟹甲	pang'xie'jia	0
泡桐花	pao'tong'hua	0
炮仗花	pao'zhang'hua	0
佩兰	pei'lan	0
喷火龙	pen'huo'long	0
蓬莱珍	peng'lai'zhen	0
蟛蜞菊	peng'qi'ju	0
皮尔逊金铃	pi'er'xun'jin'ling	0
啤酒花	pi'jiu'hua	0
枇杷苹果	pi'pa'ping'guo	0
瓶耳小草	ping'er'xiao'cao	0
平枝栒子	ping'zhi'xun'zi	0
蒲包花	pu'bao'hua	0
铺地小叶金露梅	pu'di'xiao'ye'jin'lu'mei	0
蒲公英	pu'gong'ying	0
蒲黄	pu'huang	0
葡萄	pu'tao	0
葡萄风信子	pu'tao'feng'xin'zi	0
菩提花	pu'ti'hua	0
菩提树	pu'ti'shu	0
麒麟花	qi'lin'hua	0
气球花	qi'qiu'hua	0
七叶莲	qi'ye'lian	0
七叶树	qi'ye'shu	0
七页一枝花	qi'ye'yi'zhi'hua	0
千里光	qian'li'guang	0
荨麻叶凤仙花	qian'ma'ye'feng'xian'hua	0
千屈菜	qian'qu'cai	0
千日红	qian'ri'hong	0
蔷薇	qiang'wei	0
俏黄芦	qiao'huang'lu	0
琴叶喜林芋	qin'ye'xi'lin'yu	0
青果	qing'guo	0
青蒿	qing'hao	0
青麻	qing'ma	0
青珊瑚	qing'shan'hu	0
青锁龙	qing'suo'long	0
琼花	qiong'hua	0
球根秋海棠	qiu'gen'qiu'hai'tang	0
秋海棠	qiu'hai'tang	0
球花马蓝	qiu'hua'ma'lan	0
秋葵	qiu'kui	0
秋水仙	qiu'shui'xian	0
秋叶菊	qiu'ye'ju	0
瞿麦	qu'mai	0
趣情莲	qu'qing'lian	0
曲序南星	qu'xu'nan'xing	0
全缘叶绿绒蒿	quan'yuan'ye'lv'rong'hao	0
雀舌黄杨	que'she'huang'yang	0
缺叶钟报春	que'ye'zhong'bao'chun	0
日本毛玉兰	ri'ben'mao'yu'lan	0
绒毛掌	rong'mao'zhang	0
榕树	rong'shu	0
绒叶喜林芋	rong'ye'xi'lin'yu	0
肉穗野牡丹	rou'sui'ye'mu'dan	0
乳茄	ru'qie	0
乳突紫背杜鹃	ru'tu'zi'bei'du'juan	0
瑞香	rui'xiang	0
瑞云	rui'yun	0
三白草	san'bai'cao	0
三花杜鹃	san'hua'du'juan	0
三尖栝楼	san'jian'gua'lou	0
三角花	san'jiao'hua	0
三棱虾脊兰	san'leng'xia'ji'lan	0
散鳞杜鹃	san'lin'du'juan	0
三色堇	san'se'jin	0
三色龙血树	san'se'long'xue'shu	0
散穗黄堇	san'sui'huang'jin	0
散尾葵	san'wei'kui	0
三叶鬼针草	san'ye'gui'zhen'cao	0
三褶虾脊兰	san'zhe'xia'ji'lan	0
桑树	sang'shu	0
缫丝花	sao'si'hua	0
森氏杜鹃	sen'shi'du'juan	0
沙棘	sha'ji	0
沙漠玫瑰	sha'mo'mei'gui	0
山茶花	shan'cha'hua	0
山地豆	shan'di'dou	0
山芙蓉	shan'fu'rong	0
珊瑚刺桐	shan'hu'ci'tong	0
珊瑚花	shan'hu'hua	0
珊瑚树	shan'hu'shu	0
珊瑚藤	shan'hu'teng	0
山居雪林芝	shan'ju'xue'lin'zhi	0
山梅花	shan'mei'hua	0
扇叶蒲葵	shan'ye'pu'kui	0
扇叶铁线蕨	shan'ye'tie'xian'jue	0
山银花	shan'yin'hua	0
山影拳	shan'ying'quan	0
山育杜鹃	shan'yu'du'juan	0
山玉兰	shan'yu'lan	0
山楂	shan'zha	0
山茱萸	shan'zhu'yu	0
少对峨嵋蔷薇	shao'dui'e'mei'qiang'wei	0
芍药	shao'yao	0
蛇鞭菊	she'bian'ju	0
蛇床子	she'chuang'zi	0
蛇莓	she'mei	0
生石花	sheng'shi'hua	0
柿蒂	shi'di	0
石峰杜鹃	shi'feng'du'juan	0
石碱草	shi'jian'cao	0
石榴	shi'liu	0
柿子	shi'zi	0
绶草	shou'cao	0
束花石斛	shu'hua'shi'hu	0
蜀秔子梢	shu'jing'zi'shao	0
蜀葵	shu'kui	0
鼠曲草	shu'qu'cao	0
鼠麴舅	shu'qu'jiu	0
鼠尾掌	shu'wei'zhang	0
双穗雀	shuang'sui'que	0
水飞蓟	shui'fei'ji	0
水鬼蕉	shui'gui'jiao	0
水红花子	shui'hong'hua'zi	0
水晶兰	shui'jing'lan	0
睡莲	shui'lian	0
水塔花	shui'ta'hua	0
水仙	shui'xian	0
水杨梅	shui'yang'mei	0
硕花马先蒿	shuo'hua'ma'xian'hao	0
四季海棠	si'ji'hai'tang	0
松花粉	song'hua'fen	0
松毛翠	song'mao'cui	0
松鼠尾	song'shu'wei	0
松霞	song'xia	0
松竹草	song'zhu'cao	0
宿根福禄考	su'gen'fu'lu'kao	0
苏木	su'mu	0
苏铁	su'tie	0
台湾百合	tai'wan'bai'he	0
台湾菜	tai'wan'cai	0
台湾及己	tai'wan'ji'ji	0
台湾藜芦	tai'wan'li'lu	0
台湾水鸭脚	tai'wan'shui'ya'jiao	0
台湾天南星	tai'wan'tian'nan'xing	0
台湾笑靥花	tai'wan'xiao'ye'hua	0
台湾一叶兰	tai'wan'yi'ye'lan	0
昙花	tan'hua	0
檀香	tan'xiang	0
唐菖蒲	tang'chang'pu	0
糖芥	tang'jie	0
桃儿七	tao'er'qi	0
桃花	tao'hua	0
桃金娘	tao'jin'niang	0
桃叶珊瑚	tao'ye'shan'hu	0
桃子	tao'zi	0
天胡荽	tian'hu'sui	0
天蓝龙胆	tian'lan'long'dan	0
天门冬	tian'men'dong	0
铁苋菜	tie'xian'cai	0
铁线草	tie'xian'cao	0
铁线莲	tie'xian'lian	0
头状四照花	tou'zhuang'si'zhao'hua	0
土丁桂	tu'ding'gui	0
兔儿菜	tu'er'cai	0
团叶越桔	tuan'ye'yue'ju	0
团羽铁线蕨	tuan'yu'tie'xian'jue	0
瓦松	wa'song	0
文殊兰	wen'shu'lan	0
五彩红星	wu'cai'hong'xing	0
乌臼	wu'jiu	0
乌蔹莓	wu'lian'mei	0
乌毛蕨	wu'mao'jue	0
五色海棠五味子	wu'se'hai'tang'wu'wei'zi	0
五色梅	wu'se'mei	0
五色苋	wu'se'xian	0
勿忘草	wu'wang'cao	0
乌心石	wu'xin'shi	0
五爪金龙	wu'zhao'jin'long	0
五针松	wu'zhen'song	0
吴茱萸	wu'zhu'yu	0
西班牙鸢尾	xi'ban'ya'yuan'wei	0
西番莲	xi'fan'lian	0
西府海棠	xi'fu'hai'tang	0
西瓜	xi'gua	0
西瓜皮椒草	xi'gua'pi'jiao'cao	0
菥冥	xi'ming	0
西南吊兰	xi'nan'diao'lan	0
西南花楸	xi'nan'hua'qiu	0
喜普鞋兰	xi'pu'xie'lan	0
喜树果	xi'shu'guo	0
希莶草	xi'xian'cao	0
西藏粉报春	xi'zang'fen'bao'chun	0
西藏锦鸡儿	xi'zang'jin'ji'er	0
西藏龙胆	xi'zang'long'dan	0
西藏铁线莲	xi'zang'tie'xian'lian	0
西藏卫矛	xi'zang'wei'mao	0
狭萼风吹箫	xia'e'feng'chui'xiao	0
虾脊兰	xia'ji'lan	0
夏枯草	xia'ku'cao	0
夏水仙	xia'shui'xian	0
虾夷花	xia'yi'hua	0
仙丹花	xian'dan'hua	0
咸丰草	xian'feng'cao	0
腺果大叶蔷薇	xian'guo'da'ye'qiang'wei	0
仙鹤草	xian'he'cao	0
仙客来	xian'ke'lai	0
仙人笔	xian'ren'bi	0
仙人掌	xian'ren'zhang	0
仙人指	xian'ren'zhi	0
腺叶绢毛蔷薇	xian'ye'juan'mao'qiang'wei	0
腺叶酢浆草	xian'ye'zuo'jiang'cao	0
香豆蔻	xiang'dou'kou	0
香蕉	xiang'jiao	0
香龙血树	xiang'long'xue'shu	0
象南星	xiang'nan'xing	0
橡皮树	xiang'pi'shu	0
向日葵	xiang'ri'kui	0
相思树	xiang'si'shu	0
香雪球	xiang'xue'qiu	0
象牙红	xiang'ya'hong	0
香橼	xiang'yuan	0
小仓兰	xiao'cang'lan	0
小果子蔓	xiao'guo'zi'man	0
小花龙舌兰	xiao'hua'long'she'lan	0
小茴香	xiao'hui'xiang	0
小蓟	xiao'ji	0
小丽花	xiao'li'hua	0
小毛毡苔	xiao'mao'zhan'tai	0
小虾花	xiao'xia'hua	0
小叶红叶藤	xiao'ye'hong'ye'teng	0
小叶栒子	xiao'ye'xun'zi	0
楔叶绣线菊	xie'ye'xiu'xian'ju	0
蟹爪	xie'zhao	0
心叶冰花	xin'ye'bing'hua	0
心叶球兰	xin'ye'qiu'lan	0
辛夷	xin'yi	0
星状雪兔子	xing'zhuang'xue'tu'zi	0
绣球藤	xiu'qiu'teng	0
袖珍椰子	xiu'zhen'ye'zi	0
须弥紫菀	xu'mi'zi'wan	0
萱草	xuan'cao	0
旋覆花	xuan'fu'hua	0
旋花	xuan'hua	0
悬铃花	xuan'ling'hua	0
雪滴花	xue'di'hua	0
血红蕉	xue'hong'jiao	0
雪茄花	xue'jia'hua	0
雪莲花	xue'lian'hua	0
雪山翻白草	xue'shan'fan'bai'cao	0
血苋	xue'xian	0
熏衣草	xun'yi'cao	0
勋章花	xun'zhang'hua	0
鸦胆子	ya'dan'zi	0
鸭跖草	ya'zhi'cao	0
艳凤梨	yan'feng'li	0
艳红赫蕉	yan'hong'he'jiao	0
沿阶草	yan'jie'cao	0
雁来红	yan'lai'hong	0
岩生银莲花	yan'sheng'yin'lian'hua	0
芫荽	yan'sui	0
燕子掌	yan'zi'zhang	0
阳春砂	yang'chun'sha	0
洋金花	yang'jin'hua	0
杨梅	yang'mei	0
羊蹄甲	yang'ti'jia	0
咬人猫	yao'ren'mao	0
野颠茄	ye'dian'qie	0
夜合花	ye'he'hua	0
腋花扭柄花	ye'hua'niu'bing'hua	0
野菊花	ye'ju'hua	0
夜来香	ye'lai'xiang	0
野马追	ye'ma'zhui	0
野牡丹	ye'mu'dan	0
野山楂	ye'shan'zha	0
野塘蒿	ye'tang'hao	0
叶下珠	ye'xia'zhu	0
野苋	ye'xian	0
椰子	ye'zi	0
叶子花	ye'zi'hua	0
一串红	yi'chuan'hong	0
一点红	yi'dian'hong	0
益母草	yi'mu'cao	0
一品红	yi'pin'hong	0
一叶兰	yi'ye'lan	0
异叶千里光	yi'ye'qian'li'guang	0
益智	yi'zhi	0
一枝黄花	yi'zhi'huang'hua	0
茵陈	yin'chen	0
银芽柳	yin'ya'liu	0
淫羊藿	yin'yang'huo	0
茵芋	yin'yu	0
迎春花	ying'chun'hua	0
樱花	ying'hua	0
硬毛杜鹃	ying'mao'du'juan	0
樱桃	ying'tao	0
鱼腹草	yu'fu'cao	0
羽裂喜林芋	yu'lie'xi'lin'yu	0
玉龙山无心菜	yu'long'shan'wu'xin'cai	0
虞美人	yu'mei'ren	0
玉牛掌	yu'niu'zhang	0
玉山薄雪草	yu'shan'bo'xue'cao	0
羽扇豆	yu'shan'dou	0
玉山佛甲草	yu'shan'fo'jia'cao	0
玉山水苦贾	yu'shan'shui'ku'jia	0
玉叶金花	yu'ye'jin'hua	0
榆叶梅	yu'ye'mei	0
羽叶茑萝	yu'ye'niao'luo	0
玉簪	yu'zan	0
预知子	yu'zhi'zi	0
玉竹	yu'zhu	0
圆齿红景天	yuan'chi'hong'jing'tian	0
圆盾状忍冬	yuan'dun'zhuang'ren'dong	0
芫花	yuan'hua	0
缘毛紫菀	yuan'mao'zi'wan	0
鸢尾	yuan'wei	0
月宫殿	yue'gong'dian	0
月季	yue'ji	0
月橘	yue'ju	0
云锦杜鹃	yun'jin'du'juan	0
云南杓兰	yun'nan'biao'lan	0
云南勾儿茶	yun'nan'gou'er'cha	0
云实云杉	yun'shi'yun'shan	0
杂色钟报春	za'se'zhong'bao'chun	0
杂种落新妇	za'zhong'luo'xin'fu	0
藏南杜鹃	zang'nan'du'juan	0
藏南粉报春	zang'nan'fen'bao'chun	0
枣子	zao'zi	0
泽兰	ze'lan	0
泽漆	ze'qi	0
窄花凤仙花	zhai'hua'feng'xian'hua	0
展毛翠雀花	zhan'mao'cui'que'hua	0
长刺白龙	zhang'ci'bai'long	0
长花党参	zhang'hua'dang'shen	0
樟木	zhang'mu	0
长叶大戟	zhang'ye'da'ji	0
长叶兰	zhang'ye'lan	0
昭和草	zhao'he'cao	0
爪哇常山	zhao'wa'chang'shan	0
贞凤梨	zhen'feng'li	0
蜘蛛抱蛋	zhi'zhu'bao'dan	0
栀子	zhi'zi	0
栀子花	zhi'zi'hua	0
重瓣黄木香	zhong'ban'huang'mu'xiang	0
肿柄雪莲	zhong'bing'xue'lian	0
中国马先蒿	zhong'guo'ma'xian'hao	0
肿节风	zhong'jie'feng	0
朱顶红	zhu'ding'hong	0
诸葛菜	zhu'ge'cai	0
朱砂桔	zhu'sha'ju	0
竹叶椒	zhu'ye'jiao	0
朱缨花	zhu'ying'hua	0
紫背草	zi'bei'cao	0
紫背万年青	zi'bei'wan'nian'qing	0
紫参	zi'can	0
紫鹅绒	zi'e'rong	0
紫海葱	zi'hai'cong	0
紫花凤梨	zi'hua'feng'li	0
紫花藿香蓟	zi'hua'huo'xiang'ji	0
紫金牛	zi'jin'niu	0
紫荆花	zi'jing'hua	0
紫露草	zi'lu'cao	0
紫罗兰	zi'luo'lan	0
紫菀	zi'wan	0
紫薇	zi'wei	0
紫心草	zi'xin'cao	0
紫叶山酢浆草	zi'ye'shan'zuo'jiang'cao	0
紫玉兰	zi'yu'lan	0
紫玉盘杜鹃	zi'yu'pan'du'juan	0
棕榈	zong'lv	0
棕竹	zong'zhu	0
总状绿绒蒿	zong'zhuang'lv'rong'hao	0
醉蝶花	zui'die'hua	0
