哀当世兮莫知	ai'dang'shi'xi'mo'zhi	0
哀独苦死之无乐兮	ai'du'ku'si'zhi'wu'le'xi	0
哀高丘之赤岸兮	ai'gao'qiu'zhi'chi'an'xi	0
哀高丘之无女	ai'gao'qiu'zhi'wu'nv	0
哀故邦之逢殃	ai'gu'bang'zhi'feng'yang	0
哀故都之日远	ai'gu'du'zhi'ri'yuan	0
娭光眇视	ai'guang'miao'shi	0
哀见君而不再得	ai'jian'jun'er'bu'zai'de	0
哀江南	ai'jiang'nan	0
哀居者之诚贞	ai'ju'zhe'zhi'cheng'zhen	0
哀枯杨之冤雏	ai'ku'yang'zhi'yuan'chu	0
哀灵修之过到	ai'ling'xiu'zhi'guo'dao	0
哀民生之多艰	ai'min'sheng'zhi'duo'jian	0
哀命哀时命之不合兮	ai'ming'ai'shi'ming'zhi'bu'he'xi	0
哀南夷之莫吾知兮	ai'nan'yi'zhi'mo'wu'zhi'xi	0
哀平差兮迷谬愚	ai'ping'cha'xi'mi'miu'yu	0
哀仆夫之坎毒兮	ai'pu'fu'zhi'kan'du'xi	0
欸秋冬之绪风	ai'qiu'dong'zhi'xu'feng	0
哀人生之长勤	ai'ren'sheng'zhi'chang'qin	0
哀人事之不幸兮	ai'ren'shi'zhi'bu'xing'xi	0
哀时命哀时命之不及古人兮	ai'shi'ming'ai'shi'ming'zhi'bu'ji'gu'ren'xi	0
哀岁旻天兮清凉	ai'sui'min'tian'xi'qing'liang	0
哀所求兮不耦	ai'suo'qiu'xi'bu'ou	0
哀我兮寡独	ai'wo'xi'gua'du	0
哀吾生之无乐兮	ai'wu'sheng'zhi'wu'le'xi	0
哀吾兮介特	ai'wu'xi'jie'te	0
哀蟋蟀之宵征	ai'xi'shuai'zhi'xiao'zheng	0
哀兮忧	ai'xi'you	0
哀形体之离解兮	ai'xing'ti'zhi'li'jie'xi	0
哀郢皇天之不纯命兮	ai'ying'huang'tian'zhi'bu'chun'ming'xi	0
哀余生之不当兮	ai'yu'sheng'zhi'bu'dang'xi	0
哀余寿之弗将	ai'yu'shou'zhi'fu'jiang	0
哀哉兮淈淈	ai'zai'xi'gu'gu	0
哀朕时之不当	ai'zhen'shi'zhi'bu'dang	0
哀众芳之芜秽	ai'zhong'fang'zhi'wu'hui	0
哀州土之平乐兮	ai'zhou'tu'zhi'ping'le'xi	0
哀子胥之慎事	ai'zi'xu'zhi'shen'shi	0
安得夫良药	an'de'fu'liang'yao	0
安得良工而剖之	an'de'liang'gong'er'pou'zhi	0
安放安属	an'fang'an'shu	0
安眇眇而无所归薄	an'miao'miao'er'wu'suo'gui'bo	0
安能久见此浊世	an'neng'jiu'jian'ci'zhuo'shi	0
安能以皓皓之白	an'neng'yi'hao'hao'zhi'bai	0
安能以身之察察	an'neng'yi'shen'zhi'cha'cha	0
安以定只	an'yi'ding'zhi	0
安以舒只	an'yi'shu'zhi	0
卬明月而太息兮	ang'ming'yue'er'tai'xi'xi	0
鼇戴山抃	ao'dai'shan'bian	0
艹枲耳兮充房	ao'xi'er'xi'chong'fang	0
敖朕辞而不听	ao'zhen'ci'er'bu'ting	0
拔木九千些	ba'mu'jiu'qian'xie	0
拔搴玄芝兮	ba'qian'xuan'zhi'xi	0
八柱何当	ba'zhu'he'dang	0
百草萌兮华荣	bai'cao'meng'xi'hua'rong	0
百草育而不长	bai'cao'yu'er'bu'chang	0
白薠兮骋望	bai'fan'xi'cheng'wang	0
白皓胶只	bai'hao'jiao'zhi	0
白虎骋而为右騑	bai'hu'cheng'er'wei'you'fei	0
白虎为之前後	bai'hu'wei'zhi'qian'hou	0
白龙兮见射	bai'long'xi'jian'she	0
白露纷以涂涂兮	bai'lu'fen'yi'tu'tu'xi	0
白露既下百草兮	bai'lu'ji'xia'bai'cao'xi	0
白鹿麔麚兮或腾或倚	bai'lu'jiu'jia'xi'huo'teng'huo'yi	0
百贸易兮传卖	bai'mao'yi'xi'chuan'mai	0
白蜺婴茀	bai'ni'ying'fu	0
白日出之悠悠	bai'ri'chu'zhi'you'you	0
白日晼晚其将入兮	bai'ri'wan'wan'qi'jiang'ru'xi	0
白日晼晼其将入兮	bai'ri'wan'wan'qi'jiang'ru'xi	0
白日昭只	bai'ri'zhao'zhi	0
百神翳其备降兮	bai'shen'yi'qi'bei'jiang'xi	0
白玉兮为镇	bai'yu'xi'wei'zhen	0
白芷生	bai'zhi'sheng	0
斑陆离其上下	ban'lu'li'qi'shang'xia	0
斑漫衍而方行	ban'man'yan'er'fang'xing	0
班其相纷些	ban'qi'xiang'fen'xie	0
班衍衍之冥冥	ban'yan'yan'zhi'ming'ming	0
伴张驰之信期	ban'zhang'chi'zhi'xin'qi	0
榜舫兮下流	bang'fang'xi'xia'liu	0
宝彼兮沙砾	bao'bi'xi'sha'li	0
报大德之优游	bao'da'de'zhi'you'you	0
宝金兮委积	bao'jin'xi'wei'ji	0
保厥美以骄傲兮	bao'jue'mei'yi'jiao'ao'xi	0
保神明之清澄兮	bao'shen'ming'zhi'qing'cheng'xi	0
保寿命只	bao'shou'ming'zhi	0
雹霰兮霏霏	bao'xian'xi'fei'fei	0
抱昭华兮宝璋	bao'zhao'hua'xi'bao'zhang	0
被薜荔兮带女萝	bei'bi'li'xi'dai'nv'luo	0
悲不反余之所居兮	bei'bu'fan'yu'zhi'suo'ju'xi	0
悲楚人之和氏兮	bei'chu'ren'zhi'he'shi'xi	0
北斗为我折中兮	bei'dou'wei'wo'zhe'zhong'xi	0
背法度而心治兮	bei'fa'du'er'xin'zhi'xi	0
被发鬤只	bei'fa'rang'zhi	0
北方不可以止些	bei'fang'bu'ke'yi'zhi'xie	0
北风兮潦洌	bei'feng'xi'liao'lie	0
悲故乡而发忿兮	bei'gu'xiang'er'fa'fen'xi	0
被荷裯之晏晏兮	bei'he'dao'zhi'yan'yan'xi	0
悲皇丘兮积葛	bei'huang'qiu'xi'ji'ge	0
悲回风悲回风之摇蕙兮	bei'hui'feng'bei'hui'feng'zhi'yao'hui'xi	0
悲江介之遗风	bei'jiang'jie'zhi'yi'feng	0
悲精神之不通	bei'jing'shen'zhi'bu'tong	0
悲九州兮靡君	bei'jiu'zhou'xi'mi'jun	0
被离谤而见尤	bei'li'bang'er'jian'you	0
背龙门而入河兮	bei'long'men'er'ru'he'xi	0
悲命兮相当	bei'ming'xi'xiang'dang	0
被明月兮珮宝璐	bei'ming'yue'xi'pei'bao'lu	0
悲莫悲兮生别离	bei'mo'bei'xi'sheng'bie'li	0
悲秋风之动容兮	bei'qiu'feng'zhi'dong'rong'xi	0
悲仁人之尽节兮	bei'ren'ren'zhi'jin'jie'xi	0
背三五之典刑兮	bei'san'wu'zhi'dian'xing'xi	0
悲申徒之抗迹	bei'shen'tu'zhi'kang'ji	0
背绳墨而改错	bei'sheng'mo'er'gai'cuo	0
背绳墨以追曲兮	bei'sheng'mo'yi'zhui'qu'xi	0
背绳墨之正方	bei'sheng'mo'zhi'zheng'fang	0
被石兰兮带杜衡	bei'shi'lan'xi'dai'du'heng	0
悲霜雪之俱下兮	bei'shuang'xue'zhi'ju'xia'xi	0
悲太山之为隍兮	bei'tai'shan'zhi'wei'huang'xi	0
被文服纤	bei'wen'fu'xian	0
背我信兮自违	bei'wo'xin'xi'zi'wei	0
悲吸吸而长怀	bei'xi'xi'er'chang'huai	0
背夏浦而西思兮	bei'xia'pu'er'xi'si'xi	0
背行先些	bei'xing'xian'xie	0
悲虚言之无实兮	bei'xu'yan'zhi'wu'shi'xi	0
被以不慈之伪名	bei'yi'bu'ci'zhi'wei'ming	0
备以为交佩	bei'yi'wei'jiao'pei	0
悲夷犹而冀进兮	bei'yi'you'er'ji'jin'xi	0
北饮兮飞泉	bei'yin'xi'fei'quan	0
背膺牉以交痛兮	bei'ying'pan'yi'jiao'tong'xi	0
北有寒山	bei'you'han'shan	0
悲忧穷戚兮独处廓	bei'you'qiong'qi'xi'du'chu'kuo	0
悲余后兮失灵	bei'yu'hou'xi'shi'ling	0
背玉门以奔骛兮	bei'yu'men'yi'ben'wu'xi	0
悲余生之无欢兮	bei'yu'sheng'zhi'wu'huan'xi	0
悲余心之悁悁兮	bei'yu'xin'zhi'yuan'yuan'xi	0
北至回水	bei'zhi'hui'shui	0
北至幽陵	bei'zhi'you'ling	0
被诼谮兮虚获尤	bei'zhuo'zen'xi'xu'huo'you	0
本朝芜而不治	ben'chao'wu'er'bu'zhi	0
奔电兮光晃	ben'dian'xi'guang'huang	0
奔遁兮隐居	ben'dun'xi'yin'ju	0
比德好閒	bi'de'hao'xian	0
比干何逆	bi'gan'he'ni	0
比干忠而剖心	bi'gan'zhong'er'pou'xin	0
比干忠谏而剖心兮	bi'gan'zhong'jian'er'pou'xin'xi	0
比干菹醢	bi'gan'zu'hai	0
蔽晦君之聪明兮	bi'hui'jun'zhi'cong'ming'xi	0
彼将自然	bi'jiang'zi'ran	0
彼皆習之	bi'jie'xi'zhi	0
薜荔柏兮蕙绸	bi'li'bai'xi'hui'chou	0
彼离畔而朋党兮	bi'li'pan'er'peng'dang'xi	0
薜荔饰而陆离荐兮	bi'li'shi'er'lu'li'jian'xi	0
彼日月兮闇昧	bi'ri'yue'xi'an'mei	0
彼日月之照明兮	bi'ri'yue'zhi'zhao'ming'xi	0
俾山川以备御兮	bi'shan'chuan'yi'bei'yu'xi	0
彼圣人之神德兮	bi'sheng'ren'zhi'shen'de'xi	0
比王侨而为耦	bi'wang'qiao'er'wei'ou	0
彼王纣之躬	bi'wang'zhou'zhi'gong	0
闭心自慎	bi'xin'zi'shen	0
毕休息兮远逝	bi'xiu'xi'xi'yuan'shi	0
彼尧舜之耿介兮	bi'yao'shun'zhi'geng'jie'xi	0
庇廕兮枯树	bi'yin'xi'ku'shu	0
必折轭而摧辕	bi'zhe'e'er'cui'yuan	0
变白以为黑兮	bian'bai'yi'wei'hei'xi	0
编愁苦以为膺	bian'chou'ku'yi'wei'ying	0
鞭风伯使先驱兮	bian'feng'bo'shi'xian'qu'xi	0
变古易俗兮世衰	bian'gu'yi'su'xi'shi'shuai	0
便娟之修竹兮	bian'juan'zhi'xiu'zhu'xi	0
边马顾而不行	bian'ma'gu'er'bu'xing	0
表独立兮山之上	biao'du'li'xi'shan'zhi'shang	0
猋廱蔽此明月	biao'yong'bi'ci'ming'yue	0
滨流兮则逝	bin'liu'xi'ze'shi	0
秉鞭作牧	bing'bian'zuo'mu	0
秉德无私	bing'de'wu'si	0
秉电策兮为鞭	bing'dian'ce'xi'wei'bian	0
冰冻兮洛泽	bing'dong'xi'luo'ze	0
秉干将以割肉	bing'gan'jiang'yi'ge'rou	0
并光明於列星	bing'guang'ming'yu'lie'xing	0
并驱击翼	bing'qu'ji'yi	0
并纫茅丝以为索	bing'ren'mao'si'yi'wei'suo	0
并日夜而无正	bing'ri'ye'er'wu'zheng	0
冰炭不可以相并兮	bing'tan'bu'ke'yi'xiang'bing'xi	0
病殀兮鸣蜩	bing'yao'xi'ming'tiao	0
秉玉英兮结誓	bing'yu'ying'xi'jie'shi	0
拨谄谀而匡邪兮	bo'chan'yu'er'kuang'xie'xi	0
伯昌号衰	bo'chang'hao'shuai	0
波逢汹涌濆壅滂兮	bo'feng'xiong'yong'pen'yong'pang'xi	0
播规矩以背度兮	bo'gui'ju'yi'bei'du'xi	0
薄寒之中人	bo'han'zhi'zhong'ren	0
播江离与滋菊兮	bo'jiang'li'yu'zi'ju'xi	0
伯乐既没	bo'le'ji'mei	0
瓟蠡蠹於筐簏	bo'li'du'yu'kuang'lu	0
波澧澧而扬浇兮	bo'li'li'er'yang'jiao'xi	0
伯林雉经	bo'lin'zhi'jing	0
泊莽莽而无垠	bo'mang'mang'er'wu'yin	0
泊莽莽与野草同死	bo'mang'mang'yu'ye'cao'tong'si	0
薄暮雷电	bo'mu'lei'dian	0
伯强何处	bo'qiang'he'chu	0
波滔滔兮来迎	bo'tao'tao'xi'lai'ying	0
伯牙之绝弦兮	bo'ya'zhi'jue'xian'xi	0
伯夷饿於首阳	bo'yi'e'yu'shou'yang	0
伯夷死於首阳兮	bo'yi'si'yu'shou'yang'xi	0
波淫淫而周流兮	bo'yin'yin'er'zhou'liu'xi	0
伯禹愎鲧	bo'yu'bi'gun	0
不毕辞而赴渊兮	bu'bi'ci'er'fu'yuan'xi	0
不别横之与纵	bu'bie'heng'zhi'yu'zong	0
步屏营兮行丘阿	bu'bing'ying'xi'xing'qiu'a	0
不歠役只	bu'chuo'yi'zhi	0
步从容於山廋	bu'cong'rong'yu'shan'sou	0
不从俗而诐行兮	bu'cong'su'er'bi'xing'xi	0
不但还来	bu'dan'hai'lai	0
不得见兮心伤悲	bu'de'jian'xi'xin'shang'bei	0
不逢汤武与桓缪兮	bu'feng'tang'wu'yu'huan'miu'xi	0
不抚壮而弃秽兮	bu'fu'zhuang'er'qi'hui'xi	0
不顾地以贪名兮	bu'gu'de'yi'tan'ming'xi	0
不顾难以图後兮	bu'gu'nan'yi'tu'hou'xi	0
不顾身之卑贱兮	bu'gu'shen'zhi'bei'jian'xi	0
不获世之尘垢	bu'huo'shi'zhi'chen'gou	0
不及君而骋说兮	bu'ji'jun'er'cheng'shuo'xi	0
步及骤处兮	bu'ji'zhou'chu'xi	0
不浸近兮愈疏	bu'jin'jin'xi'yu'shu	0
卜居屈原既放	bu'ju'qu'yuan'ji'fang	0
不遽惕只	bu'ju'ti'zhi	0
不开寤而难道兮	bu'kai'wu'er'nan'dao'xi	0
不可传	bu'ke'chuan	0
不可获而复登	bu'ke'huo'er'fu'deng	0
不可以久些	bu'ke'yi'jiu'xie	0
不可以久淫些	bu'ke'yi'jiu'yin'xie	0
不可以讬些	bu'ke'yi'tuo'xie	0
不量凿而正枘兮	bu'liang'zao'er'zheng'rui'xi	0
步列星而极明	bu'lie'xing'er'ji'ming	0
不论世而高举兮	bu'lun'shi'er'gao'ju'xi	0
不能复用巫阳焉	bu'neng'fu'yong'wu'yang'yan	0
不能固臧	bu'neng'gu'zang	0
步骑罗些	bu'qi'luo'xie	0
不清澈其然否	bu'qing'che'qi'ran'fou	0
不忍此心之常愁	bu'ren'ci'xin'zhi'chang'chou	0
不任汩鸿	bu'ren'gu'hong	0
不忍见君之蔽壅	bu'ren'jian'jun'zhi'bi'yong	0
不如反余之故乡	bu'ru'fan'yu'zhi'gu'xiang	0
不如下游乎清波	bu'ru'xia'you'hu'qing'bo	0
不涩嗌只	bu'se'ai'zhi	0
不胜心伐帝	bu'sheng'xin'fa'di	0
步徒倚而遥思兮	bu'tu'yi'er'yao'si'xi	0
不枉绳以追曲兮	bu'wang'sheng'yi'zhui'qu'xi	0
不吾理而顺情	bu'wu'li'er'shun'qing	0
不吾知其亦已兮	bu'wu'zhi'qi'yi'yi'xi	0
步余马兮洞庭	bu'yu'ma'xi'dong'ting	0
步余马兮飞柱	bu'yu'ma'xi'fei'zhu	0
步余马兮山皋	bu'yu'ma'xi'shan'gao	0
步余马於兰皋兮	bu'yu'ma'yu'lan'gao'xi	0
不沾薄只	bu'zhan'bo'zhi	0
不知进退之宜当	bu'zhi'jin'tui'zhi'yi'dang	0
不知所从	bu'zhi'suo'cong	0
不终失过兮	bu'zhong'shi'guo'xi	0
步骤桂林兮	bu'zhou'gui'lin'xi	0
步周流於江畔	bu'zhou'liu'yu'jiang'pan	0
采薜荔兮水中	cai'bi'li'xi'shui'zhong	0
才德用兮列施	cai'de'yong'xi'lie'shi	0
采芳洲兮杜若	cai'fang'zhou'xi'du'ruo	0
采撚支於中洲	cai'nian'zhi'yu'zhong'zhou	0
蔡女黜而出帷兮	cai'nv'chu'er'chu'wei'xi	0
材朴委积兮	cai'pu'wei'ji'xi	0
采三秀兮於山间	cai'san'xiu'xi'yu'shan'jian	0
采锺山之玉英	cai'zhong'shan'zhi'yu'ying	0
骖白霓之習習兮	can'bai'ni'zhi'xi'xi'xi	0
参辰回兮颠倒	can'chen'hui'xi'dian'dao	0
惭光景之诚信兮	can'guang'jing'zhi'cheng'xin'xi	0
骖连蜷以骄骜	can'lian'quan'yi'jiao'ao	0
餐六气而饮沆瀣兮	can'liu'qi'er'yin'hang'xie'xi	0
参目虎首	can'mu'hu'shou	0
憯悽增欷兮	can'qi'zeng'xi'xi	0
参天地兮	can'tian'di'xi	0
惨郁郁而不通兮	can'yu'yu'er'bu'tong'xi	0
鸧鹒兮喈喈	cang'geng'xi'jie'jie	0
沧浪之水清兮	cang'lang'zhi'shui'qing'xi	0
沧浪之水浊兮	cang'lang'zhi'shui'zhuo'xi	0
苍龙蚴虬於左骖兮	cang'long'you'qiu'yu'zuo'can'xi	0
藏瑉石於金匮兮	cang'min'shi'yu'jin'kui'xi	0
苍鸟群飞	cang'niao'qun'fei	0
操规矩而无所施	cao'gui'ju'er'wu'suo'shi	0
草苴比而不芳	cao'ju'bi'er'bu'fang	0
草木莽莽	cao'mu'mang'mang	0
草木兮苍唐	cao'mu'xi'cang'tang	0
草木摇落而变衰	cao'mu'yao'luo'er'bian'shuai	0
草木摇落时槁悴兮	cao'mu'yao'luo'shi'gao'cui'xi	0
操绳墨而放弃兮	cao'sheng'mo'er'fang'qi'xi	0
操我兮墨阳	cao'wo'xi'mo'yang	0
操余弧兮反沦降	cao'yu'hu'xi'fan'lun'jiang	0
操愈坚而不衰	cao'yu'jian'er'bu'shuai	0
测汨罗之湘水兮	ce'mi'luo'zhi'xiang'shui'xi	0
策谋从兮翼机衡	ce'mou'cong'xi'yi'ji'heng	0
策驽骀而取路	ce'nu'tai'er'qu'lu	0
曾哀悽欷心离离兮	ceng'ai'qi'xi'xin'li'li'xi	0
曾不知路之曲直兮	ceng'bu'zhi'lu'zhi'qu'zhi'xi	0
曾不知夏之为丘兮	ceng'bu'zhi'xia'zhi'wei'qiu'xi	0
曾颊倚耳	ceng'jia'yi'er	0
曾莫兮别诸	ceng'mo'xi'bie'zhu	0
曾伤爰哀	ceng'shang'yuan'ai	0
曾逝兮青冥	ceng'shi'xi'qing'ming	0
层台累榭	ceng'tai'lei'xie	0
曾歔欷余郁邑兮	ceng'xu'xi'yu'yu'yi'xi	0
曾歔欷之嗟嗟兮	ceng'xu'xi'zhi'jie'jie'xi	0
曾枝剡棘	ceng'zhi'shan'ji	0
察笃夭隐	cha'du'yao'yin	0
茝兰桂树	chai'lan'gui'shu	0
豺狼斗兮我之隅	chai'lang'dou'xi'wo'zhi'yu	0
谗谄是服	chan'chan'shi'fu	0
谗妒入以自代	chan'du'ru'yi'zi'dai	0
谗夫蔼蔼而漫著兮	chan'fu'ai'ai'er'man'zhu'xi	0
谗夫党旅其以兹故兮	chan'fu'dang'lv'qi'yi'zi'gu'xi	0
蝉寂漠而无声	chan'ji'mo'er'wu'sheng	0
谗介介而蔽之	chan'jie'jie'er'bi'zhi	0
谗人高张	chan'ren'gao'zhang	0
谗人諓諓孰可愬兮	chan'ren'jian'jian'shu'ke'shuo'xi	0
蝉翼为重	chan'yi'wei'zhong	0
谗谀登乎明堂	chan'yu'deng'hu'ming'tang	0
谗谀毁而在旁	chan'yu'hui'er'zai'pang	0
谗谀进而相朋	chan'yu'jin'er'xiang'peng	0
潺湲轇轕雷动电发馺高举兮	chan'yuan'jiao'ge'lei'dong'dian'fa'sa'gao'ju'xi	0
尝被君之厚德	chang'bei'jun'zhi'hou'de	0
尝被君之渥洽	chang'bei'jun'zhi'wo'qia	0
怅敞罔兮自怜	chang'chang'wang'xi'zi'lian	0
怅惝罔以永思兮	chang'chang'wang'yi'yong'si'xi	0
长辞远逝乘湘去兮	chang'ci'yuan'shi'cheng'xiang'qu'xi	0
常度未替	chang'du'wei'ti	0
长发曼鬋	chang'fa'man'jian	0
肠愤悁而含怒兮	chang'fen'yuan'er'han'nu'xi	0
肠纷纭以缭转兮	chang'fen'yun'yi'liao'zhuan'xi	0
昌何识	chang'he'shi	0
肠回回兮盘纡	chang'hui'hui'xi'pan'yu	0
长顑颔亦何伤	chang'kan'han'yi'he'shang	0
长濑湍流	chang'lai'tuan'liu	0
长离殃而愁苦	chang'li'yang'er'chou'ku	0
长袂拂面	chang'mei'fu'mian	0
长人何守	chang'ren'he'shou	0
长人千仞	chang'ren'qian'ren	0
长太息而掩涕	chang'tai'xi'er'yan'ti	0
长太息而增欷	chang'tai'xi'er'zeng'xi	0
长太息兮将上	chang'tai'xi'xi'jiang'shang	0
长太息以掩涕兮	chang'tai'xi'yi'yan'ti'xi	0
长无绝兮终古	chang'wu'jue'xi'zhong'gu	0
长乡风而舒情	chang'xiang'feng'er'shu'qing	0
长嘘吸以於悒兮	chang'xu'xi'yi'yu'yi'xi	0
肠一夕而九运	chang'yi'xi'er'jiu'yun	0
长吟永欷涕究究兮	chang'yin'yong'xi'ti'jiu'jiu'xi	0
长愈固而弥纯	chang'yu'gu'er'mi'chun	0
长余佩之陆离	chang'yu'pei'zhi'lu'li	0
长於原野	chang'yu'yuan'ye	0
怅远望此旷野	chang'yuan'wang'ci'kuang'ye	0
倡曰	chang'yue	0
长爪踞牙	chang'zhao'ju'ya	0
怊惝怳而乖怀	chao'chang'huang'er'guai'huai	0
朝晨发兮鄢郢	chao'chen'fa'xi'yan'ying	0
朝骋骛兮江皋	chao'cheng'wu'xi'jiang'gao	0
朝驰余马兮江皋	chao'chi'yu'ma'xi'jiang'gao	0
朝发軔於苍梧兮	chao'fa'ren'yu'cang'wu'xi	0
朝发軔於太仪兮	chao'fa'ren'yu'tai'yi'xi	0
朝发軔於天津兮	chao'fa'ren'yu'tian'jin'xi	0
朝发枉陼兮	chao'fa'wang'zhu'xi	0
朝发兮艹总岭	chao'fa'xi'ao'zong'ling	0
超氛埃而淑郵兮	chao'fen'ai'er'shu'you'xi	0
怊荒忽其焉极	chao'huang'hu'qi'yan'ji	0
超慌忽其焉如	chao'huang'hu'qi'yan'ru	0
超回志度	chao'hui'zhi'du	0
怊茫茫而无归兮	chao'mang'mang'er'wu'gui'xi	0
朝搴阰之木兰兮	chao'qian'pi'zhi'mu'lan'xi	0
巢堂坛兮	chao'tang'tan'xi	0
超惘惘而遂行	chao'wang'wang'er'sui'xing	0
朝吾将济於白水兮	chao'wu'jiang'ji'yu'bai'shui'xi	0
超五岭兮嵯峨	chao'wu'ling'xi'cuo'e	0
超无为以至清兮	chao'wu'wei'yi'zhi'qing'xi	0
朝西灵於九滨	chao'xi'ling'yu'jiu'bin	0
超骧卷阿	chao'xiang'juan'a	0
超逍遥兮今焉薄	chao'xiao'yao'xi'jin'yan'bo	0
朝饮木兰之坠露兮	chao'yin'mu'lan'zhi'zhui'lu'xi	0
超永思乎故乡	chao'yong'si'hu'gu'xiang	0
朝濯发乎洧盘	chao'zhuo'fa'hu'wei'pan	0
朝濯发於汤谷兮	chao'zhuo'fa'yu'tang'gu'xi	0
车错毂兮短兵接	che'cuo'gu'xi'duan'bing'jie	0
车既弊而马罢兮	che'ji'bi'er'ma'ba'xi	0
车既覆而马颠兮	che'ji'fu'er'ma'dian'xi	0
车既驾兮朅而归	che'ji'jia'xi'qie'er'gui	0
车軏折兮马虺颓	che'yue'zhe'xi'ma'hui'tui	0
陈不占战而赴围	chen'bu'zhan'zhan'er'fu'wei	0
沉江惟往古之得失兮	chen'jiang'wei'wang'gu'zhi'de'shi'xi	0
尘莫莫兮未晞	chen'mo'mo'xi'wei'xi	0
沉日夜些	chen'ri'ye'xie	0
沉王躬兮湘汨	chen'wang'gong'xi'xiang'mi	0
陈吴羹些	chen'wu'geng'xie	0
陈竽瑟兮浩倡	chen'yu'se'xi'hao'chang	0
陈锺按鼓	chen'zhong'an'gu	0
乘白水而高骛兮	cheng'bai'shui'er'gao'wu'xi	0
乘白鼋兮逐文鱼	cheng'bai'yuan'xi'zhu'wen'yu	0
乘赤豹兮从文狸	cheng'chi'bao'xi'cong'wen'li	0
乘鄂渚而反顾兮	cheng'e'zhu'er'fan'gu'xi	0
称而弗忘	cheng'er'fu'wang	0
乘氾泭以下流兮	cheng'fan'fu'yi'xia'liu'xi	0
乘戈和兮讴谣	cheng'ge'he'xi'ou'yao	0
成功隳而不卒兮	cheng'gong'hui'er'bu'zu'xi	0
乘虹骖蜺兮	cheng'hong'can'ni'xi	0
承皇考之妙仪	cheng'huang'kao'zhi'miao'yi	0
乘回风而远游	cheng'hui'feng'er'yuan'you	0
乘回风兮载云旗	cheng'hui'feng'xi'zai'yun'qi	0
诚既勇兮又以武	cheng'ji'yong'xi'you'yi'wu	0
乘精气之抟抟兮	cheng'jing'qi'zhi'tuan'tuan'xi	0
惩连改忿兮	cheng'lian'gai'fen'xi	0
乘舲船余上沅兮	cheng'ling'chuan'yu'shang'yuan'xi	0
乘六蛟兮蜿蝉	cheng'liu'jiao'xi'wan'chan	0
乘隆波而南渡兮	cheng'long'bo'er'nan'du'xi	0
乘龙兮辚辚	cheng'long'xi'lin'lin	0
乘龙兮偃蹇	cheng'long'xi'yan'jian	0
诚莫之能善御	cheng'mo'zhi'neng'shan'yu	0
乘骐骋骥舒吾情兮	cheng'qi'cheng'ji'shu'wu'qing'xi	0
乘骐骥而驰骋兮	cheng'qi'ji'er'chi'cheng'xi	0
乘骐骥以驰骋兮	cheng'qi'ji'yi'chi'cheng'xi	0
骋骐骥於中庭兮	cheng'qi'ji'yu'zhong'ting'xi	0
乘骐骥之浏浏兮	cheng'qi'ji'zhi'liu'liu'xi	0
乘清气兮御阴阳	cheng'qing'qi'xi'yu'yin'yang	0
称轻重而不差	cheng'qing'zhong'er'bu'cha	0
乘虬兮登阳	cheng'qiu'xi'deng'yang	0
乘日月兮上征	cheng'ri'yue'xi'shang'zheng	0
乘水车兮荷盖	cheng'shui'che'xi'he'gai	0
成汤东巡	cheng'tang'dong'xun	0
诚未遇其匹合	cheng'wei'yu'qi'pi'he	0
诚无王良之善驭	cheng'wu'wang'liang'zhi'shan'yu	0
诚惜芳之菲菲兮	cheng'xi'fang'zhi'fei'fei'xi	0
乘閒维以反顾	cheng'xian'wei'yi'fan'gu	0
成枭而牟	cheng'xiao'er'mou	0
惩於羹者而吹齑兮	cheng'yu'geng'zhe'er'chui'ji'xi	0
诚原藏而不可迁	cheng'yuan'cang'er'bu'ke'qian	0
乘云兮回回	cheng'yun'xi'hui'hui	0
逞志究欲	cheng'zhi'jiu'yu	0
斥谗夫与便嬖	chi'chan'fu'yu'pian'bi	0
殦雕游兮华屋	chi'diao'you'xi'hua'wu	0
鸱龟曳衔	chi'gui'ye'xian	0
驰椒丘且焉止息	chi'jiao'qiu'qie'yan'zhi'xi	0
驰六蛟兮上征	chi'liu'jiao'xi'shang'zheng	0
驰六龙於三危兮	chi'liu'long'yu'san'wei'xi	0
螭龙并流	chi'long'bing'liu	0
赤松王乔皆在旁	chi'song'wang'qiao'jie'zai'pang	0
驰委移之焉止	chi'wei'yi'zhi'yan'zhi	0
驰骛於杳冥之中兮	chi'wu'yu'yao'ming'zhi'zhong'xi	0
斥蜥蜴兮进龟龙	chi'xi'yi'xi'jin'gui'long	0
鸱鸮集於木兰	chi'xiao'ji'yu'mu'lan	0
鸱枭群而制之	chi'xiao'qun'er'zhi'zhi	0
赤蚁若象	chi'yi'ruo'xiang	0
驰余车兮玄石	chi'yu'che'xi'xuan'shi	0
斥逐鸿鹄兮	chi'zhu'hong'hu'xi	0
冲风起兮横波	chong'feng'qi'xi'heng'bo	0
冲风至兮水扬波	chong'feng'zhi'xi'shui'yang'bo	0
重华不可遻兮	chong'hua'bu'ke'e'xi	0
虫豸兮夹余	chong'zhi'xi'jia'yu	0
崇忠贞兮弥坚	chong'zhong'zhen'xi'mi'jian	0
愁哀哀而累息	chou'ai'ai'er'lei'xi	0
愁不聊兮遑生	chou'bu'liao'xi'huang'sheng	0
惆怅兮	chou'chang'xi	0
惆怅兮自悲	chou'chang'xi'zi'bei	0
惆怅兮自怜	chou'chang'xi'zi'lian	0
愁独哀而冤结	chou'du'ai'er'yuan'jie	0
鯈忽兮容裔	chou'hu'xi'rong'yi	0
鯈忽焉在	chou'hu'yan'zai	0
愁倥傯於山陆	chou'kong'zong'yu'shan'lu	0
抽库娄兮酌醴	chou'ku'lou'xi'zhuo'li	0
抽蒲兮陈坐	chou'pu'xi'chen'zuo	0
愁悄悄之常悲兮	chou'qiao'qiao'zhi'chang'bei'xi	0
愁人兮奈何	chou'ren'xi'nai'he	0
抽思心郁郁之忧思兮	chou'si'xin'yu'yu'zhi'you'si'xi	0
愁叹苦神	chou'tan'ku'shen	0
愁修夜而宛转兮	chou'xiu'ye'er'wan'zhuan'xi	0
愁郁郁之无快兮	chou'yu'yu'zhi'wu'kuai'xi	0
愁郁郁之焉极	chou'yu'yu'zhi'yan'ji	0
出不入兮往不反	chu'bu'ru'xi'wang'bu'fan	0
楚辞	chu'ci	0
处雌蜺之标颠	chu'ci'ni'zhi'biao'dian	0
畜鴳兮近处	chu'e'xi'jin'chu	0
初放平生於国兮	chu'fang'ping'sheng'yu'guo'xi	0
处妇愤而长望	chu'fu'fen'er'chang'wang	0
畜凫驾鹅	chu'fu'jia'e	0
出国门而端指兮	chu'guo'men'er'duan'zhi'xi	0
出国门而轸怀兮	chu'guo'men'er'zhen'huai'xi	0
除秽累而反真	chu'hui'lei'er'fan'zhen	0
初既与余成言兮	chu'ji'yu'yu'cheng'yan'xi	0
楚劳商只	chu'lao'shang'zhi	0
畜鸾皇只	chu'luan'huang'zhi	0
出门兮触螽	chu'men'xi'chu'zhong	0
处湣湣之浊世兮	chu'min'min'zhi'zhuo'shi'xi	0
初若是而逢殆	chu'ruo'shi'er'feng'dai	0
出若云只	chu'ruo'yun'zhi	0
触石碕而衡游	chu'shi'qi'er'heng'you	0
初汤臣挚	chu'tang'chen'zhi	0
初吾所陈之耿著兮	chu'wu'suo'chen'zhi'geng'zhu'xi	0
处玄舍之幽门兮	chu'xuan'she'zhi'you'men'xi	0
处浊世而显荣兮	chu'zhuo'shi'er'xian'rong'xi	0
处卓卓而日远兮	chu'zhuo'zhuo'er'ri'yuan'xi	0
出自汤谷	chu'zi'tang'gu	0
传芭兮代舞	chuan'ba'xi'dai'wu	0
川谷何洿	chuan'gu'he'hu	0
川谷径复	chuan'gu'jing'fu	0
川谷兮渊渊	chuan'gu'xi'yuan'yuan	0
船容与而不进兮	chuan'rong'yu'er'bu'jin'xi	0
怆恨兮怀愁	chuang'hen'xi'huai'chou	0
怆怳懭悢兮	chuang'huang'kuang'liang'xi	0
吹参差兮谁思	chui'cen'ci'xi'shui'si	0
垂明月之玄珠	chui'ming'yue'zhi'xuan'zhu	0
垂文扬采遗将来兮	chui'wen'yang'cai'yi'jiang'lai'xi	0
垂屣兮将起	chui'xi'xi'jiang'qi	0
鹑鹌兮甄甄	chun'an'xi'zhen'zhen	0
春草生兮萋萋	chun'cao'sheng'xi'qi'qi	0
惷怅立兮涕滂沲	chun'chang'li'xi'ti'pang'tuo	0
鹑鴳飞扬	chun'e'fei'yang	0
春兰兮秋鞠	chun'lan'xi'qiu'ju	0
春气奋发	chun'qi'fen'fa	0
春秋逴逴而日高兮	chun'qiu'chuo'chuo'er'ri'gao'xi	0
春秋忽其不淹兮	chun'qiu'hu'qi'bu'yan'xi	0
春与秋其代序	chun'yu'qiu'qi'dai'xu	0
逴绝垠乎寒门	chuo'jue'yin'hu'han'men	0
逴龙赩只	chuo'long'xi'zhi	0
此德之门	ci'de'zhi'men	0
此皆甘人	ci'jie'gan'ren	0
辞九年而不复兮	ci'jiu'nian'er'bu'fu'xi	0
辞灵修而陨志兮	ci'ling'xiu'er'yun'zhi'xi	0
雌蜺便娟以增挠兮	ci'ni'bian'juan'yi'zeng'nao'xi	0
此孰吉孰凶	ci'shu'ji'shu'xiong	0
次于蒙氾	ci'yu'meng'fan	0
蛓缘兮我裳	ci'yuan'xi'wo'shang	0
从安期兮蓬莱	cong'an'qi'xi'peng'lai	0
从卬遨兮栖迟	cong'ang'ao'xi'qi'chi	0
丛薄深林兮	cong'bo'shen'lin'xi	0
从风雨而飞飏	cong'feng'yu'er'fei'yang	0
藂菅是食些	cong'jian'shi'shi'xie	0
丛林兮崟崟	cong'lin'xi'yin'yin	0
丛林之下无怨士兮	cong'lin'zhi'xia'wu'yuan'shi'xi	0
从水蛟而为徙兮	cong'shui'jiao'er'wei'xi'xi	0
从虾兮游陼	cong'xia'xi'you'zhu	0
从玄鹤与鹪明	cong'xuan'he'yu'jiao'ming	0
从颛顼乎增冰	cong'zhuan'xu'hu'zeng'bing	0
从子胥而自適	cong'zi'xu'er'zi'shi	0
爨土鬵於中宇	cuan'tu'xin'yu'zhong'yu	0
萃何喜	cui'he'xi	0
翠缥兮为裳	cui'piao'xi'wei'shang	0
存仿佛而不见兮	cun'fang'fu'er'bu'jian'xi	0
寸有所长	cun'you'suo'chang	0
错权衡而任意	cuo'quan'heng'er'ren'yi	0
挫糟冻饮	cuo'zao'dong'yin	0
大侯张只	da'hou'zhang'zhi	0
大火兮西睨	da'huo'xi'xi'ni	0
大苦咸酸	da'ku'xian'suan	0
大鸟何鸣	da'niao'he'ming	0
大人所晟	da'ren'suo'sheng	0
大司命广开兮天门	da'si'ming'guang'kai'xi'tian'men	0
大招青春受谢	da'zhao'qing'chun'shou'xie	0
带长铗之陆离兮	dai'chang'jia'zhi'lu'li'xi	0
带长剑兮挟秦弓	dai'chang'jian'xi'xie'qin'gong	0
待明君其知之	dai'ming'jun'qi'zhi'zhi	0
代秦郑卫	dai'qin'zheng'wei	0
代水不可涉	dai'shui'bu'ke'she	0
待天明兮立踯躅	dai'tian'ming'xi'li'zhi'zhu	0
带隐虹之逶蛇	dai'yin'hong'zhi'wei'she	0
弹角而角动	dan'jiao'er'jiao'dong	0
惮举趾而缘木	dan'ju'zhi'er'yuan'mu	0
旦徘徊於长阪兮	dan'pai'huai'yu'chang'ban'xi	0
惮褰裳而濡足	dan'qian'shang'er'ru'zu	0
惮青兕	dan'qing'si	0
澹然而自乐兮	dan'ran'er'zi'le'xi	0
澹容与而独倚兮	dan'rong'yu'er'du'yi'xi	0
澹无为而自得	dan'wu'wei'er'zi'de	0
惮涌湍之石盖石盖兮	dan'yong'tuan'zhi'shi'gai'shi'gai'xi	0
旦余济乎江湘	dan'yu'ji'hu'jiang'xiang	0
当道宿	dang'dao'su	0
当陵阳之焉至兮	dang'ling'yang'zhi'yan'zhi'xi	0
当世岂无骐骥兮	dang'shi'qi'wu'qi'ji'xi	0
荡渨涹之奸咎兮	dang'wei'wo'zhi'jian'jiu'xi	0
稻粢穱麦	dao'ci'zhuo'mai	0
导帝之兮九坑	dao'di'zhi'xi'jiu'keng	0
悼芳草之先蘦	dao'fang'cao'zhi'xian'ling	0
道可受兮	dao'ke'shou'xi	0
悼来者之悐悐	dao'lai'zhe'zhi'ti'ti	0
悼乱嗟嗟兮悲夫	dao'luan'jie'jie'xi'bei'fu	0
道莫贵兮归真	dao'mo'gui'xi'gui'zhen	0
倒上以为下	dao'shang'yi'wei'xia	0
道思作颂	dao'si'zuo'song	0
道遐回兮阻叹	dao'xia'hui'xi'zu'tan	0
道修远其难迁兮	dao'xiu'yuan'qi'nan'qian'xi	0
道壅绝而不通	dao'yong'jue'er'bu'tong	0
道壅塞而不通兮	dao'yong'se'er'bu'tong'xi	0
道幽路兮九疑	dao'you'lu'xi'jiu'yi	0
悼余生之不时兮	dao'yu'sheng'zhi'bu'shi'xi	0
道余兮何之	dao'yu'xi'he'zhi	0
道远忽兮	dao'yuan'hu'xi	0
道卓远而日忘兮	dao'zhuo'yuan'er'ri'wang'xi	0
得彼小子	de'bi'xiao'zi	0
得两男子	de'liang'nan'zi	0
得人肉以祀	de'ren'rou'yi'si	0
德日忘而怨深	de'ri'wang'er'yuan'shen	0
德誉配天	de'yu'pei'tian	0
德泽章只	de'ze'zhang'zhi	0
得罪过之不意	de'zui'guo'zhi'bu'yi	0
登苍天而高举兮	deng'cang'tian'er'gao'ju'xi	0
登阊阖於玄阙	deng'chang'he'yu'xuan'que	0
登长陵而四望兮	deng'chang'ling'er'si'wang'xi	0
登巑岏以长企兮	deng'cuan'wan'yi'chang'qi'xi	0
登大坟而望夏首	deng'da'fen'er'wang'xia'shou	0
登大坟以远望兮	deng'da'fen'yi'yuan'wang'xi	0
登逢龙而下陨兮	deng'feng'long'er'xia'yun'xi	0
登高吾不说兮	deng'gao'wu'bu'shuo'xi	0
登华盖兮乘阳	deng'hua'gai'xi'cheng'yang	0
登降堂只	deng'jiang'tang'zhi	0
登九天兮抚彗星	deng'jiu'tian'xi'fu'hui'xing	0
登昆仑而北首兮	deng'kun'lun'er'bei'shou'xi	0
登昆仑兮食玉英	deng'kun'lun'xi'shi'yu'ying	0
登昆仑兮四望	deng'kun'lun'xi'si'wang	0
登阆风而絏马	deng'lang'feng'er'xie'ma	0
登立为帝	deng'li'wei'di	0
登峦山而远望兮	deng'luan'shan'er'yuan'wang'xi	0
登山长望中心悲兮	deng'shan'chang'wang'zhong'xin'bei'xi	0
登山临水兮	deng'shan'lin'shui'xi	0
登石峦以远望兮	deng'shi'luan'yi'yuan'wang'xi	0
登太一兮玉台	deng'tai'yi'xi'yu'tai	0
登羊角兮扶舆	deng'yang'jiao'xi'fu'yu	0
地方九则	di'fang'jiu'ze	0
帝告巫阳曰	di'gao'wu'yang'yue	0
帝高阳之苗裔兮	di'gao'yang'zhi'miao'yi'xi	0
帝何求	di'he'qiu	0
帝何飨	di'he'xiang	0
帝何刑焉	di'he'xing'yan	0
弟何欲	di'he'yu	0
帝何竺之	di'he'zhu'zhi	0
低徊夷犹	di'huai'yi'you	0
帝降夷羿	di'jiang'yi'yi	0
帝乃降观	di'nai'jiang'guan	0
砥室翠翘	di'shi'cui'qiao	0
邸余车兮方林	di'yu'che'xi'fang'lin	0
奠桂酒兮椒浆	dian'gui'jiu'xi'jiao'jiang	0
颠裳以为衣	dian'shang'yi'wei'yi	0
阽余身而危死兮	dian'yu'shen'er'wei'si'xi	0
凋彼叶柯	diao'bi'ye'ke	0
雕题黑齿	diao'ti'hei'chi	0
定空桑只	ding'kong'sang'zhi	0
鼎臑盈望	ding'nao'ying'wang	0
丁时逢殃可奈何兮	ding'shi'feng'yang'ke'nai'he'xi	0
定心广志	ding'xin'guang'zhi	0
东方不可以讬些	dong'fang'bu'ke'yi'tuo'xie	0
东风飘兮神灵雨	dong'feng'piao'xi'shen'ling'yu	0
东皇太一吉日兮辰良	dong'huang'tai'yi'ji'ri'xi'chen'liang	0
东君暾将出兮东方	dong'jun'tun'jiang'chu'xi'dong'fang	0
东流不溢	dong'liu'bu'yi	0
东南何亏	dong'nan'he'kui	0
东穷海只	dong'qiong'hai'zhi	0
洞庭波兮木叶下	dong'ting'bo'xi'mu'ye'xia	0
东西南北	dong'xi'nan'bei	0
东西兮南北	dong'xi'xi'nan'bei	0
冬夜兮陶陶	dong'ye'xi'tao'tao	0
东有大海	dong'you'da'hai	0
冬又申之以严霜	dong'you'shen'zhi'yi'yan'shuang	0
冬有突厦	dong'you'tu'sha	0
东注兮石盖石盖	dong'zhu'xi'shi'gai'shi'gai	0
独悲愁其伤人兮	du'bei'chou'qi'shang'ren'xi	0
妒被离而鄣之	du'bei'li'er'zhang'zhi	0
妒被离而折之	du'bei'li'er'zhe'zhi	0
独便悁而烦毒兮	du'bian'yuan'er'fan'du'xi	0
独便悁而怀毒兮	du'bian'yuan'er'huai'du'xi	0
独不见夫鸾凤之高翔兮	du'bu'jian'fu'luan'feng'zhi'gao'xiang'xi	0
独处兮罔依	du'chu'xi'wang'yi	0
独处兮志不申	du'chu'xi'zhi'bu'shen	0
独愤积而哀娱兮	du'fen'ji'er'ai'yu'xi	0
独耿介而不随兮	du'geng'jie'er'bu'sui'xi	0
睹皇公兮问师	du'huang'gong'xi'wen'shi	0
妒佳冶之芬芳兮	du'jia'ye'zhi'fen'fang'xi	0
独立不迁	du'li'bu'qian	0
独历年而离愍兮	du'li'nian'er'li'min'xi	0
独廉洁而不容兮	du'lian'jie'er'bu'rong'xi	0
独蒙毒而逢尤	du'meng'du'er'feng'you	0
睹秘藏兮宝珍	du'mi'cang'xi'bao'zhen	0
独偏弃而远放	du'pian'qi'er'yuan'fang	0
独茕茕而南行	du'qiong'qiong'er'nan'xing	0
独茕茕而南行兮	du'qiong'qiong'er'nan'xing'xi	0
独申旦而不寐兮	du'shen'dan'er'bu'mei'xi	0
睹斯兮嫉贼	du'si'xi'ji'zei	0
睹斯兮伪惑	du'si'xi'wei'huo	0
睹天地之圜方	du'tian'di'zhi'huan'fang	0
督万兮侍宴	du'wan'xi'shi'yan	0
独无匹兮	du'wu'pi'xi	0
独徙倚而彷徉	du'xi'yi'er'pang'yang	0
独行之士其何望	du'xing'zhi'shi'qi'he'wang	0
独秀先些	du'xiu'xian'xie	0
独隐伏而思虑	du'yin'fu'er'si'lv	0
独永思而忧悲	du'yong'si'er'you'bei	0
独永叹乎增伤	du'yong'tan'hu'zeng'shang	0
独郁结其谁语	du'yu'jie'qi'shui'yu	0
独冤抑而无极兮	du'yuan'yi'er'wu'ji'xi	0
独鄣廱而蔽隐兮	du'zhang'yong'er'bi'yin'xi	0
睹轸丘兮崎倾	du'zhen'qiu'xi'qi'qing	0
断镳衔以驰骛兮	duan'biao'xian'yi'chi'wu'xi	0
端余行其如玉兮	duan'yu'xing'qi'ru'yu'xi	0
遁而有他	dun'er'you'ta	0
敦脢血拇	dun'mei'xue'mu	0
顿弃太阿	dun'qi'tai'e	0
多害伤只	duo'hai'shang'zhi	0
多迅众些	duo'xun'zhong'xie	0
多贼奸些	duo'zei'jian'xie	0
多珍怪些	duo'zhen'guai'xie	0
恶耿介之直行兮	e'geng'jie'zhi'zhi'xing'xi	0
蛾眉曼睩	e'mei'man'lu	0
蛾眉曼只	e'mei'man'zhi	0
鴳雀列兮譁讙	e'que'lie'xi'hua'huan	0
恶所兮写情	e'suo'xi'xie'qing	0
恶虞氏之箫韶兮	e'yu'shi'zhi'xiao'shao'xi	0
誒笑狂只	ei'xiao'kuang'zhi	0
恩不甚兮轻绝	en'bu'shen'xi'qing'jue	0
二八接舞	er'ba'jie'wu	0
二八齐容	er'ba'qi'rong	0
二八侍宿	er'ba'shi'su	0
胹鄨砲羔	er'bi'pao'gao	0
而蔽鄣於谗	er'bi'zhang'yu'chan	0
而不可保长	er'bu'ke'bao'zhang	0
而赐封之	er'ci'feng'zhi	0
而颠陨厥首	er'dian'yun'jue'shou	0
而顾菟在腹	er'gu'tu'zai'fu	0
而馆同爰止	er'guan'tong'yuan'zhi	0
而鲧疾修盈	er'gun'ji'xiu'ying	0
尔何怀乎故宇	er'he'huai'hu'gu'yu	0
而后帝不若	er'hou'di'bu'ruo	0
而後嗣逢长	er'hou'si'feng'chang	0
而吉妃是得	er'ji'fei'shi'dei	0
而交吞揆之	er'jiao'tun'kui'zhi	0
而厥谋不同	er'jue'mou'bu'tong	0
而厥身不危败	er'jue'shen'bu'wei'bai	0
而快朝饱	er'kuai'chao'bao	0
而离彼不祥些	er'li'bi'bu'xiang'xie	0
而黎服大说	er'li'fu'da'shuo	0
耳聊啾而戃慌	er'liao'jiu'er'tang'huang	0
而蒙世俗之尘埃乎	er'meng'shi'su'zhi'chen'ai'hu	0
而能拘是达	er'neng'ju'shi'da	0
而能与世推移	er'neng'yu'shi'tui'yi	0
二女何亲	er'nv'he'qin	0
二女御九韶歌	er'nv'yu'jiu'shao'ge	0
而妻彼雒嫔	er'qi'bi'luo'pin	0
而亲以逢殆	er'qin'yi'feng'dai	0
而死分竟地	er'si'fen'jing'di	0
而私自怜	er'si'zi'lian	0
而通之於台桑	er'tong'zhi'yu'tai'sang	0
而无害厥躬	er'wu'hai'jue'gong	0
而抑沉之	er'yi'chen'zhi	0
而禹播降	er'yu'bo'jiang	0
二子拥瑟而调均兮	er'zi'yong'se'er'tiao'jun'xi	0
发愤以抒情	fa'fen'yi'shu'qing	0
发激楚些	fa'ji'chu'xie	0
发披披以鬤鬤兮	fa'pi'pi'yi'rang'rang'xi	0
发扬荷些	fa'yang'he'xie	0
发郢都而去闾兮	fa'ying'dou'er'qu'lv'xi	0
发玉軔兮西行	fa'yu'ren'xi'xi'xing	0
发政献行	fa'zheng'xian'xing	0
反成乃亡	fan'cheng'nai'wang	0
反故居些	fan'gu'ju'xie	0
薠蘅槁而节离兮	fan'heng'gao'er'jie'li'xi	0
反既有此他志	fan'ji'you'ci'ta'zhi	0
氾潏潏其前後兮	fan'jue'jue'qi'qian'hou'xi	0
反离谤而见攘	fan'li'bang'er'jian'rang	0
反离群而赘尤	fan'li'qun'er'zhui'you	0
反蒙辜而被疑	fan'meng'gu'er'bei'yi	0
反为雠而见怨	fan'wei'chou'er'jian'yuan	0
反为小人之所贼	fan'wei'xiao'ren'zhi'suo'zei	0
反信谗以齐怒	fan'xin'chan'yi'qi'nu	0
犯颜色而触谏兮	fan'yan'se'er'chu'jian'xi	0
反以兹为腐也	fan'yi'zi'wei'fu'ye	0
汎淫澒溶纷若雾兮	fan'yin'hong'rong'fen'ruo'wu'xi	0
汎淫兮无根	fan'yin'xi'wu'gen	0
烦冤瞀容	fan'yuan'mao'rong	0
芳不得薄兮	fang'bu'de'bo'xi	0
芳菲菲而难亏兮	fang'fei'fei'er'nan'kui'xi	0
芳菲菲其弥章	fang'fei'fei'qi'mi'zhang	0
芳菲菲兮满堂	fang'fei'fei'xi'man'tang	0
芳菲菲兮袭予	fang'fei'fei'xi'xi'yu	0
方圜殊而不合兮	fang'huan'shu'er'bu'he'xi	0
放佞人与谄谀兮	fang'ning'ren'yu'chan'yu'xi	0
芳若兹而不御兮	fang'ruo'zi'er'bu'yu'xi	0
放山渊之龟玉兮	fang'shan'yuan'zhi'gui'yu'xi	0
方世俗之幽昏兮	fang'shi'su'zhi'you'hun'xi	0
访太昊兮道要	fang'tai'hao'xi'dao'yao	0
芳虈兮挫枯	fang'xiao'xi'cuo'ku	0
芳以歇而不比	fang'yi'xie'er'bu'bi	0
芳懿懿而终败兮	fang'yi'yi'er'zhong'bai'xi	0
放游志乎云中	fang'you'zhi'hu'yun'zhong	0
放余辔兮策驷	fang'yu'pei'xi'ce'si	0
芳郁渥而纯美	fang'yu'wo'er'chun'mei	0
芳与泽其杂糅兮	fang'yu'ze'qi'za'rou'xi	0
放敶组缨	fang'zhen'zu'ying	0
方仲春而东迁	fang'zhong'chun'er'dong'qian	0
放子出而不还	fang'zi'chu'er'bu'hai	0
费白日些	fei'bai'ri'xie	0
翡翠珠被	fei'cui'zhu'bei	0
飞駏兮步旁	fei'ju'xi'bu'pang	0
非俊疑傑兮	fei'jun'yi'jie'xi	0
飞龙兮翩翩	fei'long'xi'pian'pian	0
飞鸟号其群兮	fei'niao'hao'qi'qun'xi	0
肥牛之腱	fei'niu'zhi'jian	0
非世俗之所服	fei'shi'su'zhi'suo'fu	0
吠所怪也	fei'suo'guai'ye	0
翡帷翠帐	fei'wei'cui'zhang	0
飞翔兮灵丘	fei'xiang'xi'ling'qiu	0
飞雪千里些	fei'xue'qian'li'xie	0
非余心之所急	fei'yu'xin'zhi'suo'ji	0
非余心之所乐	fei'yu'xin'zhi'suo'le	0
废制度而不用兮	fei'zhi'du'er'bu'yong'xi	0
非重躯以虑难兮	fei'zhong'qu'yi'lv'nan'xi	0
废周邵於遐夷	fei'zhou'shao'yu'xia'yi	0
飞硃鸟使先驱兮	fei'zhu'niao'shi'xian'qu'xi	0
氛埃辟而清凉	fen'ai'pi'er'qing'liang	0
粉白黛黑	fen'bai'dai'hei	0
分曹并进	fen'cao'bing'jin	0
纷纯纯之原忠兮	fen'chun'chun'zhi'yuan'zhong'xi	0
纷独有此姱节	fen'du'you'ci'kua'jie	0
纷逢尤以离谤兮	fen'feng'you'yi'li'bang'xi	0
分流汨兮	fen'liu'mi'xi	0
纷其可喜兮	fen'qi'ke'xi'xi	0
纷容容之无经兮	fen'rong'rong'zhi'wu'jing'xi	0
纷容与而并驰	fen'rong'yu'er'bing'chi	0
纷吾乘兮玄云	fen'wu'cheng'xi'xuan'yun	0
纷吾既有此内美兮	fen'wu'ji'you'ci'nei'mei'xi	0
奋摇兮众芳	fen'yao'xi'zhong'fang	0
纷旖旎乎都房	fen'yi'ni'hu'dou'fang	0
纷翼翼兮上跻	fen'yi'yi'xi'shang'ji	0
纷郁郁其远蒸兮	fen'yu'yu'qi'yuan'zheng'xi	0
忿悁悒兮孰诉告	fen'yuan'yi'xi'shu'su'gao	0
蒶蕴兮霉黧	fen'yun'xi'mei'li	0
纷缊宜修	fen'yun'yi'xiu	0
纷载驱兮高驰	fen'zai'qu'xi'gao'chi	0
芬至今犹未沬	fen'zhi'jin'you'wei'hui	0
纷总总其离合兮	fen'zong'zong'qi'li'he'xi	0
纷总总兮九州	fen'zong'zong'xi'jiu'zhou	0
逢彼白雉	feng'bi'bai'zhi	0
封比干之丘垄	feng'bi'gan'zhi'qiu'long	0
风伯为余先驱兮	feng'bo'wei'yu'xian'qu'xi	0
逢此世之俇攘	feng'ci'shi'zhi'guang'rang	0
凤独遑遑而无所集	feng'du'huang'huang'er'wu'suo'ji	0
凤独翔翔而无所薄	feng'du'xiang'xiang'er'wu'suo'bo	0
蜂蛾微命	feng'e'wei'ming	0
逢纷伊伯庸之末胄兮	feng'fen'yi'bo'yong'zhi'mo'zhou'xi	0
封狐千里些	feng'hu'qian'li'xie	0
凤皇不翔兮	feng'huang'bu'xiang'xi	0
凤皇飞而高翔	feng'huang'fei'er'gao'xiang	0
凤皇高飞而不下	feng'huang'gao'fei'er'bu'xia	0
凤皇既受诒兮	feng'huang'ji'shou'yi'xi	0
凤皇翔只	feng'huang'xiang'zhi	0
凤凰翼其承旂兮	feng'huang'yi'qi'cheng'qi'xi	0
凤皇翼其承旂兮	feng'huang'yi'qi'cheng'qi'xi	0
凤皇在笯兮	feng'huang'zai'nu'xi	0
封介山而为之禁兮	feng'jie'shan'er'wei'zhi'jin'xi	0
冯昆仑以瞰雾兮	feng'kun'lun'yi'kan'wu'xi	0
逢流星兮问路	feng'liu'xing'xi'wen'lu	0
丰肉微骨	feng'rou'wei'gu	0
风飒飒兮木萧萧	feng'sa'sa'xi'mu'xiao'xiao	0
风骚屑以摇木兮	feng'sao'xie'yi'yao'mu'xi	0
封豨是射	feng'xi'shi'she	0
风習習兮和暖	feng'xi'xi'xi'he'nuan	0
奉先功以照下兮	feng'xian'gong'yi'zhao'xia'xi	0
冯珧利决	feng'yao'li'jue	0
凤亦不贪餧而妄食	feng'yi'bu'tan'si'er'wang'shi	0
冯翼惟像	feng'yi'wei'xiang	0
风邑邑而蔽之	feng'yi'yi'er'bi'zhi	0
逢尤悲兮愁	feng'you'bei'xi'chou	0
凤愈飘翔而高举	feng'yu'piao'xiang'er'gao'ju	0
冯郁郁其何极	feng'yu'yu'qi'he'ji	0
阜隘狭而幽险兮	fu'ai'xia'er'you'xian'xi	0
抚案下些	fu'an'xia'xie	0
服罢牛而骖骥	fu'ba'niu'er'can'ji	0
弗参验以考实兮	fu'can'yan'yi'kao'shi'xi	0
刜谗贼於中廇兮	fu'chan'zei'yu'zhong'liu'xi	0
抚长剑兮玉珥	fu'chang'jian'xi'yu'er	0
夫尺有所短	fu'chi'you'suo'duan	0
夫方圜之异形兮	fu'fang'huan'zhi'yi'xing'xi	0
夫何长	fu'he'chang	0
夫何恶之	fu'he'e'zhi	0
夫何极而不至兮	fu'he'ji'er'bu'zhi'xi	0
夫何久长	fu'he'jiu'chang	0
夫何彭咸之造思兮	fu'he'peng'xian'zhi'zao'si'xi	0
夫何茕独而不予听	fu'he'qiong'du'er'bu'yu'ting	0
夫何三年不施	fu'he'san'nian'bu'shi	0
夫何索求	fu'he'suo'qiu	0
夫何以变化	fu'he'yi'bian'hua	0
父何以鱞	fu'he'yi'guan	0
夫何以责其捷巧	fu'he'yi'ze'qi'jie'qiao	0
夫何予生之不遘时	fu'he'yu'sheng'zhi'bu'gou'shi	0
夫何执操之不固	fu'he'zhi'cao'zhi'bu'gu	0
夫何周流	fu'he'zhou'liu	0
夫何罪尤	fu'he'zui'you	0
夫黄鹄神龙犹如此兮	fu'huang'hu'shen'long'you'ru'ci'xi	0
浮江淮而入海兮	fu'jiang'huai'er'ru'hai'xi	0
赴江湘之湍流兮	fu'jiang'xiang'zhi'tuan'liu'xi	0
服觉皓以殊俗兮	fu'jue'hao'yi'shu'su'xi	0
抚槛兮远望	fu'kan'xi'yuan'wang	0
弗可久兮此方	fu'ke'jiu'xi'ci'fang	0
赴昆山兮馽騄	fu'kun'shan'xi'zhi'lu	0
赴汨罗之长流	fu'mi'luo'zhi'chang'liu	0
浮溺水兮舒光	fu'ni'shui'xi'shu'guang	0
伏匿穴处	fu'ni'xue'chu	0
伏念思过兮	fu'nian'si'guo'xi	0
俛念兮子胥	fu'nian'xi'zi'xu	0
抚珮衽以案志兮	fu'pei'ren'yi'an'zhi'xi	0
伏清白以死直兮	fu'qing'bai'yi'si'zhi'xi	0
服清白以逍遥兮	fu'qing'bai'yi'xiao'yao'xi	0
抚情效志兮	fu'qing'xiao'zhi'xi	0
赴曲相和	fu'qu'xiang'he	0
夫人孰能不反其真情	fu'ren'shu'neng'bu'fan'qi'zhen'qing	0
夫人自有兮美子	fu'ren'zi'you'xi'mei'zi	0
芙蓉盖而菱华车兮	fu'rong'gai'er'ling'hua'che'xi	0
芙蓉始发	fu'rong'shi'fa	0
蝮蛇蜒只	fu'she'yan'zhi	0
蝮蛇蓁蓁	fu'she'zhen'zhen	0
抚轼叹兮作诗	fu'shi'tan'xi'zuo'shi	0
夫孰非义而可用兮	fu'shu'fei'yi'er'ke'yong'xi	0
夫孰异道而相安	fu'shu'yi'dao'er'xiang'an	0
夫谁使挑之	fu'shui'shi'tiao'zhi	0
夫谁畏惧	fu'shui'wei'ju	0
复往轨於初古	fu'wang'gui'yu'chu'gu	0
夫惟党人鄙固兮	fu'wei'dang'ren'bi'gu'xi	0
夫唯捷径以窘步	fu'wei'jie'jing'yi'jiong'bu	0
夫唯灵修之故也	fu'wei'ling'xiu'zhi'gu'ye	0
夫维圣哲以茂行兮	fu'wei'sheng'zhe'yi'mao'xing'xi	0
伏戏驾辩	fu'xi'jia'bian	0
赴湘沅之流澌兮	fu'xiang'yuan'zhi'liu'si'xi	0
父信谗而不好	fu'xin'chan'er'bu'hao	0
弗省察而按实兮	fu'xing'cha'er'an'shi'xi	0
负檐荷以丈尺兮	fu'yan'he'yi'zhang'chi'xi	0
服偃蹇以低昂兮	fu'yan'jian'yi'di'ang'xi	0
凫雁皆唼夫梁藻兮	fu'yan'jie'sha'fu'liang'zao'xi	0
夫焉取九子	fu'yan'qu'jiu'zi	0
夫焉丧厥体	fu'yan'sang'jue'ti	0
赴阳侯之潢洋兮	fu'yang'hou'zhi'huang'yang'xi	0
阜杳杳以蔽日	fu'yao'yao'yi'bi'ri	0
抚余马兮安驱	fu'yu'ma'xi'an'qu	0
抚余佩兮缤纷	fu'yu'pei'xi'bin'fen	0
怫郁兮莫陈	fu'yu'xi'mo'chen	0
浮云陈而蔽晦兮	fu'yun'chen'er'bi'hui'xi	0
浮云漠兮自娱	fu'yun'mo'xi'zi'yu	0
浮云雾而入冥兮	fu'yun'wu'er'ru'ming'xi	0
浮云兮容与	fu'yun'xi'rong'yu	0
服云衣之披披	fu'yun'yi'zhi'pi'pi	0
浮云郁兮昼昏	fu'yun'yu'xi'zhou'hun	0
抚招摇以质正	fu'zhao'yao'yi'zhi'zheng	0
覆舟斟寻	fu'zhou'zhen'xun	0
抚硃爵与鵕鸃	fu'zhu'jue'yu'jun'yi	0
负子肆情	fu'zi'si'qing	0
负左右之耿介	fu'zuo'you'zhi'geng'jie	0
该秉季德	gai'bing'ji'de	0
盖见兹以永叹兮	gai'jian'zi'yi'yong'tan'xi	0
改前圣之法度兮	gai'qian'sheng'zhi'fa'du'xi	0
盖为余而造怒	gai'wei'yu'er'zao'nu	0
甘棠枯於丰草兮	gan'tang'ku'yu'feng'cao'xi	0
干协时舞	gan'xie'shi'wu	0
感余志兮惨栗	gan'yu'zhi'xi'can'li	0
高翱翔之翼翼	gao'ao'xiang'zhi'yi'yi	0
槁本兮萎落	gao'ben'xi'wei'luo	0
高驰兮冲天	gao'chi'xi'chong'tian	0
高飞兮安翔	gao'fei'xi'an'xiang	0
高回翔兮上臻	gao'hui'xiang'xi'shang'zhen	0
皋兰被径兮	gao'lan'bei'jing'xi	0
高山崔巍兮	gao'shan'cui'wei'xi	0
高太息兮自怜	gao'tai'xi'xi'zi'lian	0
高堂邃宇	gao'tang'sui'yu	0
高辛之灵晟兮	gao'xin'zhi'ling'sheng'xi	0
高阳邈以远兮	gao'yang'miao'yi'yuan'xi	0
高阳无故而委尘兮	gao'yang'wu'gu'er'wei'chen'xi	0
高余冠之岌岌兮	gao'yu'guan'zhi'ji'ji'xi	0
告余以吉故	gao'yu'yi'ji'gu	0
葛藟虆於桂树兮	ge'lei'lei'yu'gui'shu'xi	0
革孽夏民	ge'nie'xia'min	0
各兴心而嫉妒	ge'xing'xin'er'ji'du	0
各有所错兮	ge'you'suo'cuo'xi	0
梗其有理兮	geng'qi'you'li'xi	0
更统世而自贶	geng'tong'shi'er'zi'kuang	0
耿吾既得此中正	geng'wu'ji'de'ci'zhong'zheng	0
更壹志兮	geng'yi'zhi'xi	0
功不成而无嶜	gong'bu'cheng'er'wu'jin	0
躬纯粹而罔愆兮	gong'chun'cui'er'wang'qian'xi	0
躬获愆而结难	gong'huo'qian'er'jie'nan	0
躬劬劳而瘏悴	gong'qu'lao'er'tu'cui	0
躬速速其不吾亲	gong'su'su'qi'bu'wu'qin	0
宫庭震惊	gong'ting'zhen'jing	0
工祝招君	gong'zhu'zhao'jun	0
苟得列乎众芳	gou'de'lie'hu'zhong'fang	0
苟得用此下土	gou'de'yong'ci'xia'tu	0
构桂木而为室	gou'gui'mu'er'wei'shi	0
鉤绳用而异态	gou'sheng'yong'er'yi'tai	0
彀天弧兮射奸	gou'tian'hu'xi'she'jian	0
苟余情其信芳	gou'yu'qing'qi'xin'fang	0
苟余情其信姱以练要兮	gou'yu'qing'qi'xin'kua'yi'lian'yao'xi	0
苟余心其端直兮	gou'yu'xin'qi'duan'zhi'xi	0
苟中情其好修兮	gou'zhong'qing'qi'hao'xiu'xi	0
孤雌惊兮鸣呴呴	gu'ci'jing'xi'ming'xu'xu	0
孤雌吟於高墉兮	gu'ci'yin'yu'gao'yong'xi	0
鼓刀扬声	gu'dao'yang'sheng	0
固烦言不可结诒兮	gu'fan'yan'bu'ke'jie'yi'xi	0
固非众人之所识	gu'fei'zhong'ren'zhi'suo'shi	0
故高枕而自適	gu'gao'zhen'er'zi'shi	0
古固有不并兮	gu'gu'you'bu'bing'xi	0
孤寡存只	gu'gua'cun'zhi	0
固将愁苦而终穷	gu'jiang'chou'ku'er'zhong'qiong	0
固将重昏而终身	gu'jiang'zhong'hun'er'zhong'shen	0
汩沮南土	gu'ju'nan'tu	0
故驹跳而远去	gu'ju'tiao'er'yuan'qu	0
故叩宫而宫应兮	gu'kou'gong'er'gong'ying'xi	0
顾列孛兮缥缥	gu'lie'bei'xi'piao'piao	0
顾林兮忽荒	gu'lin'xi'hu'huang	0
顾龙门而不见	gu'long'men'er'bu'jian	0
固乱流其鲜终兮	gu'luan'liu'qi'xian'zhong'xi	0
顾念兮旧都	gu'nian'xi'jiu'du	0
顾仆夫之憔悴	gu'pu'fu'zhi'qiao'cui	0
固前圣之所厚	gu'qian'sheng'zhi'suo'hou	0
固前修以菹醢	gu'qian'xiu'yi'zu'hai	0
固切人之不媚兮	gu'qie'ren'zhi'bu'mei'xi	0
顾屈节以从流兮	gu'qu'jie'yi'cong'liu'xi	0
固人命兮有当	gu'ren'ming'xi'you'dang	0
故人疏而日忘兮	gu'ren'shu'er'ri'wang'xi	0
固儃回而不息	gu'shan'hui'er'bu'xi	0
孤圣特而易伤	gu'sheng'te'er'yi'shang	0
固时俗之工巧兮	gu'shi'su'zhi'gong'qiao'xi	0
固时俗之溷浊兮	gu'shi'su'zhi'hun'zhuo'xi	0
固时俗之流从兮	gu'shi'su'zhi'liu'cong'xi	0
故荼荠不同亩兮	gu'tu'ji'bu'tong'mu'xi	0
故退伏於末庭	gu'tui'fu'yu'mo'ting	0
瞽谓之不明	gu'wei'zhi'bu'ming	0
顾我指兮从左	gu'wo'zhi'xi'cong'zuo	0
固陿腹而不得息	gu'xia'fu'er'bu'de'xi	0
故相臣莫若君兮	gu'xiang'chen'mo'ruo'jun'xi	0
鼓枻而去	gu'xie'er'qu	0
固庸态也	gu'yong'tai'ye	0
顾游心兮鄗酆	gu'you'xin'xi'hao'feng	0
故远闻而难亏	gu'yuan'wen'er'nan'kui	0
故矰缴而不能加	gu'zeng'jiao'er'bu'neng'jia	0
顾瞻郢路终不返兮	gu'zhan'ying'lu'zhong'bu'fan'xi	0
顾章华兮太息	gu'zhang'hua'xi'tai'xi	0
固朕形之不服兮	gu'zhen'xing'zhi'bu'fu'xi	0
固众芳之所在	gu'zhong'fang'zhi'suo'zai	0
故众口其铄金兮	gu'zhong'kou'qi'shuo'jin'xi	0
故重著以自明	gu'zhong'zhu'yi'zi'ming	0
孤子吟而抆泪兮	gu'zi'yin'er'wen'lei'xi	0
卦发字曰灵均	gua'fa'zi'yue'ling'jun	0
挂曲琼些	gua'qu'qiong'xie	0
贯薜荔之落蕊	guan'bi'li'zhi'luo'rui	0
冠崔嵬而切云兮	guan'cui'wei'er'qie'yun'xi	0
观道兮从横	guan'dao'xi'cong'heng	0
观浮石兮崔嵬	guan'fu'shi'xi'cui'wei	0
冠浮云之峨峨	guan'fu'yun'zhi'e'e	0
贯澒濛以东朅兮	guan'hong'meng'yi'dong'qie'xi	0
观江河之纡曲兮	guan'jiang'he'zhi'yu'qu'xi	0
冠屦兮共絇	guan'ju'xi'gong'qu	0
观绝霤只	guan'jue'liu'zhi	0
关梁闭而不通	guan'liang'bi'er'bu'tong	0
观流水兮潺湲	guan'liu'shui'xi'chan'yuan	0
观南人之变态	guan'nan'ren'zhi'bian'tai	0
冠切云之崔嵬	guan'qie'yun'zhi'cui'wei	0
管束缚兮桎梏	guan'shu'fu'xi'zhi'gu	0
观天火之炎炀兮	guan'tian'huo'zhi'yan'yang'xi	0
莞芎弃於泽洲兮	guan'xiong'qi'yu'ze'zhou'xi	0
观炎气之相仍兮	guan'yan'qi'zhi'xiang'reng'xi	0
观幽云兮陈浮	guan'you'yun'xi'chen'fu	0
贯鱼眼与珠玑	guan'yu'yan'yu'zhu'ji	0
观者憺兮忘归	guan'zhe'dan'xi'wang'gui	0
观中宇兮浩浩	guan'zhong'yu'xi'hao'hao	0
广大无所极些	guang'da'wu'suo'ji'xie	0
光风转蕙	guang'feng'zhuan'hui	0
光明齐於日月兮	guang'ming'qi'yu'ri'yue'xi	0
广遂前画兮	guang'sui'qian'hua'xi	0
龟策诚不能知事	gui'ce'cheng'bu'neng'zhi'shi	0
贵宠沙劘	gui'chong'sha'mo	0
桂栋兮兰橑	gui'dong'xi'lan'lao	0
桂蠹不知所淹留兮	gui'du'bu'zhi'suo'yan'liu'xi	0
归反故室	gui'fan'gu'shi	0
跪敷衽以陈辞兮	gui'fu'ren'yi'chen'ci'xi	0
归骸旧邦莫谁语兮	gui'hai'jiu'bang'mo'shui'yu'xi	0
归何忧	gui'he'you	0
鬼火兮荧荧	gui'huo'xi'ying'ying	0
归来归来	gui'lai'gui'lai	0
桂树列兮纷敷	gui'shu'lie'xi'fen'fu	0
桂水兮潺湲	gui'shui'xi'chan'yuan	0
归雁兮于征	gui'yan'xi'yu'zheng	0
桂棹兮兰枻	gui'zhao'xi'lan'xie	0
贵真人之休德兮	gui'zhen'ren'zhi'xiu'de'xi	0
闺中既以邃远兮	gui'zhong'ji'yi'sui'yuan'xi	0
鲧功用而不就	gun'gong'yong'er'bu'jiu	0
鲧何所营	gun'he'suo'ying	0
鲧何听焉	gun'he'ting'yan	0
鲧婞直以亡身兮	gun'xing'zhi'yi'wang'shen'xi	0
过鲍肆而失香	guo'bao'si'er'shi'xiang	0
国富强而法立兮	guo'fu'qiang'er'fa'li'xi	0
过桂车兮合黎	guo'gui'che'xi'he'li	0
国家为只	guo'jia'wei'zhi	0
国殇操吾戈兮披犀甲	guo'shang'cao'wu'ge'xi'pi'xi'jia	0
过万首兮嶷嶷	guo'wan'shou'xi'yi'yi	0
国无人莫我知兮	guo'wu'ren'mo'wo'zhi'xi	0
过夏首而西浮兮	guo'xia'shou'er'xi'fu'xi	0
国有骥而不知乘兮	guo'you'ji'er'bu'zhi'cheng'xi	0
还顾高丘泣如洒兮	hai'gu'gao'qiu'qi'ru'sa'xi	0
还顾睠睠	hai'gu'juan'juan	0
还顾世俗兮	hai'gu'shi'su'xi	0
还及君之无恙	hai'ji'jun'zhi'wu'yang	0
醢豕苦狗	hai'shi'ku'gou	0
还余车於南郢兮	hai'yu'che'yu'nan'ying'xi	0
含沆瀣以长生	han'hang'xie'yi'chang'sheng	0
寒凝凝只	han'ning'ning'zhi	0
含素水而蒙深兮	han'su'shui'er'meng'shen'xi	0
韩信蒙於介胄兮	han'xin'meng'yu'jie'zhou'xi	0
含忧强老兮愁无乐	han'you'qiang'lao'xi'chou'wu'le	0
好蔽美而称恶	hao'bi'mei'er'cheng'e	0
好蔽美而嫉妒	hao'bi'mei'er'ji'du	0
好夫人之忼慨	hao'fu'ren'zhi'kang'kai	0
好夫人之慷慨	hao'fu'ren'zhi'kang'kai	0
好桂树之冬荣	hao'gui'shu'zhi'dong'rong	0
浩浩沅湘	hao'hao'yuan'xiang	0
豪傑执政	hao'jie'zhi'zheng	0
好姱佳丽兮	hao'kua'jia'li'xi	0
好遗风之激楚	hao'yi'feng'zhi'ji'chu	0
合百草兮实庭	he'bai'cao'xi'shi'ting	0
何百姓之震愆	he'bai'xing'zhi'zhen'qian	0
和抱璞而泣血兮	he'bao'pu'er'qi'xue'xi	0
何本何化	he'ben'he'hua	0
何变化以作诈	he'bian'hua'yi'zuo'zha	0
何变易之可为	he'bian'yi'zhi'ke'wei	0
河伯兮开门	he'bo'xi'kai'men	0
河伯与女游兮九河	he'bo'yu'nv'you'xi'jiu'he	0
何不变此志也	he'bu'bian'ci'zhi'ye	0
何不餔其糟而歠其酾	he'bu'bu'qi'zao'er'chuo'qi'shi	0
何不改乎此度	he'bu'gai'hu'ci'du	0
何不淈其泥而扬其波	he'bu'gu'qi'ni'er'yang'qi'bo	0
何不课而行之	he'bu'ke'er'xing'zhi	0
何曾华之无实兮	he'ceng'hua'zhi'wu'shi'xi	0
何承谋夏桀	he'cheng'mou'xia'jie	0
何楚国兮难化	he'chu'guo'xi'nan'hua	0
和楚酪只	he'chu'lao'zhi	0
和楚沥只	he'chu'li'zhi	0
何道取之	he'dao'qu'zhi	0
何颠易厥首	he'dian'yi'jue'shou	0
和调度以自娱兮	he'diao'du'yi'zi'yu'xi	0
何独乐斯之蹇蹇兮	he'du'le'si'zhi'jian'jian'xi	0
何恶辅弼	he'e'fu'bi	0
何罚何佑	he'fa'he'you	0
何氾滥之浮云兮	he'fan'lan'zhi'fu'yun'xi	0
何繁鸟萃棘	he'fan'niao'cui'ji	0
何芳草之早殀兮	he'fang'cao'zhi'zao'yao'xi	0
何方圜之能周兮	he'fang'huan'zhi'neng'zhou'xi	0
何逢长之	he'feng'chang'zhi	0
何冯弓挟矢	he'feng'gong'xie'shi	0
何感天抑坠	he'gan'tian'yi'zhui	0
何故深思高举	he'gu'shen'si'gao'ju	0
何故兮久留	he'gu'xi'jiu'liu	0
何故至於斯	he'gu'zhi'yu'si	0
河海应龙	he'hai'ying'long	0
何号于市	he'hao'yu'shi	0
何阖而晦	he'he'er'hui	0
何后益作革	he'hou'yi'zuo'ge	0
何环穿自闾社丘陵	he'huan'chuan'zi'lv'she'qiu'ling	0
何回极之浮浮	he'hui'ji'zhi'fu'fu	0
何晦明之若岁	he'hui'ming'zhi'ruo'sui	0
何毁誉之昧昧	he'hui'yu'zhi'mei'mei	0
何践吾期	he'jian'wu'qi	0
盍将把兮琼芳	he'jiang'ba'xi'qiong'fang	0
何桀纣之昌披兮	he'jie'zhou'zhi'chang'pi'xi	0
何尽何历	he'jin'he'li	0
何君臣之相失兮	he'jun'chen'zhi'xiang'shi'xi	0
何开而明	he'kai'er'ming	0
何况一国之事兮	he'kuang'yi'guo'zhi'shi'xi	0
何离心之可同兮	he'li'xin'zhi'ke'tong'xi	0
何令彻彼岐社	he'ling'che'bi'qi'she	0
何灵魂之信直兮	he'ling'hun'zhi'xin'zhi'xi	0
何能依	he'neng'yi	0
何乞彼小臣	he'qi'bi'xiao'chen	0
曷其不舒予情	he'qi'bu'shu'yu'qing	0
何气通焉	he'qi'tong'yan	0
何启惟忧	he'qi'wei'you	0
何亲就上帝罚	he'qin'jiu'shang'di'fa	0
何亲揆发	he'qin'kui'fa	0
何勤子屠母	he'qin'zi'tu'mu	0
何青云之流澜兮	he'qing'yun'zhi'liu'lan'xi	0
何琼佩之偃蹇兮	he'qiong'pei'zhi'yan'jian'xi	0
何求于嫂	he'qiu'yu'sao	0
何去何从	he'qu'he'cong	0
何权衡之能称	he'quan'heng'zhi'neng'cheng	0
何日夜而忘之	he'ri'ye'er'wang'zhi	0
何骚骚而自故	he'sao'sao'er'zi'gu	0
何山石之崭岩兮	he'shan'shi'zhi'zhan'yan'xi	0
何少康逐犬	he'shao'kang'zhu'quan	0
何圣人之一德	he'sheng'ren'zhi'yi'de	0
何试上自予	he'shi'shang'zi'yu	0
何时俗之工巧兮	he'shi'su'zhi'gong'qiao'xi	0
何兽能言	he'shou'neng'yan	0
何寿夭兮在予	he'shou'yao'xi'zai'yu	0
河水淫淫情所原兮	he'shui'yin'yin'qing'suo'yuan'xi	0
何肆犬豕	he'si'quan'shi	0
和酸若苦	he'suan'ruo'ku	0
何所不死	he'suo'bu'si	0
何所得焉	he'suo'de'yan	0
何所冬暖	he'suo'dong'nuan	0
何所独无芳草兮	he'suo'du'wu'fang'cao'xi	0
何所急	he'suo'ji	0
何所讥	he'suo'ji	0
何所夏寒	he'suo'xia'han	0
何所悒	he'suo'yi	0
何所意焉	he'suo'yi'yan	0
何所忧之多方	he'suo'you'zhi'duo'fang	0
何条放致罚	he'tiao'fang'zhi'fa	0
何往营班禄	he'wang'ying'ban'lu	0
何为乎四方些	he'wei'hu'si'fang'xie	0
合五岳与八灵兮	he'wu'yue'yu'ba'ling'xi	0
何昔日之芳草兮	he'xi'ri'zhi'fang'cao'xi	0
何险巇之嫉妒兮	he'xian'xi'zhi'ji'du'xi	0
何献蒸肉之膏	he'xian'zheng'rou'zhi'gao	0
何续初继业	he'xu'chu'ji'ye	0
何须臾而忘反	he'xu'yu'er'wang'fan	0
何以安之	he'yi'an'zhi	0
何以窴之	he'yi'dian'zhi	0
何以肥之	he'yi'fei'zhi	0
何以坟之	he'yi'fen'zhi	0
何以厚之	he'yi'hou'zhi	0
何以怀之	he'yi'huai'zhi	0
何以将之	he'yi'jiang'zhi	0
何以识之	he'yi'shi'zhi	0
荷衣兮蕙带	he'yi'xi'hui'dai	0
何以兴之	he'yi'xing'zhi	0
何以行之	he'yi'xing'zhi	0
何以膺之	he'yi'ying'zhi	0
何羿之射革	he'yi'zhi'she'ge	0
何忧	he'you	0
何由并投	he'you'bing'tou	0
何由考之	he'you'kao'zhi	0
何远为些	he'yuan'wei'xie	0
何云贤士之不处	he'yun'xian'shi'zhi'bu'chu	0
何贞臣之无罪兮	he'zhen'chen'zhi'wu'zui'xi	0
和致芳只	he'zhi'fang'zhi	0
何之迁之	he'zhi'qian'zhi	0
何周道之平易兮	he'zhou'dao'zhi'ping'yi'xi	0
何周之命以咨嗟	he'zhou'zhi'ming'yi'zi'jie	0
何壮武历	he'zhuang'wu'li	0
何卒官汤	he'zu'guan'tang	0
黑水玄趾	hei'shui'xuan'zhi	0
恨离予之故乡	hen'li'yu'zhi'gu'xiang	0
恨其失时而无当	hen'qi'shi'shi'er'wu'dang	0
恨申子之沉江	hen'shen'zi'zhi'chen'jiang	0
恆秉季德	heng'bing'ji'de	0
横垂涕兮泫流	heng'chui'ti'xi'xuan'liu	0
横大江兮扬灵	heng'da'jiang'xi'yang'ling	0
横而不流兮	heng'er'bu'liu'xi	0
横飞谷以南征	heng'fei'gu'yi'nan'zheng	0
横流涕兮潺湲	heng'liu'ti'xi'chan'yuan	0
横汨罗而下历	heng'mi'luo'er'xia'li	0
横四海兮焉穷	heng'si'hai'xi'yan'qiong	0
横邪世而不取容	heng'xie'shi'er'bu'qu'rong	0
蘅芷彫兮莹嫇	heng'zhi'diao'xi'ying'ming	0
横舟航而济湘兮	heng'zhou'hang'er'ji'xiang'xi	0
红壁沙版	hong'bi'sha'ban	0
红采兮骍衣	hong'cai'xi'xing'yi	0
鸿鹄代游	hong'hu'dai'you	0
鸿鸕兮振翅	hong'lu'xi'zhen'chi	0
虹霓纷其朝霞兮	hong'ni'fen'qi'zhao'xia'xi	0
洪泉极深	hong'quan'ji'shen	0
鸿溶溢而滔荡	hong'rong'yi'er'tao'dang	0
鸿永路有嘉名	hong'yong'lu'you'jia'ming	0
后帝是飨	hou'di'shi'xiang	0
後飞廉使奔属	hou'fei'lian'shi'ben'shu	0
后何怒	hou'he'nu	0
后何喜	hou'he'xi	0
後尚可以竄藏	hou'shang'ke'yi'cuan'cang	0
後属青蛇	hou'shu'qing'she	0
后听虚而黜实兮	hou'ting'xu'er'chu'shi'xi	0
后土持其久	hou'tu'chi'qi'jiu	0
后土何时而得漧	hou'tu'he'shi'er'de'gan	0
後文昌使掌行兮	hou'wen'chang'shi'zhang'xing'xi	0
后辛之菹醢兮	hou'xin'zhi'zu'hai'xi	0
後兹承辅	hou'zi'cheng'fu	0
後辎乘之从从	hou'zi'cheng'zhi'cong'cong	0
忽翱翔之焉薄	hu'ao'xiang'zhi'yan'bo	0
虎豹斗兮熊罴咆	hu'bao'dou'xi'xiong'pi'pao	0
虎豹九关	hu'bao'jiu'guan	0
虎豹蜿只	hu'bao'wan'zhi	0
虎豹穴	hu'bao'xue	0
忽奔走以先後兮	hu'ben'zou'yi'xian'hou'xi	0
忽飙腾兮浮云	hu'biao'teng'xi'fu'yun	0
忽驰骛以追逐兮	hu'chi'wu'yi'zhui'zhu'xi	0
鹄竄兮枳棘	hu'cuan'xi'zhi'ji	0
忽独与余兮目成	hu'du'yu'yu'xi'mu'cheng	0
忽反顾兮西囿	hu'fan'gu'xi'xi'you	0
忽反顾以流涕兮	hu'fan'gu'yi'liu'ti'xi	0
忽反顾以游目兮	hu'fan'gu'yi'you'mu'xi	0
户服艾以盈要兮	hu'fu'ai'yi'ying'yao'xi	0
弧弓弛而不张兮	hu'gong'chi'er'bu'zhang'xi	0
忽乎吾将行	hu'hu'wu'jiang'xing	0
忽乎吾将行兮	hu'hu'wu'jiang'xing'xi	0
扈江离与辟芷兮	hu'jiang'li'yu'pi'zhi'xi	0
忽烂漫而无成	hu'lan'man'er'wu'cheng	0
狐狸兮徾徾	hu'li'xi'mei'mei	0
忽临睨夫旧乡	hu'lin'ni'fu'jiu'xiang	0
嫮目宜笑	hu'mu'yi'xiao	0
忽倾寤以婵媛	hu'qing'wu'yi'chan'yuan	0
忽容容其安之兮	hu'rong'rong'qi'an'zhi'xi	0
忽若去不信兮	hu'ruo'qu'bu'xin'xi	0
胡射夫河伯	hu'she'fu'he'bo	0
忽神奔而鬼怪	hu'shen'ben'er'gui'guai	0
狐死必首丘	hu'si'bi'shou'qiu	0
狐死必首丘兮	hu'si'bi'shou'qiu'xi	0
虎兕争兮於廷中	hu'si'zheng'xi'yu'ting'zhong	0
鹄酸臇凫	hu'suan'juan'fu	0
扈屯骑之容容	hu'tun'qi'zhi'rong'rong	0
忽忘身之贱贫	hu'wang'shen'zhi'jian'pin	0
胡为此堂	hu'wei'ci'tang	0
忽纬繣其难迁	hu'wei'hua'qi'nan'qian	0
胡为嗜不同味	hu'wei'shi'bu'tong'wei	0
忽谓之过言	hu'wei'zhi'guo'yan	0
呼五白些	hu'wu'bai'xie	0
忽吾行此流沙兮	hu'wu'xing'ci'liu'sha'xi	0
虎啸而谷风至兮	hu'xiao'er'gu'feng'zhi'xi	0
嫭以姱只	hu'yi'kua'zhi	0
胡终弊于有扈	hu'zhong'bi'yu'you'hu	0
华采衣兮若英	hua'cai'yi'xi'ruo'ying	0
华镫错些	hua'deng'cuo'xie	0
画龙蛇些	hua'long'she'xie	0
华容备些	hua'rong'bei'xie	0
化为黄熊	hua'wei'huang'xiong	0
华酌既陈	hua'zhuo'ji'chen	0
坏败罔罗	huai'bai'wang'luo	0
怀德兮何睹	huai'de'xi'he'du	0
怀芬香而挟蕙兮	huai'fen'xiang'er'xie'hui'xi	0
怀恨兮艰难	huai'hen'xi'jian'nan	0
怀计谋而不见用兮	huai'ji'mou'er'bu'jian'yong'xi	0
怀椒聊之蔎蔎兮	huai'jiao'liao'zhi'she'she'xi	0
怀椒糈而要之	huai'jiao'xu'er'yao'zhi	0
怀瑾握瑜兮	huai'jin'wo'yu'xi	0
怀兰茝之芬芳兮	huai'lan'chai'zhi'fen'fang'xi	0
怀兰蕙与衡芷兮	huai'lan'hui'yu'heng'zhi'xi	0
怀兰英兮把琼若	huai'lan'ying'xi'ba'qiong'ruo	0
怀沙砾而自沉兮	huai'sha'li'er'zi'chen'xi	0
怀沙滔滔孟夏兮	huai'sha'tao'tao'meng'xia'xi	0
怀琬琰以为心	huai'wan'yan'yi'wei'xin	0
怀琬琰之华英	huai'wan'yan'zhi'hua'ying	0
怀我兮圣京	huai'wo'xi'sheng'jing	0
怀信侘傺	huai'xin'cha'chi	0
怀瑶象而佩琼兮	huai'yao'xiang'er'pei'qiong'xi	0
怀隐忧而历兹	huai'yin'you'er'li'zi	0
怀忧含戚何侘傺兮	huai'you'han'qi'he'cha'chi'xi	0
怀朕情而不发兮	huai'zhen'qing'er'bu'fa'xi	0
怀质抱青	huai'zhi'bao'qing	0
絙洞房些	huan'dong'fang'xie	0
桓公闻而弗置	huan'gong'wen'er'fu'zhi	0
桓公闻而知之	huan'gong'wen'er'zhi'zhi	0
环理天下	huan'li'tian'xia	0
絙瑟兮交鼓	huan'se'xi'jiao'gu	0
雚苇兮仟眠	huan'wei'xi'qian'mian	0
圜凿而方枘兮	huan'zao'er'fang'rui'xi	0
圜则九重	huan'ze'jiu'chong	0
黄鹄後时而寄处兮	huang'hu'hou'shi'er'ji'chu'xi	0
荒忽兮远望	huang'hu'xi'yuan'wang	0
黄鹄之一举兮	huang'hu'zhi'yi'ju'xi	0
黄昏以为期	huang'hun'yi'wei'qi	0
惶悸兮失气	huang'ji'xi'shi'qi	0
皇览揆余初度兮	huang'lan'kui'yu'chu'du'xi	0
皇门开兮照下土	huang'men'kai'xi'zhao'xia'tu	0
皇剡剡其扬灵兮	huang'shan'shan'qi'yang'ling'xi	0
璜台十成	huang'tai'shi'cheng	0
皇天保其高兮	huang'tian'bao'qi'gao'xi	0
皇天既不纯命兮	huang'tian'ji'bu'chun'ming'xi	0
皇天集命	huang'tian'ji'ming	0
皇天平分四时兮	huang'tian'ping'fen'si'shi'xi	0
皇天无私阿兮	huang'tian'wu'si'a'xi	0
皇天淫溢而秋霖兮	huang'tian'yin'yi'er'qiu'lin'xi	0
皇舆覆以幽辟	huang'yu'fu'yi'you'pi	0
黄钟毁弃	huang'zhong'hui'qi	0
会晁争盟	hui'chao'zheng'meng	0
蟪蛄鸣兮啾啾	hui'gu'ming'xi'jiu'jiu	0
麾蛟龙使梁津兮	hui'jiao'long'shi'liang'jin'xi	0
晦冥冥而壅蔽	hui'ming'ming'er'yong'bi	0
惠气安在	hui'qi'an'zai	0
悔相道之不察兮	hui'xiang'dao'zhi'bu'cha'xi	0
回湘沅而远迁	hui'xiang'yuan'er'yuan'qian	0
回邪辟而不能入兮	hui'xie'pi'er'bu'neng'ru'xi	0
蕙肴蒸兮兰藉	hui'yao'zheng'xi'lan'ji	0
回朕车俾西引兮	hui'zhen'che'bi'xi'yin'xi	0
回朕车以复路兮	hui'zhen'che'yi'fu'lu'xi	0
魂长逝而常愁	hun'chang'shi'er'chang'chou	0
魂俇俇而南行兮	hun'guang'guang'er'nan'xing'xi	0
魂乎归徠	hun'hu'gui'lai	0
魂乎徠归	hun'hu'lai'gui	0
魂乎无北	hun'hu'wu'bei	0
魂乎无东	hun'hu'wu'dong	0
魂乎无南	hun'hu'wu'nan	0
魂乎无往	hun'hu'wu'wang	0
魂乎无西	hun'hu'wu'xi	0
魂魂离散	hun'hun'li'san	0
魂眷眷而独逝	hun'juan'juan'er'du'shi	0
魂迷惑而不知路	hun'mi'huo'er'bu'zhi'lu	0
魂眇眇而驰骋兮	hun'miao'miao'er'chi'cheng'xi	0
魂魄归徠	hun'po'gui'lai	0
魂魄毅兮为鬼雄	hun'po'yi'xi'wei'gui'xiong	0
魂悽怆兮感哀	hun'qi'chuang'xi'gan'ai	0
魂茕茕兮不遑寐	hun'qiong'qiong'xi'bu'huang'mei	0
魂识路之营营	hun'shi'lu'zhi'ying'ying	0
魂往必释些	hun'wang'bi'shi'xie	0
昏微遵迹	hun'wei'zun'ji	0
魂无逃只	hun'wu'tao'zhi	0
魂兮归徠	hun'xi'gui'lai	0
魂兮归来	hun'xi'gui'lai	0
魂一夕而九逝	hun'yi'xi'er'jiu'shi	0
魂营营而至曙	hun'ying'ying'er'zhi'shu	0
溷湛湛而日多	hun'zhan'zhan'er'ri'duo	0
魂聇聇以寄独兮	hun'zheng'zheng'yi'ji'du'xi	0
魂中道而无杭	hun'zhong'dao'er'wu'hang	0
或沉其无所达兮	huo'chen'qi'wu'suo'da'xi	0
或黕点而汙之	huo'dan'dian'er'wu'zhi	0
或訑谩而不疑	huo'dan'man'er'bu'yi	0
或清激其无所通	huo'qing'ji'qi'wu'suo'tong	0
或偷合而苟进兮	huo'tou'he'er'gou'jin'xi	0
或推迻而苟容兮	huo'tui'yi'er'gou'rong'xi	0
或隐居而深藏	huo'yin'ju'er'shen'cang	0
或直言之谔谔	huo'zhi'yan'zhi'e'e	0
或忠信而死节兮	huo'zhong'xin'er'si'jie'xi	0
骥不骤进而求服兮	ji'bu'zhou'jin'er'qiu'fu'xi	0
疾憯怛而萌生	ji'can'da'er'meng'sheng	0
集重阳入帝宫兮	ji'chong'yang'ru'di'gong'xi	0
骥踌躇於弊輂兮	ji'chou'chu'yu'bi'ju'xi	0
激楚之结	ji'chu'zhi'jie	0
击床先出	ji'chuang'xian'chu	0
骥垂两耳兮	ji'chui'liang'er'xi	0
疾风过之汤汤	ji'feng'guo'zhi'shang'shang	0
集芙蓉以为裳	ji'fu'rong'yi'wei'shang	0
既干进而务入兮	ji'gan'jin'er'wu'ru'xi	0
既含睇兮又宜笑	ji'han'di'xi'you'yi'xiao	0
济江海兮蝉蜕	ji'jiang'hai'xi'chan'tui	0
既骄美而伐武兮	ji'jiao'mei'er'fa'wu'xi	0
既惊帝切激	ji'jing'di'qie'ji	0
极劳心兮忡忡	ji'lao'xin'xi'chong'chong	0
蒺藜蔓乎东厢	ji'li'man'hu'dong'xiang	0
寂寥兮	ji'liao'xi	0
冀灵修之壹悟	ji'ling'xiu'zhi'yi'wu	0
羁旅而无友生	ji'lv'er'wu'you'sheng	0
既莫足与为美政兮	ji'mo'zu'yu'wei'mei'zheng'xi	0
及年岁之未晏兮	ji'nian'sui'zhi'wei'yan'xi	0
机蓬矢以射革	ji'peng'shi'yi'she'ge	0
忌嚭专兮郢吴虚	ji'pi'zhuan'xi'ying'wu'xu	0
楫齐扬以容与兮	ji'qi'yang'yi'rong'yu'xi	0
及前王之踵武	ji'qian'wang'zhi'zhong'wu	0
疾亲君而无他兮	ji'qin'jun'er'wu'ta'xi	0
既惸独而不群兮	ji'qiong'du'er'bu'qun'xi	0
及荣华之未落兮	ji'rong'hua'zhi'wei'luo'xi	0
罽蕠兮青艹总	ji'ru'xi'qing'ao'zong	0
及少康之未家兮	ji'shao'kang'zhi'wei'jia'xi	0
极声变只	ji'sheng'bian'zhi	0
寄生乎江潭	ji'sheng'hu'jiang'tan	0
疾世周徘徊兮汉渚	ji'shi'zhou'pai'huai'xi'han'zhu	0
既替余以蕙纕兮	ji'ti'yu'yi'hui'xiang'xi	0
即听夫人之谀辞	ji'ting'fu'ren'zhi'yu'ci	0
稷维元子	ji'wei'yuan'zi	0
鸡鹜满堂坛兮	ji'wu'man'tang'tan'xi	0
鸡鹜翔舞	ji'wu'xiang'wu	0
济湘流而南极	ji'xiang'liu'er'nan'ji	0
冀幸君之发矇	ji'xing'jun'zhi'fa'meng	0
及行迷之未远	ji'xing'mi'zhi'wei'yuan	0
骥焉程兮	ji'yan'cheng'xi	0
济杨舟於会稽兮	ji'yang'zhou'yu'kuai'ji'xi	0
冀壹反之何时	ji'yi'fan'zhi'he'shi	0
冀一见而复归	ji'yi'jian'er'fu'gui	0
冀壹寤而锡还	ji'yi'wu'er'xi'hai	0
继以兮微蔡	ji'yi'xi'wei'cai	0
及余饰之方壮兮	ji'yu'shi'zhi'fang'zhuang'xi	0
济沅湘以南征兮	ji'yuan'xiang'yi'nan'zheng'xi	0
暨志介而不忘	ji'zhi'jie'er'bu'wang	0
冀枝叶之峻茂兮	ji'zhi'ye'zhi'jun'mao'xi	0
继之以日夜	ji'zhi'yi'ri'ye	0
计专专之不可化兮	ji'zhuan'zhuan'zhi'bu'ke'hua'xi	0
箕子被发而佯狂	ji'zi'bei'fa'er'yang'kuang	0
箕子寤而佯狂	ji'zi'wu'er'yang'kuang	0
箕子详狂	ji'zi'xiang'kuang	0
既遵道而得路	ji'zun'dao'er'de'lu	0
驾八龙兮连蜷	jia'ba'long'xi'lian'quan	0
驾八龙之婉婉兮	jia'ba'long'zhi'wan'wan'xi	0
驾飞龙兮北征	jia'fei'long'xi'bei'zheng	0
嘉皇既殁终不返兮	jia'huang'ji'mo'zhong'bu'fan'xi	0
嘉己行兮无为	jia'ji'xing'xi'wu'wei	0
驾蹇驴而无策兮	jia'jian'lv'er'wu'ce'xi	0
驾两龙兮骖螭	jia'liang'long'xi'can'chi	0
驾龙辀兮乘雷	jia'long'zhou'xi'cheng'lei	0
驾鸾凤以上游兮	jia'luan'feng'yi'shang'you'xi	0
假寐兮愍斯	jia'mei'xi'min'si	0
嘉南州之炎德兮	jia'nan'zhou'zhi'yan'de'xi	0
驾青龙以驰骛兮	jia'qing'long'yi'chi'wu'xi	0
驾青虬兮骖白螭	jia'qing'qiu'xi'can'bai'chi	0
驾太一之象舆	jia'tai'yi'zhi'xiang'yu	0
驾玄螭兮北征	jia'xuan'chi'xi'bei'zheng	0
甲之晁吾以行	jia'zhi'chao'wu'yi'xing	0
见伯夷之放迹	jian'bo'yi'zhi'fang'ji	0
謇不可释也	jian'bu'ke'shi'ye	0
蹇侘傺而含慼	jian'cha'chi'er'han'qi	0
謇朝谇而夕替	jian'chao'sui'er'xi'ti	0
蹇超摇而无冀	jian'chao'yao'er'wu'ji	0
蹇充倔而无端兮	jian'chong'jue'er'wu'duan'xi	0
简狄在台喾何宜	jian'di'zai'tai'ku'he'yi	0
蹇独怀此异路	jian'du'huai'ci'yi'lu	0
建芳馨兮庑门	jian'fang'xin'xi'wu'men	0
渐槀本於洿渎	jian'gao'ben'yu'hu'du	0
见韩众而宿之兮	jian'han'zhong'er'su'zhi'xi	0
建虹采以招指	jian'hong'cai'yi'zhao'zhi	0
煎鸿鸧些	jian'hong'cang'xie	0
建虹旌兮威夷	jian'hong'jing'xi'wei'yi	0
建黄纁之总旄	jian'huang'xun'zhi'zong'mao	0
煎鰿膗雀	jian'ji'chuai'que	0
諓諓兮嗌喔	jian'jian'xi'ai'wo	0
蹇蹇之烦冤兮	jian'jian'zhi'fan'yuan'xi	0
菅蒯兮野莽	jian'kuai'xi'ye'mang	0
蹇离尤而干诟	jian'li'you'er'gan'gou	0
建烈业兮垂勋	jian'lie'ye'xi'chui'xun	0
剑淋离而从横	jian'lin'li'er'cong'heng	0
蹇驴服驾兮	jian'lv'fu'jia'xi	0
见南郢之流风兮	jian'nan'ying'zhi'liu'feng'xi	0
謇其有意些	jian'qi'you'yi'xie	0
肩倾侧而不容兮	jian'qing'ce'er'bu'rong'xi	0
建日月以为盖兮	jian'ri'yue'yi'wei'gai'xi	0
蹇骚骚而不释	jian'sao'sao'er'bu'shi	0
见盛德而後下	jian'sheng'de'er'hou'xia	0
蹇谁留兮中洲	jian'shui'liu'xi'zhong'zhou	0
见王子而宿之兮	jian'wang'zi'er'su'zhi'xi	0
謇吾法夫前修兮	jian'wu'fa'fu'qian'xiu'xi	0
蹇吾原兮	jian'wu'yuan'xi	0
建雄虹之采旄兮	jian'xiong'hong'zhi'cai'mao'xi	0
蹇淹留而踌躇	jian'yan'liu'er'chou'chu	0
蹇淹留而无成	jian'yan'liu'er'wu'cheng	0
见鄢郢兮旧宇	jian'yan'ying'xi'jiu'yu	0
见有娀之佚女	jian'you'song'zhi'yi'nv	0
见怨门下	jian'yuan'men'xia	0
蹇邅徊而不能行	jian'zhan'huai'er'bu'neng'xing	0
坚志而不忍	jian'zhi'er'bu'ren	0
见执辔者非其人兮	jian'zhi'pei'zhe'fei'qi'ren'xi	0
将驰兮四荒	jiang'chi'xi'si'huang	0
将从俗富贵	jiang'cong'su'fu'gui	0
将氾氾若水中之凫乎	jiang'fan'fan'ruo'shui'zhong'zhi'fu'hu	0
将方舟而下流兮	jiang'fang'zhou'er'xia'liu'xi	0
将奋翼兮高飞	jiang'fen'yi'xi'gao'fei	0
江河广而无梁	jiang'he'guang'er'wu'liang	0
江河之畔无隐夫	jiang'he'zhi'pan'wu'yin'fu	0
江离弃於穷巷兮	jiang'li'qi'yu'qiong'xiang'xi	0
将离兮所思	jiang'li'xi'suo'si	0
江离兮遗捐	jiang'li'xi'yi'juan	0
将去君而高翔	jiang'qu'jun'er'gao'xiang	0
将去烝兮远游	jiang'qu'zheng'xi'yuan'you	0
将丧兮玉斗	jiang'sang'xi'yu'dou	0
将升兮高山	jiang'sheng'xi'gao'shan	0
降省下土四方	jiang'sheng'xia'tu'si'fang	0
将送往劳来	jiang'song'wang'lao'lai	0
将随驽马之迹乎	jiang'sui'nu'ma'zhi'ji'hu	0
将腾驾兮偕逝	jiang'teng'jia'xi'xie'shi	0
将突梯滑稽	jiang'tu'ti'hua'ji	0
降望大壑	jiang'wang'da'he	0
将往观乎四荒	jiang'wang'guan'hu'si'huang	0
将息兮兰皋	jiang'xi'xi'lan'gao	0
江湘油油长流汩兮	jiang'xiang'you'you'chang'liu'gu'xi	0
将兴鸡鹜争食乎	jiang'xing'ji'wu'zheng'shi'hu	0
将夭折兮碎糜	jiang'yao'zhe'xi'sui'mi	0
将以遗兮离居	jiang'yi'yi'xi'li'ju	0
将以遗兮下女	jiang'yi'yi'xi'xia'nv	0
将以遗兮远者	jiang'yi'yi'xi'yuan'zhe	0
将游大人	jiang'you'da'ren	0
江与夏之不可涉	jiang'yu'xia'zhi'bu'ke'she	0
将运舟而下浮兮	jiang'yun'zhou'er'xia'fu'xi	0
将谘询兮皇羲	jiang'zi'xun'xi'huang'xi	0
将哫訾栗斯	jiang'zu'zi'li'si	0
交不忠兮怨长	jiao'bu'zhong'xi'yuan'chang	0
椒桂罗以颠覆兮	jiao'gui'luo'yi'dian'fu'xi	0
蛟何为兮水裔	jiao'he'wei'xi'shui'yi	0
矫菌桂以纫蕙兮	jiao'jun'gui'yi'ren'hui'xi	0
姣丽施只	jiao'li'shi'zhi	0
蛟龙潜於旋渊兮	jiao'long'qian'yu'xuan'yuan'xi	0
蛟龙兮导引	jiao'long'xi'dao'yin	0
蛟龙隐其文章	jiao'long'yin'qi'wen'zhang	0
鹪明鸟开路兮	jiao'ming'niao'kai'lu'xi	0
浇身被服强圉兮	jiao'shen'bei'fu'qiang'yu'xi	0
角宿未旦	jiao'su'wei'dan	0
叫我友兮配耦	jiao'wo'you'xi'pei'ou	0
憍吾以其美好兮	jiao'wu'yi'qi'mei'hao'xi	0
矫以遗夫美人	jiao'yi'yi'fu'mei'ren	0
椒瑛兮湟汙	jiao'ying'xi'huang'wu	0
椒专佞以慢慆兮	jiao'zhuan'ning'yi'man'tao'xi	0
矫兹媚以私处兮	jiao'zi'mei'yi'si'chu'xi	0
解萹薄与杂菜兮	jie'bian'bo'yu'za'cai'xi	0
嗟此国兮无良	jie'ci'guo'xi'wu'liang	0
嗟尔幼志	jie'er'you'zhi	0
桀伐蒙山	jie'fa'meng'shan	0
借浮云以送予兮	jie'fu'yun'yi'song'yu'xi	0
借光景以往来兮	jie'guang'jing'yi'wang'lai'xi	0
皆归射鞠	jie'gui'she'ju	0
结桂树之旖旎兮	jie'gui'shu'zhi'yi'ni'xi	0
结桂枝兮延伫	jie'gui'zhi'xi'yan'zhu	0
嗟怀兮眩惑	jie'huai'xi'xuan'huo	0
接径千里	jie'jing'qian'li	0
戒六神与乡服	jie'liu'shen'yu'xiang'fu	0
介眇志之所惑兮	jie'miao'zhi'zhi'suo'huo'xi	0
解佩纕以结言兮	jie'pei'xiang'yi'jie'yan'xi	0
结琦璜些	jie'qi'huang'xie	0
结琼枝以杂佩兮	jie'qiong'zhi'yi'za'pei'xi	0
蝍蛆兮穰穰	jie'qu'xi'rang'rang	0
结荣茝兮逶逝	jie'rong'chai'xi'wei'shi	0
结微情以陈辞兮	jie'wei'qing'yi'chen'ci'xi	0
节行张而不著	jie'xing'zhang'er'bu'zhu	0
嗟英俊兮未为双	jie'ying'jun'xi'wei'wei'shuang	0
结幽兰而延儜	jie'you'lan'er'yan'ning	0
接舆髡首兮	jie'yu'kun'shou'xi	0
结余轸於西山兮	jie'yu'zhen'yu'xi'shan'xi	0
竭知尽忠	jie'zhi'jin'zhong	0
竭忠诚以事君兮	jie'zhong'cheng'yi'shi'jun'xi	0
结撰至思	jie'zhuan'zhi'si	0
介子推之隐山	jie'zi'tui'zhi'yin'shan	0
介子忠而立枯兮	jie'zi'zhong'er'li'ku'xi	0
今安所达乎吾志	jin'an'suo'da'hu'wu'zhi	0
进不入以离尤兮	jin'bu'ru'yi'li'you'xi	0
进恶兮九旬	jin'e'xi'jiu'xun	0
今反表以为里兮	jin'fan'biao'yi'wei'li'xi	0
进号呼又莫吾闻	jin'hao'hu'you'mo'wu'wen	0
谨厚以为丰	jin'hou'yi'wei'feng	0
禁苛暴只	jin'ke'bao'zhi	0
晋骊姬之反情	jin'li'ji'zhi'fan'qing	0
进瞵盼兮上丘墟	jin'lin'pan'xi'shang'qiu'xu	0
进路北次兮	jin'lu'bei'ci'xi	0
今其集兮惟鸮	jin'qi'ji'xi'wei'xiao	0
晋申生之离殃兮	jin'shen'sheng'zhi'li'yang'xi	0
晋申生之孝子兮	jin'shen'sheng'zhi'xiao'zi'xi	0
今谁使乎誉之	jin'shui'shi'hu'yu'zhi	0
堇荼茂兮扶疏	jin'tu'mao'xi'fu'shu	0
近習鸱枭	jin'xi'chi'xiao	0
晋献惑於孋姬兮	jin'xian'huo'yu'li'ji'xi	0
今逍遥而来东	jin'xiao'yao'er'lai'dong	0
进雄鸠之耿耿兮	jin'xiong'jiu'zhi'geng'geng'xi	0
今修饰而窥镜兮	jin'xiu'shi'er'kui'jing'xi	0
近禹麾只	jin'yu'hui'zhi	0
今直为此萧艾也	jin'zhi'wei'ci'xiao'ai'ye	0
晋制犀比	jin'zhi'xi'bi	0
今之相者兮举肥	jin'zhi'xiang'zhe'xi'ju'fei	0
旌蔽日兮敌若云	jing'bi'ri'xi'di'ruo'yun	0
精醇粹而始壮	jing'chun'cui'er'shi'zhuang	0
径岱土兮魏阙	jing'dai'tu'xi'wei'que	0
敬而无妨些	jing'er'wu'fang'xie	0
荆和氏之泣血	jing'he'shi'zhi'qi'xue	0
荆棘聚而成林	jing'ji'ju'er'cheng'lin	0
精皎皎以往来	jing'jiao'jiao'yi'wang'lai	0
俓娵觜兮直驰	jing'ju'zui'xi'zhi'chi	0
竞佞谀兮谗阋阋	jing'ning'yu'xi'chan'xi'xi	0
惊女采薇	jing'nv'cai'wei	0
静女歌兮微晨	jing'nv'ge'xi'wei'chen	0
精气入而粗秽除	jing'qi'ru'er'cu'hui'chu	0
精琼爢以为粻	jing'qiong'mi'yi'wei'zhang	0
精色内白	jing'se'nei'bai	0
经堂入奥	jing'tang'ru'ao	0
荆文寤而徐亡	jing'wen'wu'er'xu'wang	0
静閒安些	jing'xian'an'xie	0
鲸鱏兮幽潜	jing'xun'xi'you'qian	0
荆勋作师	jing'xun'zuo'shi	0
静以安只	jing'yi'an'zhi	0
径淫曀而道壅	jing'yin'yi'er'dao'yong	0
经营四荒兮	jing'ying'si'huang'xi	0
经营原野杳冥冥兮	jing'ying'yuan'ye'yao'ming'ming'xi	0
精越裂而衰耄	jing'yue'lie'er'shuai'mao	0
竞周容以为度	jing'zhou'rong'yi'wei'du	0
经浊世而不得志兮	jing'zhuo'shi'er'bu'de'zhi'xi	0
九辩悲哉	jiu'bian'bei'zai	0
九辨九歌	jiu'bian'jiu'ge	0
就重华而陈词	jiu'chong'hua'er'chen'ci	0
就传说兮骑龙	jiu'chuan'shuo'xi'qi'long	0
九歌	jiu'ge	0
九侯淑女	jiu'hou'shu'nv	0
九怀	jiu'huai	0
就灵怀之皇祖兮	jiu'ling'huai'zhi'huang'zu'xi	0
九年之中不吾反兮	jiu'nian'zhi'zhong'bu'wu'fan'xi	0
就申胥於五湖	jiu'shen'xu'yu'wu'hu	0
九思	jiu'si	0
糺思心以为纕兮	jiu'si'xin'yi'wei'xiang'xi	0
九叹	jiu'tan	0
九天之际	jiu'tian'zhi'ji	0
咎繇弃而在野外	jiu'yao'qi'er'zai'ye'wai	0
九疑缤其并迎	jiu'yi'bin'qi'bing'ying	0
九嶷缤兮并迎	jiu'yi'bin'xi'bing'ying	0
久余是胜	jiu'yu'shi'sheng	0
九章	jiu'zhang	0
九折臂而成医兮	jiu'zhe'bi'er'cheng'yi'xi	0
九州安错	jiu'zhou'an'cuo	0
就周文兮邠歧	jiu'zhou'wen'xi'bin'qi	0
就祝融兮稽疑	jiu'zhu'rong'xi'ji'yi	0
就颛顼而陈攵辞兮	jiu'zhuan'xu'er'chen'fan'ci'xi	0
钜宝迁兮砏礉	ju'bao'qian'xi'fen'he	0
居不乐以时思兮	ju'bu'le'yi'shi'si'xi	0
举长矢兮射天狼	ju'chang'shi'xi'she'tian'lang	0
居处愁以隐约兮	ju'chu'chou'yi'yin'yue'xi	0
举斗柄以为麾	ju'dou'bing'yi'wei'hui	0
匊芳椒兮成堂	ju'fang'jiao'xi'cheng'tang	0
举傑压陛	ju'jie'ya'bi	0
橘徠服兮	ju'lai'fu'xi	0
居嵺廓兮鲜畴	ju'liao'kuo'xi'xian'chou	0
举霓旌之墆翳兮	ju'ni'jing'zhi'zhi'yi'xi	0
惧年岁之既晏	ju'nian'sui'zhi'ji'yan	0
粔籹蜜饵	ju'nv'mi'er	0
居戚戚而不可解	ju'qi'qi'er'bu'ke'jie	0
据青冥而摅虹兮	ju'qing'ming'er'shu'hong'xi	0
居室定只	ju'shi'ding'zhi	0
举世皆然兮	ju'shi'jie'ran'xi	0
举世皆浊我独清	ju'shi'jie'zhuo'wo'du'qing	0
举世以为恆俗兮	ju'shi'yi'wei'heng'su'xi	0
遽爽存只	ju'shuang'cun'zhi	0
橘颂后皇嘉树	ju'song'hou'huang'jia'shu	0
举天罼兮掩邪	ju'tian'bi'xi'yan'xie	0
惧吾心兮懤懤	ju'wu'xin'xi'chou'chou	0
举贤才而授能兮	ju'xian'cai'er'shou'neng'xi	0
橘柚萎枯兮	ju'you'wei'ku'xi	0
遽傽遑兮驱林泽	ju'zhang'huang'xi'qu'lin'ze	0
捐赤瑾於中庭	juan'chi'jin'yu'zhong'ting	0
捐此兮夜光	juan'ci'xi'ye'guang	0
捐林薄而菀死	juan'lin'bo'er'wan'si	0
卷佩将逝兮	juan'pei'jiang'shi'xi	0
捐弃随和	juan'qi'sui'he	0
捐余玦兮江中	juan'yu'jue'xi'jiang'zhong	0
捐余袂兮江中	juan'yu'mei'xi'jiang'zhong	0
绝北梁兮永辞	jue'bei'liang'xi'yong'ci	0
厥大何如	jue'da'he'ru	0
绝都广以直指兮	jue'dou'guang'yi'zhi'zhi'xi	0
厥父是臧	jue'fu'shi'zang	0
绝国家之久长	jue'guo'jia'zhi'jiu'chang	0
绝横流而径逝	jue'heng'liu'er'jing'shi	0
绝洪范之辟纪	jue'hong'fan'zhi'pi'ji	0
厥利惟何	jue'li'wei'he	0
厥利维何	jue'li'wei'he	0
爵禄盛只	jue'lu'sheng'zhi	0
厥萌在初	jue'meng'zai'chu	0
掘荃蕙与射干兮	jue'quan'hui'yu'she'gan'xi	0
厥身是继	jue'shen'shi'ji	0
厥首用夫颠陨	jue'shou'yong'fu'dian'yun	0
厥严不奉	jue'yan'bu'feng	0
君不知兮可柰何	jun'bu'zhi'xi'ke'nai'he	0
菌阁兮蕙楼	jun'ge'xi'hui'lou	0
君乖差而屏之	jun'guai'cha'er'ping'zhi	0
君含怒而待臣兮	jun'han'nu'er'dai'chen'xi	0
君回翔兮以下	jun'hui'xiang'xi'yi'xia	0
君将何以教之	jun'jiang'he'yi'jiao'zhi	0
箟簬杂於黀蒸兮	jun'lu'za'yu'zou'zheng'xi	0
君弃远而不察兮	jun'qi'yuan'er'bu'cha'xi	0
君谁须兮云之际	jun'shui'xu'xi'yun'zhi'ji	0
君思我兮不得閒	jun'si'wo'xi'bu'de'xian	0
君思我兮然疑作	jun'si'wo'xi'ran'yi'zuo	0
君王亲发兮	jun'wang'qin'fa'xi	0
君罔谓女何之	jun'wang'wei'nv'he'zhi	0
君无度而弗察兮	jun'wu'du'er'fu'cha'xi	0
君无上天些	jun'wu'shang'tian'xie	0
君无下此幽都些	jun'wu'xia'ci'you'dou'xie	0
君欣欣兮乐康	jun'xin'xin'xi'le'kang	0
鵕鸃栖兮柴蔟	jun'yi'qi'xi'chai'cu	0
君之门以九重	jun'zhi'men'yi'jiu'chong	0
君之心兮与余异	jun'zhi'xin'xi'yu'yu'yi	0
君子所鄙	jun'zi'suo'bi	0
开春发岁兮	kai'chun'fa'sui'xi	0
槛层轩些	kan'ceng'xuan'xie	0
欿愁悴而委惰兮	kan'chou'cui'er'wei'duo'xi	0
坎廪兮	kan'lin'xi	0
康回冯怒	kang'hui'feng'nu	0
慷慨绝兮不得	kang'kai'jue'xi'bu'de	0
考玄冥於空桑	kao'xuan'ming'yu'kong'sang	0
溘埃风余上征	ke'ai'feng'yu'shang'zheng	0
柯仿佛而萎黄	ke'fang'fu'er'wei'huang	0
刻方连些	ke'fang'lian'xie	0
课後先	ke'hou'xian	0
可师长兮	ke'shi'zhang'xi	0
溘吾游此春宫兮	ke'wu'you'ci'chun'gong'xi	0
可以濯吾缨	ke'yi'zhuo'wu'ying	0
可以濯吾足	ke'yi'zhuo'wu'zu	0
刻著志之无適	ke'zhu'zhi'zhi'wu'shi	0
铿锺摇虡	keng'zhong'yao'ju	0
恐不终乎永年	kong'bu'zhong'hu'yong'nian	0
恐操行之不调	kong'cao'xing'zhi'bu'tiao	0
恐导言之不固	kong'dao'yan'zhi'bu'gu	0
恐登阶之逢殆兮	kong'deng'jie'zhi'feng'dai'xi	0
恐犯忌而干讳	kong'fan'ji'er'gan'hui	0
孔盖兮翠旍	kong'gai'xi'cui'jing	0
恐高辛之先我	kong'gao'xin'zhi'xian'wo	0
孔鹤兮回翔	kong'he'xi'hui'xiang	0
恐後之谢	kong'hou'zhi'xie	0
恐皇舆之败绩	kong'huang'yu'zhi'bai'ji	0
恐祸殃之有再	kong'huo'yang'zhi'you'zai	0
恐嫉妒而折之	kong'ji'du'er'zhe'zhi	0
孔静幽默	kong'jing'you'mo	0
恐矩矱之不同	kong'ju'yue'zhi'bu'tong	0
恐溘死不得见乎阳春	kong'ke'si'bu'de'jian'hu'yang'chun	0
恐离罔而灭败	kong'li'wang'er'mie'bai	0
恐美人之迟暮	kong'mei'ren'zhi'chi'mu	0
恐年岁之不吾与	kong'nian'sui'zhi'bu'wu'yu	0
孔鸟飞而送迎兮	kong'niao'fei'er'song'ying'xi	0
恐情质之不信兮	kong'qing'zhi'zhi'bu'xin'xi	0
孔雀盈园	kong'que'ying'yuan	0
恐时世之不固	kong'shi'shi'zhi'bu'gu	0
恐鹈鴂之先鸣兮	kong'ti'jue'zhi'xian'ming'xi	0
恐天时之代序兮	kong'tian'shi'zhi'dai'xu'xi	0
恐田野之芜秽	kong'tian'ye'zhi'wu'hui	0
恐修名之不立	kong'xiu'ming'zhi'bu'li	0
恐余寿之弗将	kong'yu'shou'zhi'fu'jiang	0
恐重患而离尤	kong'zhong'huan'er'li'you	0
恐逐波而复东	kong'zhu'bo'er'fu'dong	0
孔子过之以自侍	kong'zi'guo'zhi'yi'zi'shi	0
恐自遗灾些	kong'zi'yi'zai'xie	0
恐自遗贼些	kong'zi'yi'zei'xie	0
口噤闭而不言	kou'jin'bi'er'bu'yan	0
叩锺调磬	kou'zhong'tiao'qing	0
苦称量之不审兮	ku'cheng'liang'zhi'bu'shen'xi	0
苦李旖旎	ku'li'yi'ni	0
苦众口之铄金	ku'zhong'kou'zhi'shuo'jin	0
苦众人之妒予兮	ku'zhong'ren'zhi'du'yu'xi	0
苦众人之皆然兮	ku'zhong'ren'zhi'jie'ran'xi	0
苦众人之难信兮	ku'zhong'ren'zhi'nan'xin'xi	0
姱而不丑兮	kua'er'bu'chou'xi	0
姱女倡兮容与	kua'nv'chang'xi'rong'yu	0
姱容脩态	kua'rong'xiu'tai	0
姱脩滂浩	kua'xiu'pang'hao	0
塊独守此曲隅兮	kuai'du'shou'ci'qu'yu'xi	0
塊独守此无泽兮	kuai'du'shou'ci'wu'ze'xi	0
脍苴蓴只	kuai'ju'chun'zhi	0
蒯聩登於清府兮	kuai'kui'deng'yu'qing'fu'xi	0
塊兮鞠	kuai'xi'ju	0
款冬而生兮	kuan'dong'er'sheng'xi	0
狂顾南行	kuang'gu'nan'xing	0
匡机极运兮不中	kuang'ji'ji'yun'xi'bu'zhong	0
况贤者之逢乱世哉	kuang'xian'zhe'zhi'feng'luan'shi'zai	0
筐泽泻以豹鞟兮	kuang'ze'xie'yi'bao'kuo'xi	0
窥见兮溪涧	kui'jian'xi'xi'jian	0
魁垒挤摧兮常困辱	kui'lei'ji'cui'xi'chang'kun'ru	0
喟凭心而历兹	kui'ping'xin'er'li'zi	0
窥烟液之所积	kui'yan'ye'zhi'suo'ji	0
媿易初而屈志	kui'yi'chu'er'qu'zhi	0
菎蔽象棋	kun'bi'xiang'qi	0
鹍鹤孤而夜号兮	kun'he'gu'er'ye'hao'xi	0
鹍鸿群晨	kun'hong'qun'chen	0
鹍鸡啁哳而悲鸣	kun'ji'zhao'zha'er'bei'ming	0
菎蕗杂於黀蒸兮	kun'lu'za'yu'zou'zheng'xi	0
昆仑县圃	kun'lun'xian'pu	0
廓抱景而独倚兮	kuo'bao'jing'er'du'yi'xi	0
廓落寂而无友兮	kuo'luo'ji'er'wu'you'xi	0
廓落兮	kuo'luo'xi	0
廓其无求兮	kuo'qi'wu'qiu'xi	0
来革顺志而用国	lai'ge'shun'zhi'er'yong'guo	0
赖皇天之厚德兮	lai'huang'tian'zhi'hou'de'xi	0
来集汉北	lai'ji'han'bei	0
来将屈兮困穷	lai'jiang'qu'xi'kun'qiong	0
来违弃而改求	lai'wei'qi'er'gai'qiu	0
来吾道夫先路	lai'wu'dao'fu'xian'lu	0
来杂陈些	lai'za'chen'xie	0
来者不可待	lai'zhe'bu'ke'dai	0
徠者不可与期	lai'zhe'bu'ke'yu'qi	0
来者吾不闻	lai'zhe'wu'bu'wen	0
兰薄户树	lan'bo'hu'shu	0
览察草木其犹未得兮	lan'cha'cao'mu'qi'you'wei'de'xi	0
览察兮瑶光	lan'cha'xi'yao'guang	0
兰茝幽而独芳	lan'chai'you'er'du'fang	0
揽大薄之芳茝兮	lan'da'bo'zhi'fang'chai'xi	0
兰芳假些	lan'fang'jia'xie	0
览方外之荒忽兮	lan'fang'wai'zhi'huang'hu'xi	0
揽騑辔而下节兮	lan'fei'pei'er'xia'jie'xi	0
览高冈兮峣峣	lan'gao'gang'xi'yao'yao	0
兰膏明烛	lan'gao'ming'zhu	0
揽彗星以为旍兮	lan'hui'xing'yi'wei'jing'xi	0
览冀州兮有馀	lan'ji'zhou'xi'you'yu	0
览椒兰其若兹兮	lan'jiao'lan'qi'ruo'zi'xi	0
览旧邦兮滃郁	lan'jiu'bang'xi'weng'yu	0
览可与兮匹俦	lan'ke'yu'xi'pi'chou	0
览民德焉错辅	lan'min'de'yan'cuo'fu	0
览民尤以自镇	lan'min'you'yi'zi'zhen	0
烂齐光些	lan'qi'guang'xie	0
览其志而欲北	lan'qi'zhi'er'yu'bei	0
揽茹蕙以掩涕兮	lan'ru'hui'yi'yan'ti'xi	0
览私微之所伤	lan'si'wei'zhi'suo'shang	0
揽涕而儜眙	lan'ti'er'ning'yi	0
览往昔兮俊彦	lan'wang'xi'xi'jun'yan	0
览相观於四极兮	lan'xiang'guan'yu'si'ji'xi	0
揽瑶木之橝枝兮	lan'yao'mu'zhi'tan'zhi'xi	0
览余初其犹未悔	lan'yu'chu'qi'you'wei'hui	0
览余以其修姱	lan'yu'yi'qi'xiu'kua	0
烂昭昭兮未央	lan'zhao'zhao'xi'wei'yang	0
兰芷变而不芳兮	lan'zhi'bian'er'bu'fang'xi	0
览芷圃之蠡蠡	lan'zhi'pu'zhi'li'li	0
兰芷幽而有芳	lan'zhi'you'er'you'fang	0
览中国兮冥冥	lan'zhong'guo'xi'ming'ming	0
览周流於朔方	lan'zhou'liu'yu'shuo'fang	0
老嵺廓而无处	lao'liao'kuo'er'wu'chu	0
老冉冉而逮之	lao'ran'ran'er'dai'zhi	0
老冉冉而愈弛	lao'ran'ran'er'yu'chi	0
老冉冉其将至兮	lao'ran'ran'qi'jiang'zhi'xi	0
老冉冉兮既极	lao'ran'ran'xi'ji'ji	0
劳心悁悁涕滂沱兮	lao'xin'yuan'yuan'ti'pang'tuo'xi	0
乐不可言只	le'bu'ke'yan'zhi	0
了冥冥而薄天	le'ming'ming'er'bo'tian	0
乐莫乐兮新相知	le'mo'le'xi'xin'xiang'zhi	0
勒骐骥而更驾兮	le'qi'ji'er'geng'jia'xi	0
乐穷极而不厌兮	le'qiong'ji'er'bu'yan'xi	0
乐先故些	le'xian'gu'xie	0
了杳杳而薄天	le'yao'yao'er'bo'tian	0
雷开何顺	lei'kai'he'shun	0
类任道兮	lei'ren'dao'xi	0
雷师告余以未具	lei'shi'gao'yu'yi'wei'ju	0
雷填填兮雨冥冥	lei'tian'tian'xi'yu'ming'ming	0
雷霆兮硠石盖	lei'ting'xi'lang'shi'gai	0
濿沧海兮东游	li'cang'hai'xi'dong'you	0
立长庚以继日	li'chang'geng'yi'ji'ri	0
丽而不奇些	li'er'bu'qi'xie	0
历而不爽些	li'er'bu'shuang'xie	0
离芳蔼之方壮兮	li'fang'ai'zhi'fang'zhuang'xi	0
历广漠兮驰骛	li'guang'mo'xi'chi'wu	0
丽桂树之冬荣	li'gui'shu'zhi'dong'rong	0
力何固	li'he'gu	0
礼魂成礼兮会鼓	li'hun'cheng'li'xi'hui'gu	0
历吉日乎吾将行	li'ji'ri'hu'wu'jiang'xing	0
藜棘树於中庭	li'ji'shu'yu'zhong'ting	0
立江界而长吟兮	li'jiang'jie'er'chang'yin'xi	0
历九宫兮遍观	li'jiu'gong'xi'bian'guan	0
立九卿只	li'jiu'qing'zhi	0
历九曲兮牵牛	li'jiu'qu'xi'qian'niu	0
历九州兮索合	li'jiu'zhou'xi'suo'he	0
离娄微睇兮	li'lou'wei'di'xi	0
离闵而不迁兮	li'min'er'bu'qian'xi	0
离愍而长鞠	li'min'er'chang'ju	0
历群灵之丰丰	li'qun'ling'zhi'feng'feng	0
离人群而遁逸	li'ren'qun'er'dun'yi	0
理弱而媒不通兮	li'ruo'er'mei'bu'tong'xi	0
理弱而媒拙兮	li'ruo'er'mei'zhuo'xi	0
离骚	li'sao	0
立师旷俾端辞兮	li'shi'kuang'bi'duan'ci'xi	0
离世灵怀其不吾知兮	li'shi'ling'huai'qi'bu'wu'zhi'xi	0
离四海之霑濡	li'si'hai'zhi'zhan'ru	0
历太皓以右转兮	li'tai'hao'yi'you'zhuan'xi	0
离榭脩幕	li'xie'xiu'mu	0
历玄冥以邪径兮	li'xuan'ming'yi'xie'jing'xi	0
丽以佳只	li'yi'jia'zhi	0
丽以先只	li'yi'xian'zhi	0
离忧患而乃寤兮	li'you'huan'er'nai'wu'xi	0
历众山而日远	li'zhong'shan'er'ri'yuan	0
历祝融於硃冥	li'zhu'rong'yu'zhu'ming	0
廉方正而不容	lian'fang'zheng'er'bu'rong	0
怜浮云之相羊	lian'fu'yun'zhi'xiang'yang	0
联蕙芷以为佩兮	lian'hui'zhi'yi'wei'pei'xi	0
怜思心之不可惩兮	lian'si'xin'zhi'bu'ke'cheng'xi	0
连五宿兮建旄	lian'wu'su'xi'jian'mao	0
怜余身不足以卒意兮	lian'yu'shen'bu'zu'yi'zu'yi'xi	0
谅城郭之不足恃兮	liang'cheng'guo'zhi'bu'zu'shi'xi	0
谅聪不明而蔽廱兮	liang'cong'bu'ming'er'bi'yong'xi	0
凉风兮怆悽	liang'feng'xi'chuang'qi	0
谅皇直之屈原	liang'huang'zhi'zhi'qu'yuan	0
两美其必合兮	liang'mei'qi'bi'he'xi	0
靓杪秋之遥夜兮	liang'miao'qiu'zhi'yao'ye'xi	0
谅无怨於天下兮	liang'wu'yuan'yu'tian'xia'xi	0
聊翱游兮周章	liao'ao'you'xi'zhou'zhang	0
蓼虫不知徙乎葵菜	liao'chong'bu'zhi'xi'hu'kui'cai	0
聊竄端而匿迹兮	liao'cuan'duan'er'ni'ji'xi	0
聊仿佯而逍遥兮	liao'fang'yang'er'xiao'yao'xi	0
聊浮游而求女	liao'fu'you'er'qiu'nv	0
聊浮游以逍遥	liao'fu'you'yi'xiao'yao	0
聊浮游於山狭兮	liao'fu'you'yu'shan'xia'xi	0
聊假日兮相佯	liao'jia'ri'xi'xiang'yang	0
聊假日以媮乐	liao'jia'ri'yi'tou'le	0
聊假日以须时	liao'jia'ri'yi'xu'shi	0
聊假日以须臾兮	liao'jia'ri'yi'xu'yu'xi	0
憭栗兮	liao'li'xi	0
聊媮娱以淫乐	liao'tou'yu'yi'yin'le	0
憭兮栗	liao'xi'li	0
聊逍遥兮播光	liao'xiao'yao'xi'bo'guang	0
聊逍遥兮容与	liao'xiao'yao'xi'rong'yu	0
聊逍遥以相佯	liao'xiao'yao'yi'xiang'yang	0
聊逍遥以相羊	liao'xiao'yao'yi'xiang'yang	0
聊逍遥以自恃	liao'xiao'yao'yi'zi'shi	0
聊须臾以时忘兮	liao'xu'yu'yi'shi'wang'xi	0
聊以舒吾忧心	liao'yi'shu'wu'you'xin	0
聊以娱心兮	liao'yi'yu'xin'xi	0
聊抑志而自弭	liao'yi'zhi'er'zi'mi	0
聊以自救兮	liao'yi'zi'jiu'xi	0
聊愉娱以忘忧	liao'yu'yu'yi'wang'you	0
缭之兮杜衡	liao'zhi'xi'du'heng	0
列草兮成行	lie'cao'xi'cheng'xing	0
猎春囿只	lie'chun'you'zhi	0
列击纣躬	lie'ji'zhou'gong	0
列树苦桃	lie'shu'ku'tao	0
列树芋荷	lie'shu'yu'he	0
列新夷与椒桢	lie'xin'yi'yu'jiao'zhen	0
列星安陈	lie'xing'an'chen	0
列子隐身而穷处兮	lie'zi'yin'shen'er'qiong'chu'xi	0
临风怳兮浩歌	lin'feng'huang'xi'hao'ge	0
临高山些	lin'gao'shan'xie	0
临流水而太息	lin'liu'shui'er'tai'xi	0
临曲池些	lin'qu'chi'xie	0
临深水而长啸兮	lin'shen'shui'er'chang'xiao'xi	0
临渊兮汪洋	lin'yuan'xi'wang'yang	0
临沅湘之玄渊兮	lin'yuan'xiang'zhi'xuan'yuan'xi	0
临中国之众人兮	lin'zhong'guo'zhi'zhong'ren'xi	0
令薜荔以为理兮	ling'bi'li'yi'wei'li'xi	0
凌大波而流风兮	ling'da'bo'er'liu'feng'xi	0
灵氛既告余以吉占兮	ling'fen'ji'gao'yu'yi'ji'zhan'xi	0
灵龟兮执拘	ling'gui'xi'zhi'ju	0
令海若舞冯夷	ling'hai'ruo'wu'feng'yi	0
灵何为兮水中	ling'he'wei'xi'shui'zhong	0
凌恆山其若陋兮	ling'heng'shan'qi'ruo'lou'xi	0
灵怀曾不吾与兮	ling'huai'ceng'bu'wu'yu'xi	0
灵怀其不吾闻	ling'huai'qi'bu'wu'wen	0
灵皇皇兮既降	ling'huang'huang'xi'ji'jiang	0
灵皇其不寤知兮	ling'huang'qi'bu'wu'zhi'xi	0
凌黄沱而下低兮	ling'huang'tuo'er'xia'di'xi	0
灵魂屈而偃蹇	ling'hun'qu'er'yan'jian	0
凌惊雷以轶骇电兮	ling'jing'lei'yi'yi'hai'dian'xi	0
灵连蜷兮既留	ling'lian'quan'xi'ji'liu	0
令飘风兮先驱	ling'piao'feng'xi'xian'qu	0
灵蛇吞象	ling'she'tun'xiang	0
凌天地以径度	ling'tian'di'yi'jing'du	0
令五帝以折中兮	ling'wu'di'yi'zhe'zhong'xi	0
灵偃蹇兮姣服	ling'yan'jian'xi'jiao'fu	0
凌阳侯之氾滥兮	ling'yang'hou'zhi'fan'lan'xi	0
灵遥思兮	ling'yao'si'xi	0
灵衣兮被被	ling'yi'xi'bei'bei	0
鲮鱼何所	ling'yu'he'suo	0
凌余阵兮躐余行	ling'yu'zhen'xi'lie'yu'xing	0
令沅湘兮无波	ling'yuan'xiang'xi'wu'bo	0
令昭明兮开门	ling'zhao'ming'xi'kai'men	0
灵之来兮蔽日	ling'zhi'lai'xi'bi'ri	0
灵之来兮如云	ling'zhi'lai'xi'ru'yun	0
留不死之旧乡	liu'bu'si'zhi'jiu'xiang	0
流潺湲些	liu'chan'yuan'xie	0
流金铄石些	liu'jin'shuo'shi'xie	0
留灵修兮憺忘归	liu'ling'xiu'xi'dan'wang'gui	0
流沙千里些	liu'sha'qian'li'xie	0
流水兮沄沄	liu'shui'xi'yun'yun	0
留思北顾涕渐渐兮	liu'si'bei'gu'ti'jian'jian'xi	0
流澌纷兮将来下	liu'si'fen'xi'jiang'lai'xia	0
流星坠兮成雨	liu'xing'zhui'xi'cheng'yu	0
留有虞之二姚	liu'you'yu'zhi'er'yao	0
流泽施只	liu'ze'shi'zhi	0
龙卬脟圈缭戾宛转阻相薄兮	long'ang'lie'quan'liao'li'wan'zhuan'zu'xiang'bo'xi	0
龙驾兮帝服	long'jia'xi'di'fu	0
龙举而景云往	long'ju'er'jing'yun'wang	0
陇廉与孟娵同宫	long'lian'yu'meng'ju'tong'gong	0
龙屈兮蜿蟤	long'qu'xi'wan'zhuan	0
蝼蛄兮鸣东	lou'gu'xi'ming'dong	0
路变易兮时乖	lu'bian'yi'xi'shi'guai	0
路不周以左转兮	lu'bu'zhou'yi'zuo'zhuan'xi	0
路长远而窘迫	lu'chang'yuan'er'jiong'po	0
路荡荡其无人兮	lu'dang'dang'qi'wu'ren'xi	0
路贯庐江兮	lu'guan'lu'jiang'xi	0
六合不足以肆行	lu'he'bu'zu'yi'si'xing	0
鹿何祐	lu'he'you	0
露鸡臛蠵	lu'ji'huo'xi	0
陆魁堆以蔽视兮	lu'kui'dui'yi'bi'shi'xi	0
路曼曼其无端兮	lu'man'man'qi'wu'duan'xi	0
路曼曼其修远兮	lu'man'man'qi'xiu'yuan'xi	0
路眇眇之默默	lu'miao'miao'zhi'mo'mo	0
鹿鸣求其友	lu'ming'qiu'qi'you	0
菉蘋齐华兮	lu'pin'qi'hua'xi	0
露申辛夷	lu'shen'xin'yi	0
路室女之方桑兮	lu'shi'nv'zhi'fang'sang'xi	0
路险难兮独	lu'xian'nan'xi'du	0
路修远以多艰兮	lu'xiu'yuan'yi'duo'jian'xi	0
路修远以周流	lu'xiu'yuan'yi'zhou'liu	0
路壅绝而不通	lu'yong'jue'er'bu'tong	0
路幽昧而甚难	lu'you'mei'er'shen'nan	0
路幽昧以险隘	lu'you'mei'yi'xian'ai	0
路远处幽	lu'yuan'chu'you	0
路中断而不通	lu'zhong'duan'er'bu'tong	0
乱而不分些	luan'er'bu'fen'xie	0
鸾凤翔於苍云兮	luan'feng'xiang'yu'cang'yun'xi	0
鸾皇孔凤日以远兮	luan'huang'kong'feng'ri'yi'yuan'xi	0
鸾皇为余先戒兮	luan'huang'wei'yu'xian'jie'xi	0
鸾鸟凤皇	luan'niao'feng'huang	0
鸾鸟轩翥而翔飞	luan'niao'xuan'zhu'er'xiang'fei	0
乱曰	luan'yue	0
罗幬张些	luo'dao'zhang'xie	0
罗生兮堂下	luo'sheng'xi'tang'xia	0
率彼兮畛陌	lv'bi'xi'zhen'mo	0
屡惩艾而不迻	lv'cheng'ai'er'bu'yi	0
吕傅举兮殷周兴	lv'fu'ju'xi'yin'zhou'xing	0
律魁放乎山间	lv'kui'fang'hu'shan'jian	0
屡离忧而逢患	lv'li'you'er'feng'huan	0
履绳墨而不颇	lv'sheng'mo'er'bu'po	0
吕望穷困而不聊生兮	lv'wang'qiong'kun'er'bu'liao'sheng'xi	0
吕望屠於朝歌兮	lv'wang'tu'yu'zhao'ge'xi	0
吕望之鼓刀兮	lv'wang'zhi'gu'dao'xi	0
绿叶素荣	lv'ye'su'rong	0
绿叶兮素枝	lv'ye'xi'su'zhi	0
绿叶兮紫茎	lv'ye'xi'zi'jing	0
马兰踸踔而日加	ma'lan'chen'chuo'er'ri'jia	0
霾两轮兮絷四马	mai'liang'lun'xi'zhi'si'ma	0
霾土忽兮塺塺	mai'tu'hu'xi'mei'mei	0
满内而外扬	man'nei'er'wai'yang	0
曼鹔鹴只	man'su'shuang'zhi	0
满堂兮美人	man'tang'xi'mei'ren	0
曼余自以流观兮	man'yu'zi'yi'liu'guan'xi	0
曼遭夜之方长	man'zao'ye'zhi'fang'chang	0
曼泽怡面	man'ze'yi'mian	0
莽芒芒之无仪	mang'mang'mang'zhi'wu'yi	0
莽洋洋而无极兮	mang'yang'yang'er'wu'ji'xi	0
漭洋洋只	mang'yang'yang'zhi	0
蟊截虫虫兮号西	mao'jie'chong'chong'xi'hao'xi	0
貌揭揭以巍巍	mao'jie'jie'yi'wei'wei	0
茅丝兮同综	mao'si'xi'tong'zong	0
梅伯受醢	mei'bo'shou'hai	0
梅伯数谏而至醢兮	mei'bo'shu'jian'er'zhi'hai'xi	0
美超远而逾迈	mei'chao'yuan'er'yu'mai	0
媒绝路阻兮	mei'jue'lu'zu'xi	0
美冒众流	mei'mao'zhong'liu	0
美目媔只	mei'mu'mian'zhi	0
媒女诎兮謰謱	mei'nv'qu'xi'lian'lou	0
美人既醉	mei'ren'ji'zui	0
美往世之登仙	mei'wang'shi'zhi'deng'xian	0
妹嬉何肆	mei'xi'he'si	0
美要眇兮宜修	mei'yao'miao'xi'yi'xiu	0
美玉兮盈堂	mei'yu'xi'ying'tang	0
矇蔽兮不章	meng'bi'xi'bu'zhang	0
猛犬狺狺而迎吠兮	meng'quan'yin'yin'er'ying'fei'xi	0
矇瞍谓之不章	meng'sou'wei'zhi'bu'zhang	0
迷不知宠之门	mi'bu'zhi'chong'zhi'men	0
迷不知吾所如	mi'bu'zhi'wu'suo'ru	0
汨徂往而不归	mi'cu'wang'er'bu'gui	0
麋何食兮庭中	mi'he'shi'xi'ting'zhong	0
獼猴兮熊罴	mi'hou'xi'xiong'pi	0
弥览兮九隅	mi'lan'xi'jiu'yu	0
秘密事之载心兮	mi'mi'shi'zhi'zai'xin'xi	0
靡蓱九衢	mi'ping'jiu'qu	0
麋散而不可止些	mi'san'er'bu'ke'zhi'xie	0
汨吾南征	mi'wu'nan'zheng	0
靡颜腻理	mi'yan'ni'li	0
靡有兮齐伦	mi'you'xi'qi'lun	0
汨余若将不及兮	mi'yu'ruo'jiang'bu'ji'xi	0
弥远路兮悠悠	mi'yuan'lu'xi'you'you	0
偭规矩而改错	mian'gui'ju'er'gai'cuo	0
勉升降以上下兮	mian'sheng'jiang'yi'shang'xia'xi	0
勉远逝而无狐疑兮	mian'yuan'shi'er'wu'hu'yi'xi	0
免众患而不惧兮	mian'zhong'huan'er'bu'ju'xi	0
眇不睹其东西	miao'bu'du'qi'dong'xi	0
眇不知其所蹠	miao'bu'zhi'qi'suo'zhi	0
邈而不可慕	miao'er'bu'ke'mu	0
邈蔓蔓之不可量兮	miao'man'man'zhi'bu'ke'liang'xi	0
淼南渡之焉如	miao'nan'du'zhi'yan'ru	0
眇远志之所及兮	miao'yuan'zhi'zhi'suo'ji'xi	0
灭规矩而不用兮	mie'gui'ju'er'bu'yong'xi	0
灭规矩而改错	mie'gui'ju'er'gai'cuo	0
灭规矩而改凿	mie'gui'ju'er'gai'zao	0
灭巧倕之绳墨	mie'qiao'chui'zhi'sheng'mo	0
闵妃匹合	min'fei'pi'he	0
民好恶其不同兮	min'hao'wu'qi'bu'tong'xi	0
闵空宇之孤子兮	min'kong'yu'zhi'gu'zi'xi	0
民离散而相失兮	min'li'san'er'xiang'shi'xi	0
愍命昔皇考之嘉志兮	min'ming'xi'huang'kao'zhi'jia'zhi'xi	0
闵奇思之不通兮	min'qi'si'zhi'bu'tong'xi	0
悯上哀世兮睩睩	min'shang'ai'shi'xi'lu'lu	0
民生禀命	min'sheng'bing'ming	0
民生各有所乐兮	min'sheng'ge'you'suo'le'xi	0
闵先嗣之中绝兮	min'xian'si'zhi'zhong'jue'xi	0
愍余命兮遭六极	min'yu'ming'xi'zao'liu'ji	0
愍贞良兮遇害	min'zhen'liang'xi'yu'hai	0
名不可以虚作	ming'bu'ke'yi'xu'zuo	0
鸣篪兮吹竽	ming'chi'xi'chui'yu	0
明法度之嫌疑	ming'fa'du'zhi'xian'yi	0
明法令而修理兮	ming'fa'ling'er'xiu'li'xi	0
明告君子	ming'gao'jun'zi	0
鸣鸠栖於桑榆	ming'jiu'qi'yu'sang'yu	0
命咎繇使并听	ming'jiu'yao'shi'bing'ting	0
命咎繇使听直	ming'jiu'yao'shi'ting'zhi	0
命灵氛为余占之	ming'ling'fen'wei'yu'zhan'zhi	0
冥凌浹行	ming'ling'jia'xing	0
名靡散而不彰	ming'mi'san'er'bu'zhang	0
明明闇闇	ming'ming'an'an	0
名声若日	ming'sheng'ruo'ri	0
名声著而日延	ming'sheng'zhu'er'ri'yan	0
命天阍其开关兮	ming'tian'hun'qi'kai'guan'xi	0
命有殷国	ming'you'yin'guo	0
鸣玉鸾之啾啾	ming'yu'luan'zhi'jiu'jiu	0
名余曰正则兮	ming'yu'yue'zheng'ze'xi	0
鸣竽张只	ming'yu'zhang'zhi	0
明月销铄而减毁	ming'yue'xiao'shuo'er'jian'hui	0
命则处幽吾将罢兮	ming'ze'chu'you'wu'jiang'ba'xi	0
冥昭瞢闇	ming'zhao'meng'an	0
谬谏怨灵修之浩荡兮	miu'jian'yuan'ling'xiu'zhi'hao'dang'xi	0
莫好修之害也	mo'hao'xiu'zhi'hai'ye	0
嗼寂默而无声	mo'ji'mo'er'wu'sheng	0
莫能行於杳冥兮	mo'neng'xing'yu'yao'ming'xi	0
莫女母勃屑而日侍	mo'nv'mu'bo'xie'er'ri'shi	0
莫女母姣而自好	mo'nv'mu'jiao'er'zi'hao	0
默顺风以偃仰兮	mo'shun'feng'yi'yan'yang'xi	0
莫我振理	mo'wo'zhen'li	0
漠虚静以恬愉兮	mo'xu'jing'yi'tian'yu'xi	0
秣余马兮河鼓	mo'yu'ma'xi'he'gu	0
莫知余之所有	mo'zhi'yu'zhi'suo'you	0
目曾波些	mu'ceng'bo'xie	0
牧夫牛羊	mu'fu'niu'yang	0
沐盥浴兮天池	mu'guan'yu'xi'tian'chi	0
目极千里兮	mu'ji'qian'li'xi	0
穆将愉兮上皇	mu'jiang'yu'xi'shang'huang	0
慕类兮以悲	mu'lei'xi'yi'bei	0
目眽眽兮寤终朝	mu'mi'mi'xi'wu'zhong'chao	0
目眇眇而遗泣	mu'miao'miao'er'yi'qi	0
目眇眇兮愁予	mu'miao'miao'xi'chou'yu	0
穆眇眇之无垠兮	mu'miao'miao'zhi'wu'yin'xi	0
目瞥瞥兮西没	mu'pie'pie'xi'xi'mei	0
暮去次而敢止	mu'qu'ci'er'gan'zhi	0
木去根而不长	mu'qu'gen'er'bu'chang	0
目腾光些	mu'teng'guang'xie	0
穆王巧挴	mu'wang'qiao'mei	0
乃逢纷以罹诟也	nai'feng'fen'yi'li'gou'ye	0
乃歌曰	nai'ge'yue	0
乃回朅兮北逝	nai'hui'qie'xi'bei'shi	0
乃集大皇之野	nai'ji'da'huang'zhi'ye	0
乃遂焉而逢殃	nai'sui'yan'er'feng'yang	0
乃往见太卜郑詹尹曰	nai'wang'jian'tai'bu'zheng'zhan'yin'yue	0
乃下招曰	nai'xia'zhao'yue	0
乃猿狖之所居	nai'yuan'you'zhi'suo'ju	0
乃至少原之野兮	nai'zhi'shao'yuan'zhi'ye'xi	0
乃知遭命之将至	nai'zhi'zao'ming'zhi'jiang'zhi	0
乃自轸兮在兹	nai'zi'zhen'xi'zai'zi	0
南北顺堕	nan'bei'shun'duo	0
南采兮芝英	nan'cai'xi'zhi'ying	0
南方不可以止些	nan'fang'bu'ke'yi'zhi'xie	0
南房小坛	nan'fang'xiao'tan	0
南交阯只	nan'jiao'zhi'zhi	0
南土爰底	nan'tu'yuan'di	0
南有炎火千里	nan'you'yan'huo'qian'li	0
南岳是止	nan'yue'shi'zhi	0
南指月与列星	nan'zhi'yue'yu'lie'xing	0
臑若芳些	nao'ruo'fang'xie	0
内鸧鸽鹄	nei'cang'ge'hu	0
内恻隐而含哀	nei'ce'yin'er'han'ai	0
内厚质正兮	nei'hou'zhi'zheng'xi	0
内怀情之洁白兮	nei'huai'qing'zhi'jie'bai'xi	0
内距闭而不开	nei'ju'bi'er'bu'kai	0
内惟省以操端兮	nei'wei'sheng'yi'cao'duan'xi	0
内欣欣而自美兮	nei'xin'xin'er'zi'mei'xi	0
内自省而不俟兮	nei'zi'xing'er'bu'si'xi	0
能流厥严	neng'liu'jue'yan	0
睨三阶兮炳分	ni'san'jie'xi'bing'fen	0
溺水浟浟只	ni'shui'you'you'zhi	0
拟斯兮二踪	ni'si'xi'er'zong	0
睨玉石之嵾嵯	ni'yu'shi'zhi'cen'cuo	0
年齿尽兮命迫促	nian'chi'jin'xi'ming'po'cu	0
年忽忽而日度	nian'hu'hu'er'ri'du	0
年既老而不衰	nian'ji'lao'er'bu'shuai	0
年既已过太半兮	nian'ji'yi'guo'tai'ban'xi	0
念君兮不忘	nian'jun'xi'bu'wang	0
念灵闺兮隩重深	nian'ling'gui'xi'ao'zhong'shen	0
念女嬃之婵媛兮	nian'nv'xu'zhi'chan'yuan'xi	0
念三年之积思兮	nian'san'nian'zhi'ji'si'xi	0
念社稷之几危兮	nian'she'ji'zhi'ji'wei'xi	0
年寿延只	nian'shou'yan'zhi	0
念私门之正匠兮	nian'si'men'zhi'zheng'jiang'xi	0
年岁虽少	nian'sui'sui'shao	0
年滔滔而自远兮	nian'tao'tao'er'zi'yuan'xi	0
念我茕茕魂谁求兮	nian'wo'qiong'qiong'hun'shui'qiu'xi	0
念我长生而久仙兮	nian'wo'zhang'sheng'er'jiu'xian'xi	0
年洋洋以日往兮	nian'yang'yang'yi'ri'wang'xi	0
念余邦之横陷兮	nian'yu'bang'zhi'heng'xian'xi	0
鸟次兮屋上	niao'ci'xi'wu'shang	0
鸟萃兮蘋中	niao'cui'xi'pin'zhong	0
鸟飞反故乡兮	niao'fei'fan'gu'xiang'xi	0
鸟何燠之	niao'he'yu'zhi	0
嫋嫋兮秋风	niao'niao'xi'qiu'feng	0
鸟兽惊而失群兮	niao'shou'jing'er'shi'qun'xi	0
鸟兽鸣以号群兮	niao'shou'ming'yi'hao'qun'xi	0
鸟兽兮惊骇	niao'shou'xi'jing'hai	0
鸟兽犹知怀德兮	niao'shou'you'zhi'huai'de'xi	0
孽臣之号咷兮	nie'chen'zhi'hao'tao'xi	0
蹑天衢兮长驱	nie'tian'qu'xi'chang'qu	0
齧芝华兮疗饥	nie'zhi'hua'xi'liao'ji	0
宁昂昂若千里之驹乎	ning'ang'ang'ruo'qian'li'zhi'ju'hu	0
宁超然高举	ning'chao'ran'gao'ju	0
宁赴湘流	ning'fu'xiang'liu	0
宁浮沅而驰骋兮	ning'fu'yuan'er'chi'cheng'xi	0
宁溘死而流亡兮	ning'ke'si'er'liu'wang'xi	0
宁溘死以流亡兮	ning'ke'si'yi'liu'wang'xi	0
宁廉洁正直	ning'lian'jie'zheng'zhi	0
甯戚饭牛而商歌兮	ning'qi'fan'niu'er'shang'ge'xi	0
甯戚歌而饭牛	ning'qi'ge'er'fan'niu	0
甯戚讴於车下兮	ning'qi'ou'yu'che'xia'xi	0
甯戚之讴歌兮	ning'qi'zhi'ou'ge'xi	0
宁穷处而守高	ning'qiong'chu'er'shou'gao	0
宁为江海之泥涂兮	ning'wei'jiang'hai'zhi'ni'tu'xi	0
宁隐闵而寿考兮	ning'yin'min'er'shou'kao'xi	0
宁幽隐以远祸兮	ning'you'yin'yi'yuan'huo'xi	0
宁与黄鹄比翼乎	ning'yu'huang'hu'bi'yi'hu	0
宁与骐骥亢轭乎	ning'yu'qi'ji'kang'e'hu	0
宁正言不讳	ning'zheng'yan'bu'hui	0
宁诛锄草茅	ning'zhu'chu'cao'mao	0
农夫辍耕而容与兮	nong'fu'chuo'geng'er'rong'yu'xi	0
驽骏杂而不分兮	nu'jun'za'er'bu'fen'xi	0
女婵媛兮为余太息	nv'chan'yuan'xi'wei'yu'tai'xi	0
女歧缝裳	nv'qi'feng'shang	0
女歧无合	nv'qi'wu'he	0
女娲有体	nv'wa'you'ti	0
女嬃之婵媛兮	nv'xu'zhi'chan'yuan'xi	0
女乐罗些	nv'yue'luo'xie	0
讴和扬阿	ou'he'yang'a	0
排阊阖而望予	pai'chang'he'er'wang'yu	0
排帝宫与罗囿兮	pai'di'gong'yu'luo'you'xi	0
攀北极而一息兮	pan'bei'ji'er'yi'xi'xi	0
牉独处此异域	pan'du'chu'ci'yi'yu	0
判独离而不服	pan'du'li'er'bu'fu	0
叛陆离其上下兮	pan'lu'li'qi'shang'xia'xi	0
攀天阶兮下视	pan'tian'jie'xi'xia'shi	0
攀援桂枝兮聊淹留	pan'yuan'gui'zhi'xi'liao'yan'liu	0
彷徨兮兰宫	pang'huang'xi'lan'gong	0
滂心绰态	pang'xin'chuo'tai	0
彷徉无所倚	pang'yang'wu'suo'yi	0
旁引之於四时	pang'yin'zhi'yu'si'shi	0
佩缤纷其繁饰兮	pei'bin'fen'qi'fan'shi'xi	0
佩缤纷以缭转兮	pei'bin'fen'yi'liao'zhuan'xi	0
佩苍龙之蚴虬兮	pei'cang'long'zhi'you'qiu'xi	0
配稷契兮恢唐功	pei'ji'qi'xi'hui'tang'gong	0
佩江蓠之菲菲	pei'jiang'li'zhi'fei'fei	0
沛罔瀁而自浮	pei'wang'yang'er'zi'fu	0
沛吾乘兮桂舟	pei'wu'cheng'xi'gui'zhou	0
蓬艾亲入御於床笫兮	peng'ai'qin'ru'yu'yu'chuang'zi'xi	0
朋曹比而党誉	peng'cao'bi'er'dang'yu	0
彭铿斟雉	peng'keng'zhen'zhi	0
譬彼蛟龙乘云浮兮	pi'bi'jiao'long'cheng'yun'fu'xi	0
譬彼流水纷扬磕兮	pi'bi'liu'shui'fen'yang'ke'xi	0
披华裳兮芳芬	pi'hua'shang'xi'fang'fen	0
擗蕙櫋兮既张	pi'hui'mian'xi'ji'zhang	0
譬若王侨之乘云兮	pi'ruo'wang'qiao'zhi'cheng'yun'xi	0
仳倠倚於弥楹	pi'sui'yi'yu'mi'ying	0
辟与此其无异	pi'yu'ci'qi'wu'yi	0
骈罗兮列陈	pian'luo'xi'lie'chen	0
翩冥冥之不可娱	pian'ming'ming'zhi'bu'ke'yu	0
甂瓯登於明堂兮	pian'ou'deng'yu'ming'tang'xi	0
便旋兮中原	pian'xuan'xi'zhong'yuan	0
偏与乎玄英异色	pian'yu'hu'xuan'ying'yi'se	0
漂翻翻其上下兮	piao'fan'fan'qi'shang'xia'xi	0
飘风来之汹汹	piao'feng'lai'zhi'xiong'xiong	0
飘风蓬龙埃坲坲兮	piao'feng'peng'long'ai'fo'fo'xi	0
飘风起兮扬尘埃	piao'feng'qi'xi'yang'chen'ai	0
飘风屯其相离兮	piao'feng'tun'qi'xiang'li'xi	0
缥绵绵之不可纡	piao'mian'mian'zhi'bu'ke'yu	0
贫士失职而志不平	pin'shi'shi'zhi'er'zhi'bu'ping	0
凭不厌乎求索	ping'bu'yan'hu'qiu'suo	0
蓱号起雨	ping'hao'qi'yu	0
平明发兮苍梧	ping'ming'fa'xi'cang'wu	0
平胁曼肤	ping'xie'man'fu	0
平原忽兮路超远	ping'yuan'hu'xi'lu'chao'yuan	0
破伯牙之号锺兮	po'bo'ya'zhi'hao'zhong'xi	0
破荆和以继筑	po'jing'he'yi'ji'zhu	0
迫日兮黄昏	po'ri'xi'huang'hun	0
迫中国兮窄狭	po'zhong'guo'xi'zhai'xia	0
仆夫悲余马怀兮	pu'fu'bei'yu'ma'huai'xi	0
仆夫怀余心悲兮	pu'fu'huai'yu'xin'bei'xi	0
仆夫慌悴散若流兮	pu'fu'huang'cui'san'ruo'liu'xi	0
匍匐兮丛攒	pu'fu'xi'cong'cuan	0
匍匐兮岩石	pu'fu'xi'yan'shi	0
莆雚是营	pu'huan'shi'ying	0
朴以忠乎	pu'yi'zhong'hu	0
骑白鹿而容与	qi'bai'lu'er'rong'yu	0
岂不可喜兮	qi'bu'ke'xi'xi	0
期不信兮告余以不间	qi'bu'xin'xi'gao'yu'yi'bu'jian	0
岂不郁陶而思君兮	qi'bu'yu'tao'er'si'jun'xi	0
岂不至今其庸止	qi'bu'zhi'jin'qi'yong'zhi	0
岂珵美之能当	qi'cheng'mei'zhi'neng'dang	0
其大无垠	qi'da'wu'yin	0
启代益作后	qi'dai'yi'zuo'hou	0
鬿堆焉处	qi'dui'yan'chu	0
起奋迅兮奔走	qi'fen'xun'xi'ben'zou	0
奇傅说之讬辰星兮	qi'fu'shuo'zhi'tuo'chen'xing'xi	0
其高几里	qi'gao'ji'li	0
气涫沸沛其若波	qi'guan'fei'pei'qi'ruo'bo	0
迄乎今兮不易	qi'hu'jin'xi'bu'yi	0
齐桓九会	qi'huan'jiu'hui	0
齐桓失於专任兮	qi'huan'shi'yu'zhuan'ren'xi	0
齐桓闻以该辅	qi'huan'wen'yi'gai'fu	0
启棘宾商	qi'ji'bin'shang	0
骐骥伏匿而不见兮	qi'ji'fu'ni'er'bu'jian'xi	0
弃鸡骇於筐簏	qi'ji'hai'yu'kuang'lu	0
七谏	qi'jian	0
骑胶葛以杂乱兮	qi'jiao'ge'yi'za'luan'xi	0
其角觺觺些	qi'jiao'yi'yi'xie	0
岂尽忠而有功	qi'jin'zhong'er'you'gong	0
启九辨与九歌兮	qi'jiu'bian'yu'jiu'ge'xi	0
弃捐药芷与杜衡兮	qi'juan'yao'zhi'yu'du'heng'xi	0
其尻安在	qi'kao'an'zai	0
启匮兮探筴	qi'kui'xi'tan'jia	0
气缭转而自缔	qi'liao'zhuan'er'zi'di	0
麒麟奔於九皋兮	qi'lin'ben'yu'jiu'gao'xi	0
畦留夷与揭车兮	qi'liu'yi'yu'jie'che'xi	0
其命何从	qi'ming'he'cong	0
齐名字於天地兮	qi'ming'zi'yu'tian'di'xi	0
骑霓兮南上	qi'ni'xi'nan'shang	0
弃彭咸之娱乐兮	qi'peng'xian'zhi'yu'le'xi	0
凄凄兮漇漇	qi'qi'xi'xi'xi	0
岂其有他故兮	qi'qi'you'ta'gu'xi	0
齐千乘	qi'qian'sheng	0
其身若牛些	qi'shen'ruo'niu'xie	0
其谁从焉	qi'shui'cong'yan	0
戚宋万於两楹兮	qi'song'wan'yu'liang'ying'xi	0
其土烂人	qi'tu'lan'ren	0
其外旷宇些	qi'wai'kuang'yu'xie	0
其位安施	qi'wei'an'shi	0
岂维纫夫蕙茝	qi'wei'ren'fu'hui'chai	0
岂惟是其有女	qi'wei'shi'qi'you'nv	0
齐吴榜以击汰	qi'wu'bang'yi'ji'tai	0
泣下涟涟	qi'xia'lian'lian	0
其小无内兮	qi'xiao'wu'nei'xi	0
其修孰多	qi'xiu'shu'duo	0
泣歔欷而霑衿	qi'xu'xi'er'zhan'jin	0
其衍几何	qi'yan'ji'he	0
齐玉轪而并驰	qi'yu'dai'er'bing'chi	0
岂余身之僤殃兮	qi'yu'shen'zhi'chan'yang'xi	0
岂余心之可惩	qi'yu'xin'zhi'ke'cheng	0
气於邑而不可止	qi'yu'yi'er'bu'ke'zhi	0
泣霑襟而濡袂	qi'zhan'jin'er'ru'mei	0
起郑舞些	qi'zheng'wu'xie	0
岂知何其故	qi'zhi'he'qi'gu	0
葺之兮荷盖	qi'zhi'xi'he'gai	0
岂忠信之可化	qi'zhong'xin'zhi'ke'hua	0
其罪伊何	qi'zui'yi'he	0
搴薜荔於山野兮	qian'bi'li'yu'shan'ye'xi	0
迁藏就岐	qian'cang'jiu'qi	0
潜藏兮山泽	qian'cang'xi'shan'ze	0
搴长洲之宿莽	qian'chang'zhou'zhi'su'mang	0
煔鹑敶只	qian'chun'zhen'zhi	0
铅刀进御兮	qian'dao'jin'yu'xi	0
铅刀历御兮	qian'dao'li'yu'xi	0
前飞廉以启路	qian'fei'lian'yi'qi'lu	0
搴芙蓉兮木末	qian'fu'rong'xi'mu'mo	0
褰虹旗於玉门	qian'hong'qi'yu'yu'men	0
搴将憺兮寿宫	qian'jiang'dan'xi'shou'gong	0
千钧为轻	qian'jun'wei'qing	0
掔木根以结茝兮	qian'mu'gen'yi'jie'chai'xi	0
前轻辌之锵锵兮	qian'qing'liang'zhi'qiang'qiang'xi	0
迁逡次而勿驱兮	qian'qun'ci'er'wu'qu'xi	0
搴汀洲兮杜若	qian'ting'zhou'xi'du'ruo	0
前图未改	qian'tu'wei'gai	0
前望舒使先驱兮	qian'wang'shu'shi'xian'qu'xi	0
牵於俗而芜秽	qian'yu'su'er'wu'hui	0
搴玉英兮自脩	qian'yu'ying'xi'zi'xiu	0
佥曰	qian'yue	0
浅智褊能兮	qian'zhi'bian'neng'xi	0
潜周鼎於江淮兮	qian'zhou'ding'yu'jiang'huai'xi	0
羌不可保也	qiang'bu'ke'bao'ye	0
羌不知余之所臧	qiang'bu'zhi'yu'zhi'suo'zang	0
羌芳华自中出	qiang'fang'hua'zi'zhong'chu	0
羌冯心犹未化	qiang'feng'xin'you'wei'hua	0
羌居蔽而闻章	qiang'ju'bi'er'wen'zhang	0
羌两足以毕斮	qiang'liang'zu'yi'bi'cuo	0
羌灵魂之欲归兮	qiang'ling'hun'zhi'yu'gui'xi	0
羌内恕己以量人兮	qiang'nei'shu'ji'yi'liang'ren'xi	0
羌声色兮娱人	qiang'sheng'se'xi'yu'ren	0
羌儵忽而难当	qiang'tiao'hu'er'nan'dang	0
羌无实而容长	qiang'wu'shi'er'rong'chang	0
羌无以异於众芳	qiang'wu'yi'yi'yu'zhong'fang	0
羌迅高而难当	qiang'xun'gao'er'nan'dang	0
羌愈思兮愁人	qiang'yu'si'xi'chou'ren	0
羌中道而改路	qiang'zhong'dao'er'gai'lu	0
羌中道而回畔兮	qiang'zhong'dao'er'hui'pan'xi	0
羌众人之所仇也	qiang'zhong'ren'zhi'suo'chou'ye	0
巧陲不斫兮	qiao'chui'bu'zhuo'xi	0
巧佞在前兮	qiao'ning'zai'qian'xi	0
窃哀兮浮萍	qie'ai'xi'fu'ping	0
窃悲夫蕙华之曾敷兮	qie'bei'fu'hui'hua'zhi'ceng'fu'xi	0
窃不敢忘初之厚德	qie'bu'gan'wang'chu'zhi'hou'de	0
窃不自料而原忠兮	qie'bu'zi'liao'er'yuan'zhong'xi	0
且从容兮自慰	qie'cong'rong'xi'zi'wei	0
窃悼後之危败	qie'dao'hou'zhi'wei'bai	0
窃独悲此廪秋	qie'du'bei'ci'lin'qiu	0
窃赋诗之所明	qie'fu'shi'zhi'suo'ming	0
窃快在其中心兮	qie'kuai'zai'qi'zhong'xin'xi	0
窃美申包胥之气晟兮	qie'mei'shen'bao'xu'zhi'qi'sheng'xi	0
窃慕诗人之遗风兮	qie'mu'shi'ren'zhi'yi'feng'xi	0
且人心之持旧兮	qie'ren'xin'zhi'chi'jiu'xi	0
且倘佯而氾观	qie'tang'yang'er'fan'guan	0
切淟涊之流俗	qie'tian'ren'zhi'liu'su	0
且隐伏而远身	qie'yin'fu'er'yuan'shen	0
窃怨君之不寤兮	qie'yuan'jun'zhi'bu'wu'xi	0
嵚岑碕礒兮碅磳磈硊	qin'cen'qi'yi'xi'jun'zeng'kui'gui	0
亲谗谀而疏贤圣兮	qin'chan'yu'er'shu'xian'sheng'xi	0
秦篝齐缕	qin'gou'qi'lv	0
禽兽骇兮亡其曹	qin'shou'hai'xi'wang'qi'cao	0
亲忠正之悃诚兮	qin'zhong'zheng'zhi'kun'cheng'xi	0
情沉抑而不达兮	qing'chen'yi'er'bu'da'xi	0
情沉抑而不扬	qing'chen'yi'er'bu'yang	0
情舛错以曼忧	qing'chuan'cuo'yi'man'you	0
情纯洁而罔薉兮	qing'chun'jie'er'wang'hui'xi	0
情澹澹其若渊	qing'dan'dan'qi'ruo'yuan	0
情慌忽以忘归兮	qing'huang'hu'yi'wang'gui'xi	0
青黄杂糅	qing'huang'za'rou	0
庆忌囚於阱室兮	qing'ji'qiu'yu'jing'shi'xi	0
情慨慨而长怀兮	qing'kai'kai'er'chang'huai'xi	0
青骊结驷兮	qing'li'jie'si'xi	0
清泠泠而歼灭兮	qing'ling'ling'er'jian'mie'xi	0
倾容幸而侍侧	qing'rong'xing'er'shi'ce	0
青色直眉	qing'se'zhi'mei	0
青莎杂树兮薠草靃靡	qing'sha'za'shu'xi'fan'cao'huo'mi	0
情素洁於纽帛	qing'su'jie'yu'niu'bo	0
清馨冻饮	qing'xin'dong'yin	0
情与貌其不变	qing'yu'mao'qi'bu'bian	0
情与质信可保兮	qing'yu'zhi'xin'ke'bao'xi	0
情冤见之日明兮	qing'yuan'jian'zhi'ri'ming'xi	0
青云衣兮白霓裳	qing'yun'yi'xi'bai'ni'chang	0
穷不知所示	qiong'bu'zhi'suo'shi	0
琼毂错衡	qiong'gu'cuo'heng	0
琼木篱些	qiong'mu'li'xie	0
穷身永乐	qiong'shen'yong'le	0
秋草荣其将实兮	qiu'cao'rong'qi'jiang'shi'xi	0
秋风浏以萧萧	qiu'feng'liu'yi'xiao'xiao	0
秋毫微哉而变容	qiu'hao'wei'zai'er'bian'rong	0
秋既先戒以白露兮	qiu'ji'xian'jie'yi'bai'lu'xi	0
求介子之所存兮	qiu'jie'zi'zhi'suo'cun'xi	0
求矩矱之所同	qiu'ju'yue'zhi'suo'tong	0
秋兰兮青青	qiu'lan'xi'qing'qing	0
丘陵翔舞兮	qiu'ling'xiang'wu'xi	0
囚灵玄於虞渊	qiu'ling'xuan'yu'yu'yuan	0
求宓妃之所在	qiu'mi'fei'zhi'suo'zai	0
璆锵鸣兮琳琅	qiu'qiang'ming'xi'lin'lang	0
求水神兮灵女	qiu'shui'shen'xi'ling'nv	0
求水无所得些	qiu'shui'wu'suo'de'xie	0
遒相迫些	qiu'xiang'po'xie	0
求轩辕兮索重华	qiu'xuan'yuan'xi'suo'chong'hua	0
求正气之所由	qiu'zheng'qi'zhi'suo'you	0
秋之为气也	qiu'zhi'wei'qi'ye	0
去白日之昭昭兮	qu'bai'ri'zhi'zhao'zhao'xi	0
去故而就新	qu'gu'er'jiu'xin	0
去故乡而就远兮	qu'gu'xiang'er'jiu'yuan'xi	0
去君之恆幹	qu'jun'zhi'heng'gan	0
曲眉规只	qu'mei'gui'zhi	0
鼁黾游乎华池	qu'min'you'hu'hua'chi	0
去飘疾而不可得	qu'piao'ji'er'bu'ke'de	0
屈情素以从事	qu'qing'su'yi'cong'shi	0
曲屋步壛	qu'wu'bu'yan	0
去乡离家兮徠远客	qu'xiang'li'jia'xi'lai'yuan'ke	0
阒睄窕兮靡睹	qu'xiao'tiao'xi'mi'du	0
屈心而抑志兮	qu'xin'er'yi'zhi'xi	0
去郢东迁余谁慕兮	qu'ying'dong'qian'yu'shui'mu'xi	0
去余邦之弥久	qu'yu'bang'zhi'mi'jiu	0
鸲鹆鸣兮聒余	qu'yu'ming'xi'guo'yu	0
屈原	qu'yuan	0
屈原沉於汨罗	qu'yuan'chen'yu'mi'luo	0
屈原曰	qu'yuan'yue	0
去终古之所居兮	qu'zhong'gu'zhi'suo'ju'xi	0
驱子侨之奔走兮	qu'zi'qiao'zhi'ben'zou'xi	0
屈子兮沉湘	qu'zi'xi'chen'xiang	0
荃不察余之中情兮	quan'bu'cha'yu'zhi'zhong'qing'xi	0
荃蕙化而为茅	quan'hui'hua'er'wei'mao	0
蜷局顾而不行	quan'ju'gu'er'bu'xing	0
蜷跼兮寒局数	quan'ju'xi'han'ju'shu	0
群阿容以晦光兮	qun'a'rong'yi'hui'guang'xi	0
群司兮譨譨	qun'si'xi'nou'nou	0
群行兮上下	qun'xing'xi'shang'xia	0
逡巡兮圃薮	qun'xun'xi'pu'sou	0
群众成朋兮	qun'zhong'cheng'peng'xi	0
然怊怅而无冀	ran'chao'chang'er'wu'ji	0
然怊怅而自悲	ran'chao'chang'er'zi'bei	0
然惆怅而自悲	ran'chou'chang'er'zi'bei	0
然後得瞑些	ran'hou'de'ming'xie	0
然潢洋而不可带	ran'huang'yang'er'bu'ke'dai	0
然潢洋而不遇兮	ran'huang'yang'er'bu'yu'xi	0
然欿傺而沉藏	ran'kan'chi'er'chen'cang	0
然埳轲而留滞	ran'kan'ke'er'liu'zhi	0
然欿切而永叹	ran'kan'qie'er'yong'tan	0
然容与而狐疑	ran'rong'yu'er'hu'yi	0
然芜秽而险戏	ran'wu'hui'er'xian'xi	0
然隐悯而不达兮	ran'yin'min'er'bu'da'xi	0
然霠曀而莫达	ran'yin'yi'er'mo'da	0
然中路而迷惑兮	ran'zhong'lu'er'mi'huo'xi	0
绕曲阿兮北次	rao'qu'a'xi'bei'ci	0
任重载盛兮	ren'chong'zai'sheng'xi	0
忍而不能舍也	ren'er'bu'neng'she'ye	0
人阜昌只	ren'fu'chang'zhi	0
纫蕙兮永辞	ren'hui'xi'yong'ci	0
纫秋兰以为佩	ren'qiu'lan'yi'wei'pei	0
纫荃蕙与辛夷	ren'quan'hui'yu'xin'yi	0
衽若交竿	ren'ruo'jiao'gan	0
人上栗	ren'shang'li	0
人心不可谓兮	ren'xin'bu'ke'wei'xi	0
忍尤而攘诟	ren'you'er'rang'gou	0
人有所极	ren'you'suo'ji	0
人之心不与吾心同	ren'zhi'xin'bu'yu'wu'xin'tong	0
仍羽人於丹丘兮	reng'yu'ren'yu'dan'qiu'xi	0
日安不到	ri'an'bu'dao	0
日忽忽其将暮	ri'hu'hu'qi'jiang'mu	0
日黄昏而长悲	ri'huang'hun'er'chang'bei	0
日饥馑而绝粮	ri'ji'jin'er'jue'liang	0
日渐染而不自知兮	ri'jian'ran'er'bu'zi'zhi'xi	0
日将暮兮怅忘归	ri'jiang'mu'xi'chang'wang'gui	0
日浸淫而合同	ri'jin'yin'er'he'tong	0
日康娱而自忘兮	ri'kang'yu'er'zi'wang'xi	0
日康娱以淫游	ri'kang'yu'yi'yin'you	0
日昧昧其将暮	ri'mei'mei'qi'jiang'mu	0
日眇眇而既远	ri'miao'miao'er'ji'yuan	0
日暮黄昏羌幽悲兮	ri'mu'huang'hun'qiang'you'bei'xi	0
日暾暾其西舍兮	ri'tun'tun'qi'xi'she'xi	0
日晻晻而下颓	ri'yan'yan'er'xia'tui	0
日杳杳以西颓兮	ri'yao'yao'yi'xi'tui'xi	0
日以远兮	ri'yi'yuan'xi	0
日阴曀其将暮	ri'yin'yi'qi'jiang'mu	0
日阴曀兮未光	ri'yin'yi'xi'wei'guang	0
日欲暮兮心悲	ri'yu'mu'xi'xin'bei	0
日月安属	ri'yue'an'shu	0
日月忽其不淹兮	ri'yue'hu'qi'bu'yan'xi	0
戎妇入而綵绣服	rong'fu'ru'er'cai'xiu'fu	0
容态好比	rong'tai'hao'bi	0
容与汉渚涕淫淫兮	rong'yu'han'zhu'ti'yin'yin'xi	0
容则秀雅	rong'ze'xiu'ya	0
入不言兮出不辞	ru'bu'yan'xi'chu'bu'ci	0
汝何博謇而好修兮	ru'he'bo'jian'er'hao'xiu'xi	0
挐黄梁些	ru'huang'liang'xie	0
入景响之无应兮	ru'jing'xiang'zhi'wu'ying'xi	0
如列宿之错置	ru'lie'su'zhi'cuo'zhi	0
汝筮予之	ru'shi'yu'zhi	0
入下吾不能	ru'xia'wu'bu'neng	0
入修门些	ru'xiu'men'xie	0
入溆浦余儃佪兮	ru'xu'pu'yu'shan'huai'xi	0
如脂如韦	ru'zhi'ru'wei	0
蒻阿拂壁	ruo'a'fu'bi	0
若必筮予之	ruo'bi'shi'yu'zhi	0
若华何光	ruo'hua'he'guang	0
若龙逢之沉首兮	ruo'long'feng'zhi'chen'shou'xi	0
若青蝇之伪质兮	ruo'qing'ying'zhi'wei'zhi'xi	0
弱水汨其为难兮	ruo'shui'mi'qi'wei'nan'xi	0
若鲜卑只	ruo'xian'bei'zhi	0
弱颜固植	ruo'yan'gu'zhi	0
若由夷之纯美兮	ruo'you'yi'zhi'chun'mei'xi	0
若在远行	ruo'zai'yuan'xing	0
若竹柏之异心	ruo'zhu'bai'zhi'yi'xin	0
若纵火於秋蓬	ruo'zong'huo'yu'qiu'peng	0
三公穆穆	san'gong'mu'mu	0
三光朗兮镜万方	san'guang'lang'xi'jing'wan'fang	0
三圭重侯	san'gui'zhong'hou	0
三苗之徒以放逐兮	san'miao'zhi'tu'yi'fang'zhu'xi	0
三年不得复见	san'nian'bu'de'fu'jian	0
三鸟飞以自南兮	san'niao'fei'yi'zi'nan'xi	0
三危安在	san'wei'an'zai	0
桑扈臝行	sang'hu'luo'xing	0
沙堂秀只	sha'tang'xiu'zhi	0
榝又欲充夫佩帏	sha'you'yu'chong'fu'pei'wei	0
善不由外来兮	shan'bu'you'wai'lai'xi	0
山阜兮峉峉	shan'fu'xi'e'e	0
山鬼若有人兮山之阿	shan'gui'ruo'you'ren'xi'shan'zhi'a	0
山峻高以蔽日兮	shan'jun'gao'yi'bi'ri'xi	0
山峻高以无垠兮	shan'jun'gao'yi'wu'yin'xi	0
山林险隘	shan'lin'xian'ai	0
善留客只	shan'liu'ke'zhi	0
善美明只	shan'mei'ming'zhi	0
山气巃嵸兮石嵯峨	shan'qi'long'zong'xi'shi'cuo'e	0
山曲岪	shan'qu'fu	0
山鹊兮嘤嘤	shan'que'xi'ying'ying	0
山参差以崭岩兮	shan'shen'cha'yi'zhan'yan'xi	0
山萧条而无兽兮	shan'xiao'tiao'er'wu'shou'xi	0
山修远其辽辽兮	shan'xiu'yuan'qi'liao'liao'xi	0
山中槛槛余伤怀兮	shan'zhong'kan'kan'yu'shang'huai'xi	0
山中人兮芳杜若	shan'zhong'ren'xi'fang'du'ruo	0
山中兮不可以久留	shan'zhong'xi'bu'ke'yi'jiu'liu	0
山中幽险郢路远兮	shan'zhong'you'xian'ying'lu'yuan'xi	0
尚黯黮而有瑕	shang'an'shen'er'you'xia	0
尚不知余之从容	shang'bu'zhi'yu'zhi'cong'rong	0
上察兮璇玑	shang'cha'xi'xuan'ji	0
裳襜襜而含风兮	shang'chan'chan'er'han'feng'xi	0
伤诚是之不察兮	shang'cheng'shi'zhi'bu'cha'xi	0
伤楚国之多忧	shang'chu'guo'zhi'duo'you	0
上洞庭而下江	shang'dong'ting'er'xia'jiang	0
赏罚当只	shang'fa'dang'zhi	0
商风肃而害生兮	shang'feng'su'er'hai'sheng'xi	0
上高岩之峭岸兮	shang'gao'yan'zhi'qiao'an'xi	0
尚何论乎祸凶	shang'he'lun'hu'huo'xiong	0
伤怀永哀兮	shang'huai'yong'ai'xi	0
上浸以惑	shang'jin'yi'huo	0
伤精神而寿夭	shang'jing'shen'er'shou'yao	0
伤离散之交乱兮	shang'li'san'zhi'jiao'luan'xi	0
上寥廓而无天	shang'liao'kuo'er'wu'tian	0
伤灵修之数化	shang'ling'xiu'zhi'shu'hua	0
伤明珠之赴泥兮	shang'ming'zhu'zhi'fu'ni'xi	0
上牵联於矰隿	shang'qian'lian'yu'zeng'yi	0
尚三王只	shang'san'wang'zhi	0
伤时俗兮溷乱	shang'shi'su'xi'hun'luan	0
伤时惟昊天兮昭灵	shang'shi'wei'hao'tian'xi'zhao'ling	0
伤俗兮泥浊	shang'su'xi'ni'zhuo	0
伤太息之愍怜兮	shang'tai'xi'zhi'min'lian'xi	0
上同凿枘於伏戏兮	shang'tong'zao'rui'yu'fu'xi'xi	0
上葳蕤而防露兮	shang'wei'rui'er'fang'lu'xi	0
上无所考此盛德兮	shang'wu'suo'kao'ci'sheng'de'xi	0
上下未形	shang'xia'wei'xing	0
上下兮同流	shang'xia'xi'tong'liu	0
上下悠悠只	shang'xia'you'you'zhi	0
尚贤士只	shang'xian'shi'zhi	0
伤心悲	shang'xin'bei	0
伤压次而不发兮	shang'ya'ci'er'bu'fa'xi	0
上要求於仙者	shang'yao'qiu'yu'xian'zhe	0
上有枫	shang'you'feng	0
上有兮猴猿	shang'you'xi'hou'yuan	0
尚由由而进之	shang'you'you'er'jin'zhi	0
尚欲布名乎天下	shang'yu'bu'ming'hu'tian'xia	0
伤余心之不能已	shang'yu'xin'zhi'bu'neng'yi	0
伤余心之忧忧	shang'yu'xin'zhi'you'you	0
上沅湘而分离	shang'yuan'xiang'er'fen'li	0
上至列缺兮	shang'zhi'lie'que'xi	0
少歌曰	shao'ge'yue	0
少离散亡	shao'li'san'wang	0
少司命秋兰兮麋芜	shao'si'ming'qiu'lan'xi'mi'wu	0
少须臾而释思	shao'xu'yu'er'shi'si	0
涉丹水而驼骋兮	she'dan'shui'er'tuo'cheng'xi	0
射递代些	she'di'dai'xie	0
设菰粱只	she'gu'liang'zhi	0
涉江采菱	she'jiang'cai'ling	0
涉江余幼好此奇服兮	she'jiang'yu'you'hao'ci'qi'fu'xi	0
舍君之乐处	she'jun'zhi'le'chu	0
涉青云以汎滥游兮	she'qing'yun'yi'fan'lan'you'xi	0
摄提兮运低	she'ti'xi'yun'di	0
摄提贞于孟陬兮	she'ti'zhen'yu'meng'zou'xi	0
摄衣兮缓带	she'yi'xi'huan'dai	0
设张辟以娱君兮	she'zhang'pi'yi'yu'jun'xi	0
身被疾而不閒兮	shen'bei'ji'er'bu'xian'xi	0
身不挂於罔罗	shen'bu'gua'yu'wang'luo	0
深不可测只	shen'bu'ke'ce'zhi	0
申侘傺之烦惑兮	shen'cha'chi'zhi'fan'huo'xi	0
申诚信而罔违兮	shen'cheng'xin'er'wang'wei'xi	0
申旦以舒中情兮	shen'dan'yi'shu'zhong'qing'xi	0
身服义而未沬	shen'fu'yi'er'wei'hui	0
神浮游以高历	shen'fu'you'yi'gao'li	0
神高驰之邈邈	shen'gao'chi'zhi'miao'miao	0
深固难徙	shen'gu'nan'xi	0
神光兮颎颎	shen'guang'xi'jiong'jiong	0
身衡陷而下沉兮	shen'heng'xian'er'xia'chen'xi	0
身既不容於浊世兮	shen'ji'bu'rong'yu'zhuo'shi'xi	0
身既死兮神以灵	shen'ji'si'xi'shen'yi'ling	0
深林杳以冥冥兮	shen'lin'yao'yi'ming'ming'xi	0
神龙失水而陆居兮	shen'long'shi'shui'er'lu'ju'xi	0
身憔悴而考旦兮	shen'qiao'cui'er'kao'dan'xi	0
身寝疾而日愁兮	shen'qin'ji'er'ri'chou'xi	0
身去兮意存	shen'qu'xi'yi'cun	0
谌荏弱而难持	shen'ren'ruo'er'nan'chi	0
身容与而日远	shen'rong'yu'er'ri'yuan	0
申申其詈予	shen'shen'qi'li'yu	0
申生孝而被殃	shen'sheng'xiao'er'bei'yang	0
神儵忽而不反兮	shen'tiao'hu'er'bu'fan'xi	0
申徒狄之赴渊	shen'tu'di'zhi'fu'yuan	0
神罔两而无舍	shen'wang'liang'er'wu'she	0
神要眇以淫放	shen'yao'miao'yi'yin'fang	0
审壹气之和德	shen'yi'qi'zhi'he'de	0
身永流而不还兮	shen'yong'liu'er'bu'hai'xi	0
神有所不通	shen'you'suo'bu'tong	0
身幽隐而备之	shen'you'yin'er'bei'zhi	0
神章灵篇兮	shen'zhang'ling'pian'xi	0
身至死而不得逞	shen'zhi'si'er'bu'de'cheng	0
声哀哀而怀高丘兮	sheng'ai'ai'er'huai'gao'qiu'xi	0
声嗷嗷以寂寥兮	sheng'ao'ao'yi'ji'liao'xi	0
昇车兮命仆	sheng'che'xi'ming'pu	0
声噭誂兮清和	sheng'chi'diao'xi'qing'he	0
盛鬋不同制	sheng'jian'bu'tong'zhi	0
生南国兮	sheng'nan'guo'xi	0
晟气志而过之	sheng'qi'zhi'er'guo'zhi	0
圣人不凝滞於物	sheng'ren'bu'ning'zhi'yu'wu	0
圣舜摄兮昭尧绪	sheng'shun'she'xi'zhao'yao'xu	0
生天地之若过兮	sheng'tian'di'zhi'ruo'guo'xi	0
生天坠之若过兮	sheng'tian'zhui'zhi'ruo'guo'xi	0
升县圃以眩灭	sheng'xian'pu'yi'xuan'mie	0
升虚凌冥沛浊浮清入帝宫兮	sheng'xu'ling'ming'pei'zhuo'fu'qing'ru'di'gong'xi	0
声有隐而先倡	sheng'you'yin'er'xian'chang	0
声有隐而相感兮	sheng'you'yin'er'xiang'gan'xi	0
时暧暧其将罢兮	shi'ai'ai'qi'jiang'ba'xi	0
时暧曃其曭莽兮	shi'ai'dai'qi'tang'mang'xi	0
侍陂陛些	shi'bei'bi'xie	0
时缤纷其变易兮	shi'bin'fen'qi'bian'yi'xi	0
世并举而好朋兮	shi'bing'ju'er'hao'peng'xi	0
时不当兮	shi'bu'dang'xi	0
时不可兮再得	shi'bu'ke'xi'zai'de	0
时不可兮骤得	shi'bu'ke'xi'zhou'de	0
时不可淹	shi'bu'ke'yan	0
势不可以相错	shi'bu'ke'yi'xiang'cuo	0
势不能凌波以径度兮	shi'bu'neng'ling'bo'yi'jing'du'xi	0
食不媮而为饱兮	shi'bu'tou'er'wei'bao'xi	0
蓍蔡兮踊跃	shi'cai'xi'yong'yue	0
食草木之秋实	shi'cao'mu'zhi'qiu'shi	0
石嵾嵯以翳日	shi'cen'cuo'yi'yi'ri	0
使谗谀而日得	shi'chan'yu'er'ri'de	0
时迟迟其日进兮	shi'chi'chi'qi'ri'jin'xi	0
世从俗而变化兮	shi'cong'su'er'bian'hua'xi	0
食多方些	shi'duo'fang'xie	0
十二焉分	shi'er'yan'fen	0
使芳草为薮幽	shi'fang'cao'wei'sou'you	0
时仿佛以遥见兮	shi'fang'fu'yi'yao'jian'xi	0
施芳泽只	shi'fang'ze'zhi	0
使夫百草为之不芳	shi'fu'bai'cao'wei'zhi'bu'fang	0
饰高堂些	shi'gao'tang'xie	0
释管晏而任臧获兮	shi'guan'yan'er'ren'zang'huo'xi	0
师何以尚之	shi'he'yi'shang'zhi	0
施黄棘之枉策	shi'huang'ji'zhi'wang'ce	0
时混混兮浇饡	shi'hun'hun'xi'jiao'zan	0
世溷浊而不分兮	shi'hun'zhuo'er'bu'fen'xi	0
世溷浊而不清	shi'hun'zhuo'er'bu'qing	0
世溷浊而不知	shi'hun'zhuo'er'bu'zhi	0
世溷浊而嫉贤兮	shi'hun'zhuo'er'ji'xian'xi	0
世溷浊而莫余知兮	shi'hun'zhuo'er'mo'yu'zhi'xi	0
世溷浊莫吾知	shi'hun'zhuo'mo'wu'zhi	0
时溷浊其犹未央	shi'hun'zhuo'qi'you'wei'yang	0
时溷浊犹未清兮	shi'hun'zhuo'you'wei'qing'xi	0
世既卓兮远眇眇	shi'ji'zhuo'xi'yuan'miao'miao	0
室家遂宗	shi'jia'sui'zong	0
室家盈廷	shi'jia'ying'ting	0
使江水兮安流	shi'jiang'shui'xi'an'liu	0
矢交坠兮土争先	shi'jiao'zhui'xi'tu'zheng'xian	0
始结言於庙堂兮	shi'jie'yan'yu'miao'tang'xi	0
事君而不贰兮	shi'jun'er'bu'er'xi	0
侍君之閒些	shi'jun'zhi'xian'xie	0
实孔鸾兮所居	shi'kong'luan'xi'suo'ju	0
石濑兮浅浅	shi'lai'xi'qian'qian	0
使湅雨兮灑尘	shi'lan'yu'xi'sa'chen	0
石磊磊兮葛曼曼	shi'lei'lei'xi'ge'man'man	0
世雷同而炫曜兮	shi'lei'tong'er'xuan'yao'xi	0
实满宫些	shi'man'gong'xie	0
事绵绵而多私兮	shi'mian'mian'er'duo'si'xi	0
世莫可以寄讬	shi'mo'ke'yi'ji'tuo	0
世莫知其所如	shi'mo'zhi'qi'suo'ru	0
士莫志兮羔裘	shi'mo'zhi'xi'gao'qiu	0
士女杂坐	shi'nv'za'zuo	0
实沛徂兮	shi'pei'cu'xi	0
时昢昢兮且旦	shi'po'po'xi'qie'dan	0
使麒麟可得羁而係兮	shi'qi'lin'ke'de'ji'er'xi'xi	0
世人皆浊	shi'ren'jie'zhuo	0
十日代出	shi'ri'dai'chu	0
使日月乎无光	shi'ri'yue'hu'wu'guang	0
食时至兮增泉	shi'shi'zhi'xi'zeng'quan	0
豕首纵目	shi'shou'zong'mu	0
世孰可为明之	shi'shu'ke'wei'ming'zhi	0
世孰云而知之	shi'shu'yun'er'zhi'zhi	0
世俗更而变化兮	shi'su'geng'er'bian'hua'xi	0
使素女兮鼓簧	shi'su'nv'xi'gu'huang	0
视儵忽而无见兮	shi'tiao'hu'er'wu'jian'xi	0
师望在肆	shi'wang'zai'si	0
时亹亹而过中兮	shi'wei'wei'er'guo'zhong'xi	0
事亹亹而觊进兮	shi'wei'wei'er'ji'jin'xi	0
使湘灵鼓瑟兮	shi'xiang'ling'gu'se'xi	0
使枭杨先导兮	shi'xiao'yang'xian'dao'xi	0
时厌饫而不用兮	shi'yan'yu'er'bu'yong'xi	0
世殽乱犹未察	shi'yao'luan'you'wei'cha	0
是以见放	shi'yi'jian'fang	0
时亦冉冉而将至	shi'yi'ran'ran'er'jiang'zhi	0
时亦犹其未央	shi'yi'you'qi'wei'yang	0
世幽昧以昡曜兮	shi'you'mei'yi'xuan'yao'xi	0
施玉色而外淫	shi'yu'shai'er'wai'yin	0
实羽觞些	shi'yu'shang'xie	0
食元气兮长存	shi'yuan'qi'xi'chang'cun	0
適昭明兮所处	shi'zhao'ming'xi'suo'chu	0
使贞臣为无由	shi'zhen'chen'wei'wu'you	0
失志兮悠悠	shi'zhi'xi'you'you	0
视忠正之何若	shi'zhong'zheng'zhi'he'ruo	0
室中之观	shi'zhong'zhi'guan	0
释舟陵行	shi'zhou'ling'xing	0
使祝融兮先行	shi'zhu'rong'xi'xian'xing	0
受赐兹醢	shou'ci'zi'hai	0
寿何所止	shou'he'suo'zhi	0
收恢台之孟夏兮	shou'hui'tai'zhi'meng'xia'xi	0
受礼天下	shou'li'tian'xia	0
收潦而水清	shou'liao'er'shui'qing	0
受命不迁	shou'ming'bu'qian	0
受命诏以昭诗	shou'ming'zhao'yi'zhao'shi	0
寿冉冉而日衰兮	shou'ran'ran'er'ri'shuai'xi	0
寿冉冉而愈衰	shou'ran'ran'er'yu'shuai	0
首身离兮心不惩	shou'shen'li'xi'xin'bu'cheng	0
受寿永多	shou'shou'yong'duo	0
受物之汶汶者乎	shou'wu'zhi'wen'wen'zhe'hu	0
授殷天下	shou'yin'tian'xia	0
守志陟玉峦兮逍遥	shou'zhi'zhi'yu'luan'xi'xiao'yao	0
舒并节以驰骛兮	shu'bing'jie'yi'chi'wu'xi	0
孰不实而有穫	shu'bu'shi'er'you'huo	0
孰察其揆正	shu'cha'qi'kui'zheng	0
孰初作之	shu'chu'zuo'zhi	0
叔旦不嘉	shu'dan'bu'jia	0
孰道尚之	shu'dao'shang'zhi	0
舒芳兮振条	shu'fang'xi'zhen'tiao	0
孰非善而可服	shu'fei'shan'er'ke'fu	0
疏缓节兮安歌	shu'huan'jie'xi'an'ge	0
述皇舆之踵迹	shu'huang'yu'zhi'zhong'ji	0
孰江河之可涸	shu'jiang'he'zhi'ke'he	0
孰魁摧之可久兮	shu'kui'cui'zhi'ke'jiu'xi	0
属雷师之阗阗兮	shu'lei'shi'zhi'tian'tian'xi	0
菽藟兮蔓衍	shu'lei'xi'man'yan	0
庶类以成兮	shu'lei'yi'cheng'xi	0
淑离不淫	shu'li'bu'yin	0
孰离合兮可为	shu'li'he'xi'ke'wei	0
孰两东门之可芜	shu'liang'dong'men'zhi'ke'wu	0
树轮相纠兮林木茷骫	shu'lun'xiang'jiu'xi'lin'mu'pei'wei	0
殊能将之	shu'neng'jiang'zhi	0
孰能若兮原为辅	shu'neng'ruo'xi'yuan'wei'fu	0
孰能施於无报	shu'neng'shi'yu'wu'bao	0
孰能思而不隐兮	shu'neng'si'er'bu'yin'xi	0
漱凝霜之雰雰	shu'ning'shuang'zhi'fen'fen	0
舒佩兮綝纚	shu'pei'xi'shen'xi	0
叔齐久而逾明	shu'qi'jiu'er'yu'ming	0
孰契契而委栋兮	shu'qi'qi'er'wei'dong'xi	0
孰期去斯	shu'qi'qu'si	0
孰侵辱之可为	shu'qin'ru'zhi'ke'wei	0
舒情陈诗冀以自免兮	shu'qing'chen'shi'ji'yi'zi'mian'xi	0
孰求美而释女	shu'qiu'mei'er'shi'nv	0
蠋入兮我怀	shu'ru'xi'wo'huai	0
孰申旦而别之	shu'shen'dan'er'bie'zhi	0
孰使萃之	shu'shi'cui'zhi	0
疏石兰兮为芳	shu'shi'lan'xi'wei'fang	0
孰使乱惑	shu'shi'luan'huo	0
属天命而委之咸池	shu'tian'ming'er'wei'zhi'xian'chi	0
数惟荪之多怒兮	shu'wei'sun'zhi'duo'nu'xi	0
孰为忠直	shu'wei'zhong'zhi	0
孰无施而有报兮	shu'wu'shi'er'you'bao'xi	0
孰信修而慕之	shu'xin'xiu'er'mu'zhi	0
孰虚伪之可长	shu'xu'wei'zhi'ke'chang	0
数言便事兮	shu'yan'bian'shi'xi	0
孰营度之	shu'ying'du'zhi	0
数有所不逮	shu'you'suo'bu'dai	0
孰由兮贤者	shu'you'xi'xian'zhe	0
舒忧娱哀兮	shu'you'yu'ai'xi	0
摅羽翮兮超俗	shu'yu'he'xi'chao'su	0
孰云察余之善恶	shu'yun'cha'yu'zhi'shan'e	0
孰云察余之中情	shu'yun'cha'yu'zhi'zhong'qing	0
孰云知其所至	shu'yun'zhi'qi'suo'zhi	0
孰哉复加加	shu'zai'fu'jia'jia	0
属贞臣而日娭	shu'zhen'chen'er'ri'ai	0
漱正阳而含朝霞	shu'zheng'yang'er'han'zhao'xia	0
孰知察其黑白	shu'zhi'cha'qi'hei'bai	0
树枳棘与薪柴	shu'zhi'ji'yu'xin'chai	0
孰制匠之	shu'zhi'jiang'zhi	0
孰知其不合兮	shu'zhi'qi'bu'he'xi	0
孰知其故	shu'zhi'qi'gu	0
孰知余之从容	shu'zhi'yu'zhi'cong'rong	0
衰色罔兮中怠	shuai'se'wang'xi'zhong'dai	0
帅云霓而来御	shuai'yun'ni'er'lai'yu	0
霜露惨悽而交下兮	shuang'lu'can'qi'er'jiao'xia'xi	0
霜雪兮漼溰	shuang'xue'xi'cui'ai	0
水背流而源竭兮	shui'bei'liu'er'yuan'jie'xi	0
水滨之木	shui'bin'zhi'mu	0
水波远以冥冥兮	shui'bo'yuan'yi'ming'ming'xi	0
谁传道之	shui'chuan'dao'zhi	0
谁可与玩此遗芳	shui'ke'yu'wan'ci'yi'fang	0
谁可与玩斯遗芳兮	shui'ke'yu'wan'si'yi'fang'xi	0
谁可与兮寤语	shui'ke'yu'xi'wu'yu	0
谁可与兮终生	shui'ke'yu'xi'zhong'sheng	0
水流汤汤	shui'liu'shang'shang	0
谁能极之	shui'neng'ji'zhi	0
谁使正其真是兮	shui'shi'zheng'qi'zhen'shi'xi	0
谁所极焉	shui'suo'ji'yan	0
水跃兮余旌	shui'yue'xi'yu'jing	0
谁知其数	shui'zhi'qi'shu	0
谁知吾之廉贞	shui'zhi'wu'zhi'lian'zhen	0
水周兮堂下	shui'zhou'xi'tang'xia	0
顺波凑而下降	shun'bo'cou'er'xia'jiang	0
顺长濑之浊流	shun'chang'lai'zhi'zhuo'liu	0
顺风波以从流兮	shun'feng'bo'yi'cong'liu'xi	0
顺风波以南北兮	shun'feng'bo'yi'nan'bei'xi	0
舜服厥弟	shun'fu'jue'di	0
顺极兮彷徉	shun'ji'xi'pang'yang	0
顺凯风以从游兮	shun'kai'feng'yi'cong'you'xi	0
顺弥代些	shun'mi'dai'xie	0
舜闵在家	shun'min'zai'jia	0
眴兮杳杳	shun'xi'yao'yao	0
顺欲成功	shun'yu'cheng'gong	0
吮玉液兮止渴	shun'yu'ye'xi'zhi'ke	0
说操筑於傅岩兮	shuo'cao'zhu'yu'fu'yan'xi	0
愬灵怀之鬼神	shuo'ling'huai'zhi'gui'shen	0
思比干之恲恲兮	si'bi'gan'zhi'peng'peng'xi	0
驷跛虌而上山兮	si'bo'bie'er'shang'shan'xi	0
思不眠以至曙	si'bu'mian'yi'zhi'shu	0
思沉抑而不扬	si'chen'yi'er'bu'yang	0
汜崇兰些	si'chong'lan'xie	0
思丁文兮圣明哲	si'ding'wen'xi'sheng'ming'zhe	0
四方之门	si'fang'zhi'men	0
思夫君兮太息	si'fu'jun'xi'tai'xi	0
思怫郁兮肝切剥	si'fu'yu'xi'gan'qie'bo	0
思哽饐兮诘诎	si'geng'yi'xi'ji'qu	0
思公子兮徒离忧	si'gong'zi'xi'tu'li'you	0
思公子兮未敢言	si'gong'zi'xi'wei'gan'yan	0
思古冥冥深林兮树木郁郁	si'gu'ming'ming'shen'lin'xi'shu'mu'yu'yu	0
思国家之离沮兮	si'guo'jia'zhi'li'ju'xi	0
思还流而复反	si'hai'liu'er'fu'fan	0
思蹇产而不释	si'jian'chan'er'bu'shi	0
思蹇产之不释兮	si'jian'chan'zhi'bu'shi'xi	0
思旧故以想像兮	si'jiu'gu'yi'xiang'xiang'xi	0
思久故之亲身兮	si'jiu'gu'zhi'qin'shen'xi	0
思九州之博大兮	si'jiu'zhou'zhi'bo'da'xi	0
思君其莫我忠兮	si'jun'qi'mo'wo'zhong'xi	0
思君兮无聊	si'jun'xi'wu'liao	0
死林薄兮	si'lin'bo'xi	0
思灵保兮贤姱	si'ling'bao'xi'xian'kua	0
思灵泽兮一膏沐	si'ling'ze'xi'yi'gao'mu	0
斯路渐	si'lu'jian	0
驷马惊而横奔	si'ma'jing'er'heng'ben	0
思美人思美人兮	si'mei'ren'si'mei'ren'xi	0
思南郢之旧俗兮	si'nan'ying'zhi'jiu'su'xi	0
思念郢路兮	si'nian'ying'lu'xi	0
四佞放兮後得禹	si'ning'fang'xi'hou'de'yu	0
思彭咸之故也	si'peng'xian'zhi'gu'ye	0
思彭咸之水游	si'peng'xian'zhi'shui'you	0
死日将至兮	si'ri'jiang'zhi'xi	0
汜容与而遐举兮	si'rong'yu'er'xia'ju'xi	0
四上竞气	si'shang'jing'qi	0
四时递来而卒岁兮	si'shi'di'lai'er'zu'sui'xi	0
俟时风之清激兮	si'shi'feng'zhi'qing'ji'xi	0
斯无穷乎	si'wu'qiong'hu	0
斯言谁告兮	si'yan'shui'gao'xi	0
思尧舜兮袭兴	si'yao'shun'xi'xi'xing	0
驷玉虬以桀鹥兮	si'yu'qiu'yi'jie'yi'xi	0
思余俗之流风兮	si'yu'su'zhi'liu'feng'xi	0
思怨移只	si'yuan'yi'zhi	0
死则又育	si'ze'you'yu	0
思忠登九灵兮游神	si'zhong'deng'jiu'ling'xi'you'shen	0
四酎并孰	si'zhou'bing'shu	0
私自怜兮何极	si'zi'lian'xi'he'ji	0
慫长剑兮拥幼艾	song'chang'jian'xi'yong'you'ai	0
送将归	song'jiang'gui	0
送美人兮南浦	song'mei'ren'xi'nan'pu	0
讼谓闾娵为丑恶	song'wei'lv'ju'wei'chou'e	0
竦余驾兮入冥	song'yu'jia'xi'ru'ming	0
竦余剑兮干将	song'yu'jian'xi'gan'jiang	0
宿北姑兮	su'bei'gu'xi	0
苏粪壤以充祎兮	su'fen'rang'yi'chong'yi'xi	0
溯高风以低佪兮	su'gao'feng'yi'di'huai'xi	0
俗嫉妒而蔽贤兮	su'ji'du'er'bi'xian'xi	0
溯江潭兮	su'jiang'tan'xi	0
俗流从而不止兮	su'liu'cong'er'bu'zhi'xi	0
俗岒峨而嵾嵯	su'qian'e'er'cen'cuo	0
苏世独立	su'shi'du'li	0
俗推佞而进富兮	su'tui'ning'er'jin'fu'xi	0
诉五帝以置辞	su'wu'di'yi'zhi'ci	0
遂不禦乎千里	sui'bu'yu'hu'qian'li	0
虽不周於今之人兮	sui'bu'zhou'yu'jin'zhi'ren'xi	0
遂侧身而既远	sui'ce'shen'er'ji'yuan	0
遂曾闳而迫身	sui'ceng'hong'er'po'shen	0
遂成考功	sui'cheng'kao'gong	0
遂驰骋兮升云	sui'chi'cheng'xi'sheng'yun	0
随风靡而成行	sui'feng'mi'er'cheng'xing	0
虽过失犹弗治	sui'guo'shi'you'fu'zhi	0
岁忽忽而不反	sui'hu'hu'er'bu'fan	0
岁忽忽而遒尽兮	sui'hu'hu'er'qiu'jin'xi	0
岁忽忽其若颓	sui'hu'hu'qi'ruo'tui	0
岁曶曶其若颓兮	sui'hu'hu'qi'ruo'tui'xi	0
岁忽忽兮惟暮	sui'hu'hu'xi'wei'mu	0
岁既晏兮孰华予	sui'ji'yan'xi'shu'hua'yu	0
虽謇謇以申志兮	sui'jian'jian'yi'shen'zhi'xi	0
遂见排而逢谗	sui'jian'pai'er'feng'chan	0
虽九死其犹未悔	sui'jiu'si'qi'you'wei'hui	0
遂闷叹而无名	sui'men'tan'er'wu'ming	0
虽灭没之自乐	sui'mie'mo'zhi'zi'le	0
遂没身而不反	sui'mo'shen'er'bu'fan	0
岁暮兮不自聊	sui'mu'xi'bu'zi'liao	0
虽僻远之何伤	sui'pi'yuan'zhi'he'shang	0
随飘风之所仍	sui'piao'feng'zhi'suo'reng	0
遂去不复与言	sui'qu'bu'fu'yu'yan	0
遂踢达兮邪造	sui'ti'da'xi'xie'zao	0
虽体解其不变兮	sui'ti'jie'qi'bu'bian'xi	0
虽体解吾犹未变兮	sui'ti'jie'wu'you'wei'bian'xi	0
遂儵忽而扪天	sui'tiao'hu'er'men'tian	0
遂萎绝而离异	sui'wei'jue'er'li'yi	0
虽萎绝其亦何伤兮	sui'wei'jue'qi'yi'he'shang'xi	0
虽翕翅其不容	sui'xi'chi'qi'bu'rong	0
虽信美而无礼兮	sui'xin'mei'er'wu'li'xi	0
虽有八师而不可为	sui'you'ba'shi'er'bu'ke'wei	0
虽有西施之美容兮	sui'you'xi'shi'zhi'mei'rong'xi	0
虽原忠其焉得	sui'yuan'zhong'qi'yan'de	0
随真人兮翱翔	sui'zhen'ren'xi'ao'xiang	0
虽知困其不改操兮	sui'zhi'kun'qi'bu'gai'cao'xi	0
虽重介之何益	sui'zhong'jie'zhi'he'yi	0
虽重追吾何及	sui'zhong'zhui'wu'he'ji	0
遂自忍而沉流	sui'zi'ren'er'chen'liu	0
荪壁兮紫坛	sun'bi'xi'zi'tan	0
荪独宜兮为民正	sun'du'yi'xi'wei'min'zheng	0
荪何以兮愁苦	sun'he'yi'xi'chou'ku	0
荪桡兮兰旌	sun'rao'xi'lan'jing	0
荪详聋而不闻	sun'xiang'long'er'bu'wen	0
索胡绳之纚纚	suo'hu'sheng'zhi'xi'xi	0
索琼茅以筳篿兮	suo'qiong'mao'yi'ting'tuan'xi	0
所行几里	suo'xing'ji'li	0
所以证之不远	suo'yi'zheng'zhi'bu'yuan	0
所作忠而言之兮	suo'zuo'zhong'er'yan'zhi'xi	0
太公不遇文王兮	tai'gong'bu'yu'wen'wang'xi	0
太公九十乃显荣兮	tai'gong'jiu'shi'nai'xian'rong'xi	0
太一为余听之	tai'yi'wei'yu'ting'zhi	0
叹离骚以扬意兮	tan'li'sao'yi'yang'yi'xi	0
贪枉兮党比	tan'wang'xi'dang'bi	0
叹曰	tan'yue	0
汤出重泉	tang'chu'zhong'quan	0
汤谷寂寥只	tang'gu'ji'liao'zhi	0
汤何殛焉	tang'he'ji'yan	0
汤谋易旅	tang'mou'yi'lv	0
倘佯垆阪沼水深兮	tang'yang'lu'ban'zhao'shui'shen'xi	0
唐虞点灼而毁议	tang'yu'dian'zhuo'er'hui'yi	0
汤禹久远兮	tang'yu'jiu'yuan'xi	0
唐虞兮不存	tang'yu'xi'bu'cun	0
汤禹俨而求合兮	tang'yu'yan'er'qiu'he'xi	0
汤禹俨而祗敬兮	tang'yu'yan'er'zhi'jing'xi	0
陶嘉月兮总驾	tao'jia'yue'xi'zong'jia	0
檮木兰以矫蕙兮	tao'mu'lan'yi'jiao'hui'xi	0
陶壅览杳杳兮世惟	tao'yong'lan'yao'yao'xi'shi'wei	0
特处兮茕茕	te'chu'xi'qiong'qiong	0
腾告鸾鸟迎宓妃	teng'gao'luan'niao'ying'mi'fei	0
腾驾步游	teng'jia'bu'you	0
腾驾橐驼	teng'jia'tuo'tuo	0
腾驴骡以驰逐	teng'lv'luo'yi'chi'zhu	0
腾群鹤於瑶光	teng'qun'he'yu'yao'guang	0
腾蛇兮後从	teng'she'xi'hou'cong	0
腾众车使径待	teng'zhong'che'shi'jing'dai	0
体便娟只	ti'bian'juan'zhi	0
涕潺湲兮下霑轼	ti'chan'yuan'xi'xia'zhan'shi	0
涕横集而成行	ti'heng'ji'er'cheng'xing	0
鹈集兮帷幄	ti'ji'xi'wei'wo	0
涕渐渐其若屑	ti'jian'jian'qi'ruo'xie	0
涕流交集兮	ti'liu'jiao'ji'xi	0
涕流澜兮如雨	ti'liu'lan'xi'ru'yu	0
涕流滂沲	ti'liu'pang'tuo	0
涕泣交而凄凄兮	ti'qi'jiao'er'qi'qi'xi	0
涕泣流乎於悒	ti'qi'liu'hu'yu'yi	0
体溶溶而东回	ti'rong'rong'er'dong'hui	0
涕淫淫其若霰	ti'yin'yin'qi'ruo'xian	0
天白颢颢	tian'bai'hao'hao	0
天德明只	tian'de'ming'zhi	0
天地四方	tian'di'si'fang	0
天高而气清	tian'gao'er'qi'qing	0
天何所沓	tian'he'suo'ta	0
天极焉加	tian'ji'yan'jia	0
天命反侧	tian'ming'fan'ce	0
搷鸣鼓些	tian'ming'gu'xie	0
天生我兮当闇时	tian'sheng'wo'xi'dang'an'shi	0
天式从横	tian'shi'cong'heng	0
天时懟兮威灵怒	tian'shi'dui'xi'wei'ling'nu	0
恬死亡而不聊	tian'si'wang'er'bu'liao	0
天庭明兮云霓藏	tian'ting'ming'xi'yun'ni'cang	0
天问曰遂古之初	tian'wen'yue'sui'gu'zhi'chu	0
田邑千畛	tian'yi'qian'zhen	0
儵而来兮忽而逝	tiao'er'lai'xi'hu'er'shi	0
调以娱只	tiao'yi'yu'zhi	0
挑揄扬汰荡迅疾兮	tiao'yu'yang'tai'dang'xun'ji'xi	0
听波声之汹汹	ting'bo'sheng'zhi'xiong'xiong	0
听谗人之虚辞	ting'chan'ren'zhi'xu'ci	0
听惝怳而无闻	ting'chang'huang'er'wu'wen	0
听潮水之相击	ting'chao'shui'zhi'xiang'ji	0
听大壑之波声	ting'da'he'zhi'bo'sheng	0
听歌譔只	ting'ge'zhuan'zhi	0
听奸臣之浮说兮	ting'jian'chen'zhi'fu'shuo'xi	0
听类神只	ting'lei'shen'zhi	0
听王后兮吹竽	ting'wang'hou'xi'chui'yu	0
听玄鹤之晨鸣兮	ting'xuan'he'zhi'chen'ming'xi	0
痛楚国之流亡兮	tong'chu'guo'zhi'liu'wang'xi	0
通飞廉之衙衙	tong'fei'lian'zhi'ya'ya	0
痛凤兮远逝	tong'feng'xi'yuan'shi	0
同极而异路兮	tong'ji'er'yi'lu'xi	0
同类者相似	tong'lei'zhe'xiang'si	0
通路天门兮坠户	tong'lu'tian'men'xi'zhui'hu	0
同驽鸁与乘駔兮	tong'nu'luo'yu'cheng'zang'xi	0
同权概而就衡	tong'quan'gai'er'jiu'heng	0
同糅玉石兮	tong'rou'yu'shi'xi	0
同心赋些	tong'xin'fu'xie	0
同音者相和兮	tong'yin'zhe'xiang'he'xi	0
痛忠言之逆耳兮	tong'zhong'yan'zhi'ni'er'xi	0
投剑兮脱冕	tou'jian'xi'tuo'mian	0
投诗赋只	tou'shi'fu'zhi	0
偷以全吾躯乎	tou'yi'quan'wu'qu'hu	0
投之深渊些	tou'zhi'shen'yuan'xie	0
投之於冰上	tou'zhi'yu'bing'shang	0
土伯九约	tu'bo'jiu'yue	0
涂漫漫其无时	tu'man'man'qi'wu'shi	0
吐紫华兮布条	tu'zi'hua'xi'bu'tiao	0
貒貉兮蟫蟫	tuan'hao'xi'xun'xun	0
退顾兮彭务	tui'gu'xi'peng'wu	0
退将复修吾初服	tui'jiang'fu'xiu'wu'chu'fu	0
退静默而莫余知兮	tui'jing'mo'er'mo'yu'zhi'xi	0
颓流下陨身日远兮	tui'liu'xia'yun'shen'ri'yuan'xi	0
忳惛惛而愁约	tun'hun'hun'er'chou'yue	0
吞人以益其心些	tun'ren'yi'yi'qi'xin'xie	0
屯余车其千乘兮	tun'yu'che'qi'qian'sheng'xi	0
屯余车兮黄支	tun'yu'che'xi'huang'zhi	0
屯余车兮索友	tun'yu'che'xi'suo'you	0
屯余车之万乘兮	tun'yu'che'zhi'wan'sheng'xi	0
忳郁邑余佗傺兮	tun'yu'yi'yu'tuo'chi'xi	0
讬回飙乎尚羊	tuo'hui'biao'hu'shang'yang	0
讬彭咸之所居	tuo'peng'xian'zhi'suo'ju	0
瓦釜雷鸣	wa'fu'lei'ming	0
瓦砾进宝兮	wa'li'jin'bao'xi	0
外承欢之汋约兮	wai'cheng'huan'zhi'que'yue'xi	0
外彷徨而游览兮	wai'pang'huang'er'you'lan'xi	0
外迫胁於机臂兮	wai'po'xie'yu'ji'bi'xi	0
菀彼青青泣如颓兮	wan'bi'qing'qing'qi'ru'tui'xi	0
万变其情岂可盖兮	wan'bian'qi'qing'qi'ke'gai'xi	0
刓方以为圜兮	wan'fang'yi'wei'huan'xi	0
菀蘼芜与菌若兮	wan'mi'wu'yu'jun'ruo'xi	0
万民理只	wan'min'li'zhi	0
玩琴书兮游戏	wan'qin'shu'xi'you'xi	0
万物遽只	wan'wu'ju'zhi	0
望北山而流涕兮	wang'bei'shan'er'liu'ti'xi	0
罔薜荔兮为帷	wang'bi'li'xi'wei'wei	0
王不察其长利兮	wang'bu'cha'qi'chang'li'xi	0
望涔阳兮极浦	wang'cen'yang'xi'ji'pu	0
望长楸而太息兮	wang'chang'qiu'er'tai'xi'xi	0
枉车登兮庆云	wang'che'deng'xi'qing'yun	0
望大河之洲渚兮	wang'da'he'zhi'zhou'zhu'xi	0
望夫君兮未来	wang'fu'jun'xi'wei'lai	0
望高丘而叹涕兮	wang'gao'qiu'er'tan'ti'xi	0
望高山之蹇产	wang'gao'shan'zhi'jian'chan	0
网户硃缀	wang'hu'zhu'zhui	0
望淮兮沛沛	wang'huai'xi'pei'pei	0
王虺骞只	wang'hui'qian'zhi	0
望江汉兮濩渃	wang'jiang'han'xi'hu'luo	0
望旧邦兮路逶随	wang'jiu'bang'xi'lu'wei'sui	0
望旧邦之黯黮兮	wang'jiu'bang'zhi'an'shen'xi	0
往恐危身些	wang'kong'wei'shen'xie	0
往来鯈忽	wang'lai'chou'hu	0
往来侁侁些	wang'lai'shen'shen'xie	0
望阆风之板桐	wang'lang'feng'zhi'ban'tong	0
罔流涕以聊虑兮	wang'liu'ti'yi'liao'lv'xi	0
罔芒芒之无纪	wang'mang'mang'zhi'wu'ji	0
望孟夏之短夜兮	wang'meng'xia'zhi'duan'ye'xi	0
望南郢而闚之	wang'nan'ying'er'kui'zhi	0
望泞美兮未来	wang'ning'mei'xi'wei'lai	0
望三五以为像兮	wang'san'wu'yi'wei'xiang'xi	0
王孙兮归来	wang'sun'xi'gui'lai	0
王孙游兮不归	wang'sun'you'xi'bu'gui	0
罔所兮归薄	wang'suo'xi'gui'bo	0
望太微兮穆穆	wang'tai'wei'xi'mu'mu	0
望太一兮淹息	wang'tai'yi'xi'yan'xi	0
望溪谷兮滃郁	wang'xi'gu'xi'weng'yu	0
罔兮沕	wang'xi'wu	0
忘儇媚以背众兮	wang'xuan'mei'yi'bei'zhong'xi	0
望崦嵫而勿迫	wang'yan'zi'er'wu'po	0
望瑶台之偃蹇兮	wang'yao'tai'zhi'yan'jian'xi	0
枉玉衡於炎火兮	wang'yu'heng'yu'yan'huo'xi	0
往者不可扳援兮	wang'zhe'bu'ke'ban'yuan'xi	0
往者不可及兮	wang'zhe'bu'ke'ji'xi	0
往者余弗及兮	wang'zhe'yu'fu'ji'xi	0
妄周容而入世兮	wang'zhou'rong'er'ru'shi'xi	0
王子比干之逢醢	wang'zi'bi'gan'zhi'feng'hai	0
王子比干之横废	wang'zi'bi'gan'zhi'heng'fei	0
惟草木之零落兮	wei'cao'mu'zhi'ling'luo'xi	0
味豺羹只	wei'chai'geng'zhi	0
惟楚怀之婵连	wei'chu'huai'zhi'chan'lian	0
惟此党人其独异	wei'ci'dang'ren'qi'du'yi	0
惟此党人之不谅兮	wei'ci'dang'ren'zhi'bu'liang'xi	0
惟党人之偷乐兮	wei'dang'ren'zhi'tou'le'xi	0
惟烦懑而盈匈	wei'fan'men'er'ying'xiong	0
谓凤皇兮安栖	wei'feng'huang'xi'an'qi	0
为凤皇作鹑笼兮	wei'feng'huang'zuo'chun'long'xi	0
未改此度	wei'gai'ci'du	0
未改此度也	wei'gai'ci'du'ye	0
惟庚寅吾以降	wei'geng'yin'wu'yi'jiang	0
违故乡之漫漫	wei'gu'xiang'zhi'man'man	0
微观兮玄圃	wei'guan'xi'xuan'pu	0
危害厥兄	wei'hai'jue'xiong	0
惟何戒之	wei'he'jie'zhi	0
谓蕙若其不可佩	wei'hui'ruo'qi'bu'ke'pei	0
惟魂是索些	wei'hun'shi'suo'xie	0
惟极浦兮寤怀	wei'ji'pu'xi'wu'huai	0
委积兮从横	wei'ji'xi'cong'heng	0
惟佳人之独怀兮	wei'jia'ren'zhi'du'huai'xi	0
惟佳人之永都兮	wei'jia'ren'zhi'yong'dou'xi	0
惟椒兰之不反兮	wei'jiao'lan'zhi'bu'fan'xi	0
惟浇在户	wei'jiao'zai'hu	0
委厥美而历兹	wei'jue'mei'er'li'zi	0
委厥美以从俗兮	wei'jue'mei'yi'cong'su'xi	0
危俊林不容兮鸣蜩	wei'jun'lin'bu'rong'xi'ming'tiao	0
违君兮归真	wei'jun'xi'gui'zhen	0
委两馆于咸唐	wei'liang'guan'yu'xian'tang	0
维六龙於扶桑	wei'liu'long'yu'fu'sang	0
为蝼蚁之所裁	wei'lou'yi'zhi'suo'cai	0
罻罗张而在下	wei'luo'zhang'er'zai'xia	0
骫靡兮成俗	wei'mi'xi'cheng'su	0
惟其纷糅而将落兮	wei'qi'fen'rou'er'jiang'luo'xi	0
维其何故	wei'qi'he'gu	0
谓骐骥兮安归	wei'qi'ji'xi'an'gui	0
违群小兮謑訽	wei'qun'xiao'xi'xia'gou	0
谓申椒其不芳	wei'shen'jiao'qi'bu'fang	0
惟时何为	wei'shi'he'wei	0
惟时俗兮疾正	wei'shi'su'xi'ji'zheng	0
惟是兮用忧	wei'shi'xi'yong'you	0
微霜降而下戒	wei'shuang'jiang'er'xia'jie	0
微霜降而下沦兮	wei'shuang'jiang'er'xia'lun'xi	0
微霜降之蒙蒙	wei'shuang'jiang'zhi'meng'meng	0
微霜兮眇眇	wei'shuang'xi'miao'miao	0
微霜下而夜降	wei'shuang'xia'er'ye'jiang	0
惟天地之无穷兮	wei'tian'di'zhi'wu'qiong'xi	0
惟天禄兮不再	wei'tian'lu'xi'bu'zai	0
亹亹兮自强	wei'wei'xi'zi'qiang	0
违郢都之旧闾兮	wei'ying'dou'zhi'jiu'lv'xi	0
惟郢路之辽远兮	wei'ying'lu'zhi'liao'yuan'xi	0
惟郢路之遥远兮	wei'ying'lu'zhi'yao'yuan'xi	0
谓幽兰其不可佩	wei'you'lan'qi'bu'ke'pei	0
为余驾飞龙兮	wei'yu'jia'fei'long'xi	0
为余先乎平路	wei'yu'xian'hu'ping'lu	0
委玉质兮於泥涂	wei'yu'zhi'xi'yu'ni'tu	0
唯昭质其犹未亏	wei'zhao'zhi'qi'you'wei'kui	0
未知兮所投	wei'zhi'xi'suo'tou	0
惟著意而得之	wei'zhu'yi'er'de'zhi	0
惟兹何功	wei'zi'he'gong	0
惟兹佩之可贵兮	wei'zi'pei'zhi'ke'gui'xi	0
闻百里之为虏兮	wen'bai'li'zhi'wei'lu'xi	0
文采耀燿於玉石	wen'cai'yao'yao'yu'yu'shi	0
闻赤松之清尘兮	wen'chi'song'zhi'qing'chen'xi	0
问大微之所居	wen'da'wei'zhi'suo'ju	0
闻佳人兮召予	wen'jia'ren'xi'zhao'yu	0
闻见又寡	wen'jian'you'gua	0
文君寤而追求	wen'jun'wu'er'zhui'qiu	0
闻雷兮阗阗	wen'lei'xi'tian'tian	0
闻南籓乐而欲往兮	wen'nan'fan'le'er'yu'wang'xi	0
闻省想而不可得	wen'sheng'xiang'er'bu'ke'de	0
闻素女兮微歌	wen'su'nv'xi'wei'ge	0
问天道之所在	wen'tian'dao'zhi'suo'zai	0
文异豹饰	wen'yi'bao'shi	0
文鱼兮上濑	wen'yu'xi'shang'lai	0
文缘波些	wen'yuan'bo'xie	0
文章烂兮	wen'zhang'lan'xi	0
闻至贵而遂徂兮	wen'zhi'gui'er'sui'cu'xi	0
文质疏内兮	wen'zhi'shu'nei'xi	0
偓促谈於廊庙兮	wo'cu'tan'yu'lang'miao'xi	0
握剞劂而不用兮	wo'ji'jue'er'bu'yong'xi	0
我决死而不生兮	wo'jue'si'er'bu'sheng'xi	0
握佩玖兮中路躇	wo'pei'jiu'xi'zhong'lu'chu	0
握申椒与杜若兮	wo'shen'jiao'yu'du'ruo'xi	0
握神精兮雍容	wo'shen'jing'xi'yong'rong	0
斡维焉系	wo'wei'yan'xi	0
我心兮煎熬	wo'xin'xi'jian'ao	0
喔咿嚅唲	wo'yi'ru'er	0
我又何言	wo'you'he'yan	0
我欲辅之	wo'yu'fu'zhi	0
无伯乐之相善兮	wu'bo'le'zhi'xiang'shan'xi	0
吾不能变心而从俗兮	wu'bu'neng'bian'xin'er'cong'su'xi	0
寤从容以周流兮	wu'cong'rong'yi'zhou'liu'xi	0
武丁用而不疑	wu'ding'yong'er'bu'yi	0
无东无西	wu'dong'wu'xi	0
吾独乖剌而无当兮	wu'du'guai'la'er'wu'dang'xi	0
吾独穷困乎此时也	wu'du'qiong'kun'hu'ci'shi'ye	0
吾独死而後已	wu'du'si'er'hou'yi	0
武发杀殷	wu'fa'sha'yin	0
吾方高驰而不顾	wu'fang'gao'chi'er'bu'gu	0
吾告堵敖以不长	wu'gao'du'ao'yi'bu'chang	0
五榖不生	wu'gu'bu'sheng	0
五榖六仞	wu'gu'liu'ren	0
吾固知乎命之不长	wu'gu'zhi'hu'ming'zhi'bu'chang	0
吾固知其不能升	wu'gu'zhi'qi'bu'neng'sheng	0
吾固知其鉏铻而难入	wu'gu'zhi'qi'ju'wu'er'nan'ru	0
吴光争国	wu'guang'zheng'guo	0
务光自投於深渊兮	wu'guang'zi'tou'yu'shen'yuan'xi	0
悟过改更	wu'guo'gai'geng	0
巫何活焉	wu'he'huo'yan	0
毋滑而魂兮	wu'hua'er'hun'xi	0
乌获戚而骖乘兮	wu'huo'qi'er'can'cheng'xi	0
吴获迄古	wu'huo'qi'gu	0
吾将从彭咸之所居	wu'jiang'cong'peng'xian'zhi'suo'ju	0
吾将从王乔而娱戏	wu'jiang'cong'wang'qiao'er'yu'xi	0
吾将荡志而愉乐兮	wu'jiang'dang'zhi'er'yu'le'xi	0
吾将过乎句芒	wu'jiang'guo'hu'gou'mang	0
吾将上下而求索	wu'jiang'shang'xia'er'qiu'suo	0
吾将往乎南疑	wu'jiang'wang'hu'nan'yi	0
吾将以为类兮	wu'jiang'yi'wei'lei'xi	0
吾将远逝以自疏	wu'jiang'yuan'shi'yi'zi'shu	0
无可改者	wu'ke'gai'zhe	0
吴醴白蘗	wu'li'bai'bo	0
吾令帝阍开关兮	wu'ling'di'hun'kai'guan'xi	0
吾令丰隆乘云兮	wu'ling'feng'long'cheng'yun'xi	0
吾令凤鸟飞腾兮	wu'ling'feng'niao'fei'teng'xi	0
吾令謇修以为理	wu'ling'jian'xiu'yi'wei'li	0
吾令羲和弭节兮	wu'ling'xi'he'mi'jie'xi	0
吾令雁为媒兮	wu'ling'yan'wei'mei'xi	0
雾露濛濛其晨降兮	wu'lu'meng'meng'qi'chen'jiang'xi	0
无南无北只	wu'na'mo'bei'zhi	0
吾乃逝兮南娭	wu'nai'shi'xi'nan'ai	0
吾宁悃悃款款	wu'ning'kun'kun'kuan'kuan	0
无辔衔而自载	wu'pei'xian'er'zi'zai	0
寤辟摽兮永思	wu'pi'biao'xi'yong'si	0
吾且儃佪以娱忧兮	wu'qie'shan'huai'yi'yu'you'xi	0
无倾危之患难兮	wu'qing'wei'zhi'huan'nan'xi	0
乌鹊惊兮哑哑	wu'que'jing'xi'ya'ya	0
五色杂而炫耀	wu'se'za'er'xuan'yao	0
吾谁与玩此芳草	wu'shei'yu'wan'ci'fang'cao	0
吴申胥之抉眼兮	wu'shen'xu'zhi'jue'yan'xi	0
吾使历神占之兮	wu'shi'li'shen'zhan'zhi'xi	0
吴酸蒿蒌	wu'suan'hao'lou	0
无为之先	wu'wei'zhi'xian	0
吾闻之	wu'wen'zhi	0
吾闻作忠以造怨兮	wu'wen'zuo'zhong'yi'zao'yuan'xi	0
巫咸将夕降兮	wu'xian'jiang'xi'jiang'xi	0
雾宵晦以纷纷	wu'xiao'hui'yi'fen'fen	0
吴信谗而弗味兮	wu'xin'chan'er'fu'wei'xi	0
务行私而去公	wu'xing'si'er'qu'gong	0
伍胥兮浮江	wu'xu'xi'fu'jiang	0
乌焉解羽	wu'yan'jie'yu	0
巫阳对曰	wu'yang'dui'yue	0
无衣裘以御冬兮	wu'yi'qiu'yi'yu'dong'xi	0
吾谊先君而後身兮	wu'yi'xian'jun'er'hou'shen'xi	0
五音纷兮繁会	wu'yin'fen'xi'fan'hui	0
无用日多	wu'yong'ri'duo	0
物有纯而不可为	wu'you'chun'er'bu'ke'wei	0
吾又何怨乎今之人	wu'you'he'yuan'hu'jin'zhi'ren	0
物有所不足	wu'you'suo'bu'zu	0
物有微而陨性兮	wu'you'wei'er'yun'xing'xi	0
吴歈蔡讴	wu'yu'cai'ou	0
吾与重华游兮瑶之圃	wu'yu'chong'hua'you'xi'yao'zhi'pu	0
吾与君兮斋速	wu'yu'jun'xi'zhai'su	0
雾雨淫淫	wu'yu'yin'yin	0
吾欲之兮九夷	wu'yu'zhi'xi'jiu'yi	0
吾怨往昔之所冀兮	wu'yuan'wang'xi'zhi'suo'ji'xi	0
无远遥只	wu'yuan'yao'zhi	0
无正兮溷廁	wu'zheng'xi'hun'ce	0
吾至今而知其信然	wu'zhi'jin'er'zhi'qi'xin'ran	0
吾志兮觉悟	wu'zhi'xi'jue'wu	0
无锺子期而听之	wu'zhong'zi'qi'er'ting'zhi	0
无舟楫而自备	wu'zhou'ji'er'zi'bei	0
骛诸神之湛湛	wu'zhu'shen'zhi'zhan'zhan	0
伍子逢殃兮	wu'zi'feng'yang'xi	0
五子用失乎家巷	wu'zi'yong'shi'hu'jia'xiang	0
晞白日兮皎皎	xi'bai'ri'xi'jiao'jiao	0
西北辟启	xi'bei'pi'qi	0
西伯上告	xi'bo'shang'gao	0
西薄羊肠	xi'bo'yang'chang	0
夕餐秋菊之落英	xi'can'qiu'ju'zhi'luo'ying	0
袭长夜之悠悠	xi'chang'ye'zhi'you'you	0
摡尘垢之枉攘兮	xi'chen'gou'zhi'wang'rang'xi	0
喜登能而亮贤	xi'deng'neng'er'liang'xian	0
西方流沙	xi'fang'liu'sha	0
西方之害	xi'fang'zhi'hai	0
吸飞泉之微液兮	xi'fei'quan'zhi'wei'ye'xi	0
溪谷悲歌	xi'gu'bei'ge	0
溪谷崭岩兮水曾波	xi'gu'zhan'yan'xi'shui'ceng'bo	0
夕归次於穷石兮	xi'gui'ci'yu'qiong'shi'xi	0
吸沆瀣以充虚	xi'hang'xie'yi'chong'xu	0
羲和之未扬	xi'he'zhi'wei'yang	0
枲华安居	xi'hua'an'ju	0
惜皇舆之不兴	xi'huang'yu'zhi'bu'xing	0
戏疾濑之素水兮	xi'ji'lai'zhi'su'shui'xi	0
夕济兮西澨	xi'ji'xi'xi'shi	0
惜今世其何殊兮	xi'jin'shi'qi'he'shu'xi	0
吸精粹而吐氛浊兮	xi'jing'cui'er'tu'fen'zhuo'xi	0
奚久留此故居	xi'jiu'liu'ci'gu'ju	0
昔君与我成言兮	xi'jun'yu'wo'cheng'yan'xi	0
夕揽洲之宿莽	xi'lan'zhou'zhi'su'mang	0
悉灵圉而来谒	xi'ling'yu'er'lai'ye	0
夕弭节兮北渚	xi'mi'jie'xi'bei'zhu	0
惜年齿之未央	xi'nian'chi'zhi'wei'yang	0
喜嗫嚅而妄作	xi'nie'ru'er'wang'zuo	0
晞女发兮阳之阿	xi'nv'fa'xi'yang'zhi'a	0
夕彷徨而独宿	xi'pang'huang'er'du'su	0
郤骐骥而不乘兮	xi'qi'ji'er'bu'cheng'xi	0
郤骐骥以转运兮	xi'qi'ji'yi'zhuan'yun'xi	0
昔三后之纯粹兮	xi'san'hou'zhi'chun'cui'xi	0
惜伤身之无功	xi'shang'shen'zhi'wu'gong	0
西施斥於北宫兮	xi'shi'chi'yu'bei'gong'xi	0
夕始临乎於微闾	xi'shi'lin'hu'yu'wei'lv	0
西施媞媞而不得见兮	xi'shi'ti'ti'er'bu'de'jian'xi	0
惜誓惜余年老而日衰兮	xi'shi'xi'yu'nian'lao'er'ri'shuai'xi	0
惜师延之浮渚兮	xi'shi'yan'zhi'fu'zhu'xi	0
蟋蟀鸣此西堂	xi'shuai'ming'ci'xi'tang	0
惜诵惜诵以致愍兮	xi'song'xi'song'yi'zhi'min'xi	0
夕宿辰阳	xi'su'chen'yang	0
夕宿兮帝郊	xi'su'xi'di'jiao	0
夕投宿兮石城	xi'tou'su'xi'shi'cheng	0
惜往日惜往日之曾信兮	xi'wang'ri'xi'wang'ri'zhi'ceng'xin'xi	0
惜往事之不合兮	xi'wang'shi'zhi'bu'he'xi	0
惜吾不及古人兮	xi'wu'bu'ji'gu'ren'xi	0
夕晞余身兮九阳	xi'xi'yu'shen'xi'jiu'yang	0
惜贤览屈氏之离骚兮	xi'xian'lan'qu'shi'zhi'li'sao'xi	0
息阳城兮广夏	xi'yang'cheng'xi'guang'xia	0
習以都只	xi'yi'dou'zhi	0
夕淫淫而淋雨	xi'yin'yin'er'lin'yu	0
袭英衣兮缇纟習	xi'ying'yi'xi'ti'si'xi	0
惜廱君之不识	xi'yong'jun'zhi'bu'shi	0
惜廱君之不昭	xi'yong'jun'zhi'bu'zhao	0
昔余梦登天兮	xi'yu'meng'deng'tian'xi	0
惜余年之未央	xi'yu'nian'zhi'wei'yang	0
夕余至乎西极	xi'yu'zhi'hu'xi'ji	0
夕余至乎县圃	xi'yu'zhi'hu'xian'pu	0
吸湛露之浮凉兮	xi'zhan'lu'zhi'fu'liang'xi	0
夕至兮明光	xi'zhi'xi'ming'guang	0
吸众气而翱翔	xi'zhong'qi'er'ao'xiang	0
下暗漠而无光	xia'an'mo'er'wu'guang	0
下被衣於水渚	xia'bei'yi'yu'shui'zhu	0
下垂钓於溪谷兮	xia'chui'diao'yu'xi'gu'xi	0
下逢伊挚	xia'feng'yi'zhi	0
下合矩矱於虞唐	xia'he'ju'yue'yu'yu'tang	0
下江湘以邅回	xia'jiang'xiang'yi'zhan'hui	0
夏桀之常违兮	xia'jie'zhi'chang'wei'xi	0
夏康娱以自纵	xia'kang'yu'yi'zi'zong	0
下泠泠而来风	xia'ling'ling'er'lai'feng	0
夏室寒些	xia'shi'han'xie	0
下石濑而登洲	xia'shi'lai'er'deng'zhou	0
下堂兮见虿	xia'tang'xi'jian'chai	0
夏屋广大	xia'wu'guang'da	0
下幽晦以多雨	xia'you'hui'yi'duo'yu	0
下有兮虺蛇	xia'you'xi'hui'she	0
下峥嵘而无地兮	xia'zheng'rong'er'wu'di'xi	0
纤阿不御焉舒情兮	xian'a'bu'yu'yan'shu'qing'xi	0
献宝玉以为石	xian'bao'yu'yi'wei'shi	0
咸播秬黍	xian'bo'ju'shu	0
贤不必以	xian'bu'bi'yi	0
羡韩众之得一	xian'han'zhong'zhi'de'yi	0
羡咎繇兮建典谟	xian'jiu'yao'xi'jian'dian'mo	0
贤俊慕而自附兮	xian'jun'mu'er'zi'fu'xi	0
贤良蔽而不群兮	xian'liang'bi'er'bu'qun'xi	0
贤士无名	xian'shi'wu'ming	0
献岁发春兮	xian'sui'fa'chun'xi	0
先威後文	xian'wei'hou'wen	0
鲜蠵甘鸡	xian'xi'gan'ji	0
咸欣欣兮酣乐	xian'xin'xin'xi'han'le	0
霰雪纷其无垠兮	xian'xue'fen'qi'wu'yin'xi	0
霰雪雰糅其增加兮	xian'xue'fen'rou'qi'zeng'jia'xi	0
閒以静只	xian'yi'jing'zhi	0
羡余术兮可夷	xian'yu'shu'xi'ke'yi	0
贤者蔽而不见兮	xian'zhe'bi'er'bu'jian'xi	0
贤者灭息	xian'zhe'mie'xi	0
贤者远而隐藏	xian'zhe'yuan'er'yin'cang	0
陷滞而不发	xian'zhi'er'bu'fa	0
陷滞而不济	xian'zhi'er'bu'ji	0
限之以大故	xian'zhi'yi'da'gu	0
相从兮宿栖	xiang'cong'xi'su'qi	0
湘夫人帝子降兮北渚	xiang'fu'ren'di'zi'jiang'xi'bei'zhu	0
相辅政兮成化	xiang'fu'zheng'xi'cheng'hua	0
相观民之计极	xiang'guan'min'zhi'ji'ji	0
翔江洲而安歌	xiang'jiang'zhou'er'an'ge	0
湘君君不行兮夷犹	xiang'jun'jun'bu'xing'xi'yi'you	0
像设君室	xiang'she'jun'shi	0
曏吾路兮艹总岭	xiang'wu'lu'xi'ao'zong'ling	0
相下女之可诒	xiang'xia'nv'zhi'ke'yi	0
巷有兮蚰蜓	xiang'you'xi'you'ting	0
相与贵夫砾石	xiang'yu'gui'fu'li'shi	0
熽狼从目	xiao'lang'cong'mu	0
小人之居势兮	xiao'ren'zhi'ju'shi'xi	0
萧瑟兮	xiao'se'xi	0
枭鸮并进而俱鸣兮	xiao'xiao'bing'jin'er'ju'ming'xi	0
枭鸮既以成群兮	xiao'xiao'ji'yi'cheng'qun'xi	0
萷櫹椮之可哀兮	xiao'xiao'sen'zhi'ke'ai'xi	0
小腰秀颈	xiao'yao'xiu'jing	0
箫锺兮瑶虡	xiao'zhong'xi'yao'ju	0
邪气入而感内兮	xie'qi'ru'er'gan'nei'xi	0
邪气袭余之形体兮	xie'qi'xi'yu'zhi'xing'ti'xi	0
挟人筝而弹纬	xie'ren'zheng'er'dan'wei	0
邪说饰而多曲兮	xie'shuo'shi'er'duo'qu'xi	0
揳梓瑟些	xie'zi'se'xie	0
心哀哀而怫郁	xin'ai'ai'er'fu'yu	0
心不同兮媒劳	xin'bu'tong'xi'mei'lao	0
心不怡之长久兮	xin'bu'yi'zhi'chang'jiu'xi	0
信谗谀之溷浊兮	xin'chan'yu'zhi'hun'zhuo'xi	0
心婵媛而伤怀兮	xin'chan'yuan'er'shang'huai'xi	0
心婵媛而无告兮	xin'chan'yuan'er'wu'gao'xi	0
心怊怅以永思兮	xin'chao'chang'yi'yong'si'xi	0
心愁愁而思旧邦	xin'chou'chou'er'si'jiu'bang	0
心愁悽而增悲	xin'chou'qi'er'zeng'bei	0
心愁慼兮不能	xin'chou'qi'xi'bu'neng	0
心怵惕而震荡兮	xin'chu'ti'er'zhen'dang'xi	0
心怆怆兮自怜	xin'chuang'chuang'xi'zi'lian	0
心纯厖而不泄兮	xin'chun'pang'er'bu'xie'xi	0
心怛伤之憺憺	xin'da'shang'zhi'dan'dan	0
心悼怵而耄思	xin'dao'chu'er'mao'si	0
心低佪兮顾怀	xin'di'huai'xi'gu'huai	0
心调度而弗去兮	xin'diao'du'er'fu'qu'xi	0
心烦憺兮忘食事	xin'fan'dan'xi'wang'shi'shi	0
心烦愦兮意无聊	xin'fan'kui'xi'yi'wu'liao	0
心烦虑乱	xin'fan'lv'luan	0
心烦冤之忄虫忄虫	xin'fan'yuan'zhi'shu'chong'shu'chong	0
心沸热其若汤	xin'fei're'qi'ruo'tang	0
信非吾罪而弃逐兮	xin'fei'wu'zui'er'qi'zhu'xi	0
心飞扬兮浩荡	xin'fei'yang'xi'hao'dang	0
心纷错而不受	xin'fen'cuo'er'bu'shou	0
心纷结其未离	xin'fen'jie'qi'wei'li	0
心怫郁而内伤	xin'fu'yu'er'nei'shang	0
心怫郁兮内伤	xin'fu'yu'xi'nei'shang	0
辛甘行些	xin'gan'xing'xie	0
心巩巩而不夷	xin'gong'gong'er'bu'yi	0
心絓结而不解兮	xin'gua'jie'er'bu'jie'xi	0
心惶惑而自悲	xin'huang'huo'er'zi'bei	0
心鞿羁而不开兮	xin'ji'ji'er'bu'kai'xi	0
心渐渐其烦错	xin'jian'jian'qi'fan'cuo	0
心结縎兮折摧	xin'jie'hu'xi'zhe'cui	0
心紧絭兮伤怀	xin'jin'juan'xi'shang'huai	0
心懭悢以冤结兮	xin'kuang'liang'yi'yuan'jie'xi	0
心缭悷而有哀	xin'liao'li'er'you'ai	0
心闵怜之惨悽兮	xin'min'lian'zhi'can'qi'xi	0
新沐者必弹冠	xin'mu'zhe'bi'dan'guan	0
心内切磋	xin'nei'qie'cuo	0
心内兮怀伤	xin'nei'xi'huai'shang	0
心怦怦兮谅直	xin'peng'peng'xi'liang'zhi	0
心蛩蛩而怀顾兮	xin'qiong'qiong'er'huai'gu'xi	0
新人近而俞好	xin'ren'jin'er'yu'hao	0
心溶溶其不可量兮	xin'rong'rong'qi'bu'ke'liang'xi	0
信上皇而质正	xin'shang'huang'er'zhi'zheng	0
心尚幸其弗济	xin'shang'xing'qi'fu'ji	0
心戃慌其不我与兮	xin'tang'huang'qi'bu'wo'yu'xi	0
信未达乎从容	xin'wei'da'hu'cong'rong	0
心为兮隔错	xin'wei'xi'ge'cuo	0
心为兮切伤	xin'wei'xi'qie'shang	0
心淹留兮恫慌忽	xin'yan'liu'xi'dong'huang'hu	0
心焉取此怵惕	xin'yan'qu'ci'chu'ti	0
心摇悦而日幸兮	xin'yao'yue'er'ri'xing'xi	0
心意安只	xin'yi'an'zhi	0
辛夷车兮结桂旗	xin'yi'che'xi'jie'gui'qi	0
辛夷楣兮药房	xin'yi'mei'xi'yao'fang	0
辛夷兮挤臧	xin'yi'xi'ji'zang	0
心隐恻而不置	xin'yin'ce'er'bu'zhi	0
心踊跃其若汤	xin'yong'yue'qi'ruo'tang	0
心犹豫而狐疑	xin'you'yu'er'hu'yi	0
心犹豫而狐疑兮	xin'you'yu'er'hu'yi'xi	0
心郁结而纡轸	xin'yu'jie'er'yu'zhen	0
心悇憛而烦冤兮	xin'yu'tan'er'fan'yuan'xi	0
心郁邑余侘傺兮	xin'yu'yi'yu'cha'chi'xi	0
心郁郁而无告兮	xin'yu'yu'er'wu'gao'xi	0
新浴者必振衣	xin'yu'zhe'bi'zhen'yi	0
心纡轸宗而增伤	xin'yu'zhen'zong'er'zeng'shang	0
心冤结而内伤	xin'yuan'jie'er'nei'shang	0
心震悼而不敢	xin'zhen'dao'er'bu'gan	0
信直退而毁败兮	xin'zhi'tui'er'hui'bai'xi	0
信中涂而叛之	xin'zhong'tu'er'pan'zhi	0
行比伯夷	xing'bi'bo'yi	0
行不群以巅越兮	xing'bu'qun'yi'dian'yue'xi	0
幸而得脱	xing'er'de'tuo	0
行夫将而攻城	xing'fu'jiang'er'gong'cheng	0
幸咎繇兮获谋	xing'jiu'yao'xi'huo'mou	0
行君之意	xing'jun'zhi'yi	0
行叩诚而不阿兮	xing'kou'cheng'er'bu'a'xi	0
形枯槁而独留	xing'ku'gao'er'du'liu	0
兴离骚之微文兮	xing'li'sao'zhi'wei'wen'xi	0
形蟉虬而蜲蛇	xing'liu'qiu'er'wei'she	0
兴麋鹿同坑	xing'mi'lu'tong'keng	0
行明白而曰黑兮	xing'ming'bai'er'yue'hei'xi	0
形穆穆以浸远兮	xing'mu'mu'yi'jin'yuan'xi	0
形容枯槁	xing'rong'ku'gao	0
腥臊并御	xing'sao'bing'yu	0
形体白而质素兮	xing'ti'bai'er'zhi'su'xi	0
形销铄而瘀伤	xing'xiao'shuo'er'yu'shang	0
行婞直而不豫兮	xing'xing'zhi'er'bu'yu'xi	0
行隐进兮	xing'yin'jin'xi	0
行吟累欷声喟喟兮	xing'yin'lei'xi'sheng'kui'kui'xi	0
行吟泽畔	xing'yin'ze'pan	0
性愚陋以褊浅兮	xing'yu'lou'yi'bian'qian'xi	0
行中野而散之	xing'zhong'ye'er'san'zhi	0
雄虺九首	xiong'hui'jiu'shou	0
雄鸠之鸣逝兮	xiong'jiu'zhi'ming'shi'xi	0
熊罴群而逸囿	xiong'pi'qun'er'yi'you	0
熊罴兮呴嗥	xiong'pi'xi'xu'hao	0
雄雄赫赫	xiong'xiong'he'he	0
兄有噬犬	xiong'you'shi'quan	0
修德兮困控	xiu'de'xi'kun'kong	0
修洁处幽兮	xiu'jie'chu'you'xi	0
修路幽蔽	xiu'lu'you'bi	0
修往古以行恩兮	xiu'wang'gu'yi'xing'en'xi	0
休息虖昆仑之墟	xiu'xi'hu'kun'lun'zhi'xu	0
修余兮袿衣	xiu'yu'xi'gui'yi	0
须发苎悴兮顠鬓白	xu'fa'zhu'cui'xi'piao'bin'bai	0
徐风至而徘徊兮	xu'feng'zhi'er'pai'huai'xi	0
虚惑误又以欺	xu'huo'wu'you'yi'qi	0
吁嗟默默兮	xu'jie'mo'mo'xi	0
徐弭节而高历	xu'mi'jie'er'gao'li	0
徐徘徊於山阿兮	xu'pai'huai'yu'shan'e'xi	0
虚伪进而得当	xu'wei'jin'er'de'dang	0
虚以待之兮	xu'yi'dai'zhi'xi	0
蓄英秋风兮萧萧	xu'ying'qiu'feng'xi'xiao'xiao	0
蓄怨兮积思	xu'yuan'xi'ji'si	0
眩白黑之美恶	xuan'bai'hei'zhi'mei'e	0
旋车逝於崇山兮	xuan'che'shi'yu'chong'shan'xi	0
玄螭虫象并出进兮	xuan'chi'chong'xiang'bing'chu'jin'xi	0
眩弟并淫	xuan'di'bing'yin	0
翾飞兮翠曾	xuan'fei'xi'cui'ceng	0
玄蜂若壸些	xuan'feng'ruo'kun'xie	0
选鬼神於太阴兮	xuan'gui'shen'yu'tai'yin'xi	0
玄鹤弭翼而屏移	xuan'he'mi'yi'er'ping'yi	0
玄鹤兮高飞	xuan'he'xi'gao'fei	0
悬火延起兮	xuan'huo'yan'qi'xi	0
轩辌既低	xuan'liang'ji'di	0
玄鹿兮继踵	xuan'lu'xi'ji'zhong	0
选吕管於榛薄	xuan'lv'guan'yu'zhen'bo	0
玄鸟兮辞归	xuan'niao'xi'ci'gui	0
玄鸟致贻女何喜	xuan'niao'zhi'yi'nv'he'xi	0
玄气兮高朗	xuan'qi'xi'gao'lang	0
眩妻爰谋	xuan'qi'yuan'mou	0
悬人以娭	xuan'ren'yi'ai	0
旋入雷渊	xuan'ru'lei'yuan	0
选署众神以并毂	xuan'shu'zhong'shen'yi'bing'gu	0
玄文处幽兮	xuan'wen'chu'you'xi	0
玄武步兮水母	xuan'wu'bu'xi'shui'mu	0
玄颜烝	xuan'yan'zheng	0
宣游兮列宿	xuan'you'xi'lie'su	0
玄舆驰而并集兮	xuan'yu'chi'er'bing'ji'xi	0
玄玉之梁些	xuan'yu'zhi'liang'xie	0
轩辕不可攀援兮	xuan'yuan'bu'ke'pan'yuan'xi	0
玄蝯失於潜林兮	xuan'yuan'shi'yu'qian'lin'xi	0
雪雰雰而薄木兮	xue'fen'fen'er'bo'mu'xi	0
泬寥兮	xue'liao'xi	0
血气盛只	xue'qi'sheng'zhi	0
穴岩石而窟伏	xue'yan'shi'er'ku'fu	0
勋阖梦生	xun'he'meng'sheng	0
讯九鬿与六神	xun'jiu'qi'yu'liu'shen	0
巡陆夷之曲衍兮	xun'lu'yi'zhi'qu'yan'xi	0
循绳墨而不颇	xun'sheng'mo'er'bu'po	0
循四极而回周兮	xun'si'ji'er'hui'zhou'xi	0
轧洋洋之无从兮	ya'yang'yang'zhi'wu'cong'xi	0
厌白玉以为面兮	yan'bai'yu'yi'wei'mian'xi	0
言不可结而诒	yan'bu'ke'jie'er'yi	0
焉陈诚兮效忠	yan'chen'cheng'xi'xiao'zhong	0
焉陈词而效忠	yan'chen'ci'er'xiao'zhong	0
掩此哀而不去	yan'ci'ai'er'bu'qu	0
焉得彼嵞山女	yan'de'bi'tu'shan'nv	0
焉得夫褒姒	yan'de'fu'bao'si	0
焉得夫朴牛	yan'de'fu'pu'niu	0
淹低佪兮京沶	yan'di'huai'xi'jing'chi	0
焉发愤而筊抒	yan'fa'fen'er'jiao'shu	0
淹芳芷於腐井兮	yan'fang'zhi'yu'fu'jing'xi	0
掩浮云而上征	yan'fu'yun'er'shang'zheng	0
雁告余以不好	yan'gao'yu'yi'bu'hao	0
燕公操於马圉	yan'gong'cao'yu'ma'yu	0
岩何越焉	yan'he'yue'yan	0
焉皇皇而更索	yan'huang'huang'er'geng'suo	0
淹回水而凝滞	yan'hui'shui'er'ning'zhi	0
偃蹇连蜷兮枝相缭	yan'jian'lian'quan'xi'zhi'xiang'liao	0
奄离披此梧楸	yan'li'pi'ci'wu'qiu	0
艳陆离些	yan'lu'li'xie	0
颜霉黧以沮败兮	yan'mei'li'yi'ju'bai'xi	0
焉乃逝以徘徊	yan'nai'shi'yi'pai'huai	0
焉能极夫远道	yan'neng'ji'fu'yuan'dao	0
延年不死	yan'nian'bu'si	0
燕翩翩其辞归兮	yan'pian'pian'qi'ci'gui'xi	0
燕雀乌鹊	yan'que'wu'que	0
颜色憔悴	yan'se'qiao'cui	0
严杀尽兮弃原野	yan'sha'jin'xi'qi'yuan'ye	0
焉舒情而抽信兮	yan'shu'qing'er'chou'xin'xi	0
焉讬乘而上浮	yan'tuo'cheng'er'shang'fu	0
偃王行其仁义兮	yan'wang'hang'qi'ren'yi'xi	0
言物类之相感也	yan'wu'lei'zhi'xiang'gan'ye	0
言旋迈兮北徂	yan'xuan'mai'xi'bei'cu	0
岩穴处而隐藏	yan'xue'chu'er'yin'cang	0
焉洋洋而为客	yan'yang'yang'er'wei'ke	0
颜淫溢而将罢兮	yan'yin'yi'er'jiang'ba'xi	0
雁廱廱而南游兮	yan'yong'yong'er'nan'you'xi	0
焉有虬龙负熊以游	yan'you'qiu'long'fu'xiong'yi'you	0
焉有石林	yan'you'shi'lin	0
言语讷譅兮	yan'yu'ne'se'xi	0
言与行其可迹兮	yan'yu'xing'qi'ke'ji'xi	0
焱远举兮云中	yan'yuan'ju'xi'yun'zhong	0
严载驾兮出戏游	yan'zai'jia'xi'chu'xi'you	0
焉知贤士之所死	yan'zhi'xian'shi'zhi'suo'si	0
延伫乎吾将反	yan'zhu'hu'wu'jiang'fan	0
扬枹兮拊鼓	yang'bao'xi'fu'gu	0
仰长叹兮气噎结	yang'chang'tan'xi'qi'ye'jie	0
扬氛气兮为旌	yang'fen'qi'xi'wei'jing	0
仰浮云而永叹	yang'fu'yun'er'yong'tan	0
阳杲杲其未光兮	yang'gao'gao'qi'wei'guang'xi	0
仰观刻桷	yang'guan'ke'jue	0
扬彗光兮为旗	yang'hui'guang'xi'wei'qi	0
扬精华以眩燿兮	yang'jing'hua'yi'xuan'yao'xi	0
扬厥凭而不俟	yang'jue'ping'er'bu'si	0
阳离爰死	yang'li'yuan'si	0
仰怜兮比干	yang'lian'xi'bi'gan	0
扬灵兮未极	yang'ling'xi'wei'ji	0
扬流波之潢潢兮	yang'liu'bo'zhi'guang'guang'xi	0
扬流兮洋洋	yang'liu'xi'yang'yang	0
泱莽莽兮究志	yang'mang'mang'xi'jiu'zhi	0
阳气发兮清明	yang'qi'fa'xi'qing'ming	0
仰天兮增叹	yang'tian'xi'zeng'tan	0
坱兮轧	yang'xi'ya	0
阳焱焱而复顾	yang'yan'yan'er'fu'gu	0
扬云霓之晻蔼兮	yang'yun'ni'zhi'yan'ai'xi	0
尧不姚告	yao'bu'yao'gao	0
妖夫曳衒	yao'fu'ye'xuan	0
瑶浆蜜勺	yao'jiang'mi'shao	0
曜灵安藏	yao'ling'an'cang	0
耀灵晔而西征	yao'ling'ye'er'xi'zheng	0
殽乱兮纷拏	yao'luan'xi'fen'na	0
杳冥冥兮羌昼晦	yao'ming'ming'xi'qiang'zhou'hui	0
杳冥冥兮以东行	yao'ming'ming'xi'yi'dong'xing	0
要褭奔亡兮	yao'niao'ben'wang'xi	0
遥弃太阿	yao'qi'tai'e	0
摇翘奋羽驰风骋雨游无穷兮	yao'qiao'fen'yu'chi'feng'cheng'yu'you'wu'qiong'xi	0
遥涉江而远去	yao'she'jiang'er'yuan'qu	0
尧舜皆有所举任兮	yao'shun'jie'you'suo'ju'ren'xi	0
尧舜圣而慈仁兮	yao'shun'sheng'er'ci'ren'xi	0
尧舜圣已没兮	yao'shun'sheng'yi'mei'xi	0
尧舜之抗行兮	yao'shun'zhi'kang'xing'xi	0
遥望博	yao'wang'bo	0
瑶席兮玉瑱	yao'xi'xi'yu'zhen	0
肴羞未通	yao'xiu'wei'tong	0
谣吟兮中野	yao'yin'xi'zhong'ye	0
谣诼谓余以善淫	yao'zhuo'wei'yu'yi'shan'yin	0
靥辅奇牙	ye'fu'qi'ya	0
夜耿耿而不寐兮	ye'geng'geng'er'bu'mei'xi	0
夜光何德	ye'guang'he'de	0
曳彗星之皓旰兮	ye'hui'xing'zhi'hao'gan'xi	0
野寂漠而无人	ye'ji'mo'er'wu'ren	0
夜皎皎兮既明	ye'jiao'jiao'xi'ji'ming	0
夜炯炯而不寐兮	ye'jiong'jiong'er'bu'mei'xi	0
业失之而不救兮	ye'shi'zhi'er'bu'jiu'xi	0
谒玄黄兮纳贽	ye'xuan'huang'xi'na'zhi	0
叶菸邑而无色兮	ye'yan'yi'er'wu'se'xi	0
以保真乎	yi'bao'zhen'hu	0
衣不苟而为温	yi'bu'gou'er'wei'wen	0
倚阊阖而望予	yi'chang'he'er'wang'yu	0
以成名乎	yi'cheng'ming'hu	0
倚踌躇以淹留兮	yi'chou'chu'yi'yan'liu'xi	0
易初本迪兮	yi'chu'ben'di'xi	0
夷蠢蠢之溷浊	yi'chun'chun'zhi'hun'zhuo	0
揖辞让只	yi'ci'rang'zhi	0
倚此兮岩穴	yi'ci'xi'yan'xue	0
以动作只	yi'dong'zuo'zhi	0
壹斗斛而相量	yi'dou'hu'er'xiang'liang	0
亦多端而胶加	yi'duo'duan'er'jiao'jia	0
邑多兮螳螂	yi'duo'xi'tang'lang	0
亦多兮遭殃	yi'duo'xi'zao'yang	0
亦非余心之所志	yi'fei'yu'xin'zhi'suo'zhi	0
懿风后兮受瑞图	yi'feng'hou'xi'shou'rui'tu	0
依风穴以自息兮	yi'feng'xue'yi'zi'xi'xi	0
一夫九首	yi'fu'jiu'shou	0
蛜蚨兮噍噍	yi'fu'xi'jiao'jiao	0
一概而相量	yi'gai'er'xiang'liang	0
伊皋之伦以充庐	yi'gao'zhi'lun'yi'chong'lu	0
遗光燿兮周流	yi'guang'yao'xi'zhou'liu	0
意荒忽而流荡兮	yi'huang'hu'er'liu'dang'xi	0
倚结軨兮长太息	yi'jie'ling'xi'chang'tai'xi	0
以洁楹乎	yi'jie'ying'hu	0
以力耕乎	yi'li'geng'hu	0
衣纳纳而掩露	yi'na'na'er'yan'lu	0
以其骨为醢些	yi'qi'gu'wei'hai'xie	0
壹气孔神兮	yi'qi'kong'shen'xi	0
依前圣以节中兮	yi'qian'sheng'yi'jie'zhong'xi	0
亦诎辱兮系纍	yi'qu'ru'xi'xi'lei	0
邑犬群吠兮	yi'quan'qun'fei'xi	0
宜扰畜只	yi'rao'chu'zhi	0
衣摄叶以储与兮	yi'she'ye'yi'chu'yu'xi	0
以事妇人乎	yi'shi'fu'ren'hu	0
遗视矊些	yi'shi'mian'xie	0
遗失兮钮枢	yi'shi'xi'niu'shu	0
倚石岩以流涕兮	yi'shi'yan'yi'liu'ti'xi	0
伊思兮往古	yi'si'xi'wang'gu	0
以媮生乎	yi'tou'sheng'hu	0
以为君独服此蕙兮	yi'wei'jun'du'fu'ci'hui'xi	0
以危身乎	yi'wei'shen'hu	0
悒殟绝兮咶复苏	yi'wen'jue'xi'shi'fu'su	0
伊我后兮不聪	yi'wo'hou'xi'bu'cong	0
抑骛若通兮	yi'wu'ruo'tong'xi	0
夷吾忠而名彰	yi'wu'zhong'er'ming'zhang	0
宜笑嘕只	yi'xiao'xian'zhi	0
意晓阳兮燎寤	yi'xiao'yang'xi'liao'wu	0
意逍遥兮欲归	yi'xiao'yao'xi'yu'gui	0
壹心而不豫兮	yi'xin'er'bu'yu'xi	0
抑心而自强	yi'xin'er'zi'qiang	0
轶迅风於清源兮	yi'xun'feng'yu'qing'yuan'xi	0
羿焉彃日	yi'yan'bi'ri	0
意晻晻而日颓	yi'yan'yan'er'ri'tui	0
翼遥遥其左右	yi'yao'yao'qi'zuo'you	0
已矣哉	yi'yi'zai	0
伊尹烹於庖厨	yi'yin'peng'yu'pao'chu	0
壹阴兮壹阳	yi'yin'xi'yi'yang	0
羿淫游以佚畋兮	yi'yin'you'yi'yi'tian'xi	0
意有所载而远逝兮	yi'you'suo'zai'er'yuan'shi'xi	0
遗余褋兮澧浦	yi'yu'die'xi'li'pu	0
遗余佩兮澧浦	yi'yu'pei'xi'li'pu	0
意欲兮沉吟	yi'yu'xi'chen'yin	0
伊余兮念兹	yi'yu'xi'nian'zi	0
以娱昔只	yi'yu'xi'zhi	0
亦余心之所善兮	yi'yu'xin'zhi'suo'shan'xi	0
倚沼畦瀛兮	yi'zhao'qi'ying'xi	0
抑志而弭节兮	yi'zhi'er'mi'jie'xi	0
以直钅咸而为钓兮	yi'zhi'jin'xian'er'wei'diao'xi	0
易之以百两	yi'zhi'yi'bai'liang	0
易中利心	yi'zhong'li'xin	0
以自清乎	yi'zi'qing'hu	0
意恣睢以抯挢	yi'zi'sui'yi'zha'jiao	0
引八维以自道兮	yin'ba'wei'yi'zi'dao'xi	0
引车右还	yin'che'you'hai	0
因芙蓉而为媒兮	yin'fu'rong'er'wei'mei'xi	0
因缟素而哭之	yin'gao'su'er'ku'zhi	0
因归鸟而致辞兮	yin'gui'niao'er'zhi'ci'xi	0
饮菌若之朝露兮	yin'jun'ruo'zhi'zhao'lu'xi	0
隐岷山以清江	yin'min'shan'yi'qing'jiang	0
因气变而遂曾举兮	yin'qi'bian'er'sui'ceng'ju'xi	0
引日月以指极兮	yin'ri'yue'yi'zhi'ji'xi	0
隐三年而无决兮	yin'san'nian'er'wu'jue'xi	0
音声之相和兮	yin'sheng'zhi'xiang'he'xi	0
饮石泉兮廕松柏	yin'shi'quan'xi'yin'song'bai	0
隐思君兮陫侧	yin'si'jun'xi'fei'ce	0
因徙弛而长辞	yin'xi'chi'er'chang'ci	0
音晏衍兮要淫	yin'yan'yan'xi'yao'yin	0
阴阳不可与俪偕	yin'yang'bu'ke'yu'li'xie	0
阴阳三合	yin'yang'san'he	0
阴阳易位	yin'yang'yi'wei	0
殷有惑妇	yin'you'huo'fu	0
阴忧兮感余	yin'you'xi'gan'yu	0
饮余马於咸池兮	yin'yu'ma'yu'xian'chi'xi	0
音乐博衍无终极兮	yin'yue'bo'yan'wu'zhong'ji'xi	0
吟泽畔之江滨	yin'ze'pan'zhi'jiang'bin	0
殷之命以不救	yin'zhi'ming'yi'bu'jiu	0
殷宗用而不长	yin'zong'yong'er'bu'chang	0
盈北极只	ying'bei'ji'zhi	0
迎虙妃於伊雒	ying'fu'fei'yu'yi'luo	0
英华假只	ying'hua'jia'zhi	0
应律兮合节	ying'lv'xi'he'jie	0
媵有莘之妇	ying'you'xin'zhi'fu	0
迎余兮欢欣	ying'yu'xi'huan'xin	0
永遏在羽山	yong'e'zai'yu'shan	0
永怀兮内伤	yong'huai'xi'nei'shang	0
庸讵知其吉凶	yong'ju'zhi'qi'ji'xiong	0
用君之心	yong'jun'zhi'xin	0
永历年而无成	yong'li'nian'er'wu'cheng	0
永思兮窈悠	yong'si'xi'yao'you	0
永叹喟兮	yong'tan'kui'xi	0
永啸呼些	yong'xiao'hu'xie	0
永宜厥身	yong'yi'jue'shen	0
永余思兮怞怞	yong'yu'si'xi'chou'chou	0
踊跃兮距跳	yong'yue'xi'ju'tiao	0
用志兮不昭	yong'zhi'xi'bu'zhao	0
又蔽而莫之白也	you'bi'er'mo'zhi'bai'ye	0
忧不暇兮寝食	you'bu'xia'xi'qin'shi	0
右苍龙之躣躣	you'cang'long'zhi'qu'qu	0
诱骋先	you'cheng'xian	0
右大夏之遗风	you'da'xia'zhi'yi'feng	0
有狄不宁	you'di'bu'ning	0
幽独处乎山中	you'du'chu'hu'shan'zhong	0
右睹兮呼枭	you'du'xi'hu'xiao	0
幽独转而不寐兮	you'du'zhuan'er'bu'mei'xi	0
犹高飞而哀鸣	you'gao'fei'er'ai'ming	0
又好射夫封狐	you'hao'she'fu'feng'hu	0
又何必用夫行媒	you'he'bi'yong'fu'xing'mei	0
又何芳之能祗	you'he'fang'zhi'neng'zhi	0
又何怀乎故都	you'he'huai'hu'gu'du	0
又何可以淹留	you'he'ke'yi'yan'liu	0
又何路之能极	you'he'lu'zhi'neng'ji	0
又何以为此伴也	you'he'yi'wei'ci'ban'ye	0
又何以为此援也	you'he'yi'wei'ci'yuan'ye	0
又何以异虖犬羊	you'he'yi'yi'hu'quan'yang	0
又何鱼之能得	you'he'yu'zhi'neng'de	0
有扈牧竖	you'hu'mu'shu	0
有竭信而归诚	you'jie'xin'er'gui'cheng	0
游惊雾之流波	you'jing'wu'zhi'liu'bo	0
幽空虚以寂寞	you'kong'xu'yi'ji'mo	0
忧苦悲余心之悁悁兮	you'ku'bei'yu'xin'zhi'yuan'yuan'xi	0
又况揭车与江离	you'kuang'jie'che'yu'jiang'li	0
游兰皋与蕙林兮	you'lan'gao'yu'hui'lin'xi	0
右雷公以为卫	you'lei'gong'yi'wei'wei	0
有六簙些	you'liu'bo'xie	0
有美一人兮心不绎	you'mei'yi'ren'xi'xin'bu'yi	0
又莫察余之中情	you'mo'cha'yu'zhi'zhong'qing	0
有鸟自南兮	you'niao'zi'nan'xi	0
忧憔悴而无乐	you'qiao'cui'er'wu'le	0
游清灵之飒戾兮	you'qing'ling'zhi'sa'li'xi	0
有琼浆些	you'qiong'jiang'xie	0
右衽拂於不周兮	you'ren'fu'yu'bu'zhou'xi	0
有人在下	you'ren'zai'xia	0
又申之以揽茝	you'shen'zhi'yi'lan'chai	0
又使至代之	you'shi'zhi'dai'zhi	0
又树蕙之百亩	you'shu'hui'zhi'bai'mu	0
又孰能无变化	you'shu'neng'wu'bian'hua	0
游陶遨兮养神	you'tao'ao'xi'yang'shen	0
犹未殫於九章	you'wei'dan'yu'jiu'zhang	0
又未知其所从	you'wei'zhi'qi'suo'cong	0
又无彊辅	you'wu'jiang'fu	0
又无良媒在其侧	you'wu'liang'mei'zai'qi'ce	0
又无行媒兮	you'wu'xing'mei'xi	0
又无羽翼而高翔	you'wu'yu'yi'er'gao'xiang	0
忧心不遂	you'xin'bu'sui	0
忧心悄兮志勤劬	you'xin'qiao'xi'zhi'qin'qu	0
有莘爰极	you'xin'yuan'ji	0
忧心展转愁怫郁兮	you'xin'zhan'zhuan'chou'fu'yu'xi	0
有以异兮	you'yi'yi'xi	0
悠悠苍天兮	you'you'cang'tian'xi	0
犹有曩之态也	you'you'nang'zhi'tai'ye	0
忧与愁其相接	you'yu'chou'qi'xiang'jie	0
游於江潭	you'yu'jiang'tan	0
忧纡兮郁郁	you'yu'xi'yu'yu	0
有餦餭些	you'zhang'huang'xie	0
有招祸之道也	you'zhao'huo'zhi'dao'ye	0
有柘浆些	you'zhe'jiang'xie	0
有志极而无旁	you'zhi'ji'er'wu'pang	0
又众兆之所雠也	you'zhong'zhao'zhi'suo'chou'ye	0
又众兆之所咍	you'zhong'zhao'zhi'suo'hai	0
又重之以修能	you'zhong'zhi'yi'xiu'neng	0
余安能兮久居	yu'an'neng'xi'jiu'ju	0
驭安用夫强策	yu'an'yong'fu'qiang'ce	0
欲卑身而下体兮	yu'bei'shen'er'xia'ti'xi	0
余悲兮兰生	yu'bei'xi'lan'sheng	0
欲变节以从俗兮	yu'bian'jie'yi'cong'su'xi	0
与波上下	yu'bo'shang'xia	0
余不忍为此态也	yu'bu'ren'wei'ci'tai'ye	0
与长友兮	yu'chang'you'xi	0
与赤松而结友兮	yu'chi'song'er'jie'you'xi	0
余惆怅兮何归	yu'chou'chang'xi'he'gui	0
余处幽篁兮终不见天	yu'chu'you'huang'xi'zhong'bu'jian'tian	0
余辞上参於天坠兮	yu'ci'shang'can'yu'tian'zhui'xi	0
欲从灵氛之吉占兮	yu'cong'ling'fen'zhi'ji'zhan'xi	0
欲竄伏兮其焉如	yu'cuan'fu'xi'qi'yan'ru	0
欲登阶而狐疑	yu'deng'jie'er'hu'yi	0
余独好修以为常	yu'du'hao'xiu'yi'wei'chang	0
欲度世以忘归兮	yu'du'shi'yi'wang'gui'xi	0
愈氛雾其如塺	yu'fen'wu'qi'ru'mei	0
遇丰隆而不将	yu'feng'long'er'bu'jiang	0
渔父见而问之曰	yu'fu'jian'er'wen'zhi'yue	0
渔父屈原既放	yu'fu'qu'yuan'ji'fang	0
渔父莞尔而笑	yu'fu'wan'er'er'xiao	0
渔父曰	yu'fu'yue	0
余感时兮悽怆	yu'gan'shi'xi'qi'chuang	0
欲高飞而远集兮	yu'gao'fei'er'yuan'ji'xi	0
于高冈之峨峨	yu'gao'gang'zhi'e'e	0
余顾兮怊怊	yu'gu'xi'chao'chao	0
遇故乡而一顾兮	yu'gu'xiang'er'yi'gu'xi	0
余固知謇謇之为患兮	yu'gu'zhi'jian'jian'zhi'wei'huan'xi	0
欲阖口而无言兮	yu'he'kou'er'wu'yan'xi	0
余何留兮中州	yu'he'liu'xi'zhong'zhou	0
禹何所成	yu'he'suo'cheng	0
余何畏惧兮	yu'he'wei'ju'xi	0
欲横奔而失路兮	yu'heng'ben'er'shi'lu'xi	0
御后土之中和	yu'hou'tu'zhi'zhong'he	0
与化去而不见兮	yu'hua'qu'er'bu'jian'xi	0
余既不难夫离别兮	yu'ji'bu'nan'fu'li'bie'xi	0
欲寂漠而绝端兮	yu'ji'mo'er'jue'duan'xi	0
余既滋兰之九畹兮	yu'ji'zi'lan'zhi'jiu'wan'xi	0
与佳期兮夕张	yu'jia'qi'xi'xi'zhang	0
余将董道而不豫兮	yu'jiang'dong'dao'er'bu'yu'xi	0
余将谁告	yu'jiang'shui'gao	0
余将焉所程	yu'jiang'yan'suo'cheng	0
郁结纡轸兮	yu'jie'yu'zhen'xi	0
愉近習而蔽远兮	yu'jin'xi'er'bi'yuan'xi	0
欲静居兮自娱	yu'jing'ju'xi'zi'yu	0
娱酒不废	yu'jiu'bu'fei	0
余眷眷兮独悲	yu'juan'juan'xi'du'bei	0
逾空桑兮从女	yu'kong'sang'xi'cong'nv	0
遇历武之不察兮	yu'li'wu'zhi'bu'cha'xi	0
鱼邻邻兮媵予	yu'lin'lin'xi'ying'yu	0
鱼鳞屋兮龙堂	yu'lin'wu'xi'long'tang	0
鱼鳞衣而白佣蜺	yu'lin'yi'er'bai'yong'ni	0
逾陇堆兮渡漠	yu'long'dui'xi'du'mo	0
与美人抽怨兮	yu'mei'ren'chou'yuan'xi	0
郁弥路只	yu'mi'lu'zhi	0
余柰世之不知芳何	yu'nai'shi'zhi'bu'zhi'fang'he	0
与女沐兮咸池	yu'nv'mu'xi'xian'chi	0
与女游兮河之渚	yu'nv'you'xi'he'zhi'zhu	0
与女游兮九河	yu'nv'you'xi'jiu'he	0
玉佩兮陆离	yu'pei'xi'lu'li	0
鱼葺鳞以自别兮	yu'qi'lin'yi'zi'bie'xi	0
与其无义而有名兮	yu'qi'wu'yi'er'you'ming'xi	0
与前世而皆然兮	yu'qian'shi'er'jie'ran'xi	0
欲迁志而改操兮	yu'qian'zhi'er'gai'cao'xi	0
娱人乱只	yu'ren'luan'zhi	0
与日月而比荣	yu'ri'yue'er'bi'rong	0
与日月兮齐光	yu'ri'yue'xi'qi'guang	0
与日月兮殊道	yu'ri'yue'xi'shu'dao	0
欲容与以俟时兮	yu'rong'yu'yi'si'shi'xi	0
遇蓐收乎西皇	yu'ru'shou'hu'xi'huang	0
欲入兮深谷	yu'ru'xi'shen'gu	0
竽瑟狂会	yu'se'kuang'hui	0
玉色頩以脕颜兮	yu'shai'ping'yi'wen'yan'xi	0
欲儃佪以干傺兮	yu'shan'huai'yi'gan'chi'xi	0
蜮伤躬只	yu'shang'gong'zhi	0
欲少留此灵琐兮	yu'shao'liu'ci'ling'suo'xi	0
与神龙乎休息	yu'shen'long'hu'xiu'xi	0
余深愍兮惨怛	yu'shen'min'xi'can'da	0
与神人兮相胥	yu'shen'ren'xi'xiang'xu	0
遇神孈兮宴娭	yu'shen'xie'xi'yan'ai	0
欲伸要而不可得	yu'shen'yao'er'bu'ke'de	0
余生终无所依	yu'sheng'zhong'wu'suo'yi	0
欲释阶而登天兮	yu'shi'jie'er'deng'tian'xi	0
余思旧邦心依违兮	yu'si'jiu'bang'xin'yi'wei'xi	0
欲俟时於须臾兮	yu'si'shi'yu'xu'yu'xi	0
余私娱兹兮	yu'si'yu'zi'xi	0
余虽好修姱以鞿羁兮	yu'sui'hao'xiu'kua'yi'ji'ji'xi	0
遇孙阳而得代	yu'sun'yang'er'de'dai	0
与泰初而为邻	yu'tai'chu'er'wei'lin	0
与天地兮同寿	yu'tian'di'xi'tong'shou	0
与王趋梦兮	yu'wang'qu'meng'xi	0
隅隈多有	yu'wei'duo'you	0
余萎约而悲愁	yu'wei'yue'er'bei'chou	0
与吾期兮南荣	yu'wu'qi'xi'nan'rong	0
欲衒鬻兮莫取	yu'xuan'yu'xi'mo'qu	0
雨雪兮冥冥	yu'xue'xi'ming'ming	0
欲循道而平驱兮	yu'xun'dao'er'ping'qu'xi	0
与纁黄以为期	yu'xun'huang'yi'wei'qi	0
鱼眼玑之坚藏	yu'yan'ji'zhi'jian'cang	0
余焉能忍而与此终古	yu'yan'neng'ren'er'yu'ci'zhong'gu	0
揄扬涤荡飘流陨往触崟石兮	yu'yang'di'dang'piao'liu'yun'wang'chu'yin'shi'xi	0
余以兰为可恃兮	yu'yi'lan'wei'ke'shi'xi	0
余因称乎清商	yu'yin'cheng'hu'qing'shang	0
鰅鳙短狐	yu'yong'duan'hu	0
余犹恶其佻巧	yu'you'e'qi'tiao'qiao	0
余幼既有此鸿节兮	yu'you'ji'you'ci'hong'jie'xi	0
余有所疑	yu'you'suo'yi	0
纡余辔兮踌躇	yu'yu'pei'xi'chou'chu	0
纡余辔兮自休	yu'yu'pei'xi'zi'xiu	0
玉与石其同匮兮	yu'yu'shi'qi'tong'kui'xi	0
欲与天地参寿兮	yu'yu'tian'di'can'shou'xi	0
与余言而不信兮	yu'yu'yan'er'bu'xin'xi	0
欲远集而无所止兮	yu'yuan'ji'er'wu'suo'zhi'xi	0
御者迷兮失轨	yu'zhe'mi'xi'shi'gui	0
禹之力献功	yu'zhi'li'xian'gong	0
与织女兮合婚	yu'zhi'nv'xi'he'hun	0
舆中涂以回畔兮	yu'zhong'tu'yi'hui'pan'xi	0
於中夜存	yu'zhong'ye'cun	0
欲酌醴以娱忧兮	yu'zhuo'li'yi'yu'you'xi	0
欲自適而不可	yu'zi'shi'er'bu'ke	0
援北斗兮酌桂浆	yuan'bei'dou'xi'zhuo'gui'jiang	0
援瓟瓜兮接粮	yuan'bo'gua'xi'jie'liang	0
原侧身而无所	yuan'ce'shen'er'wu'suo	0
原侧身岩穴而自讬	yuan'ce'shen'yan'xue'er'zi'tuo	0
原曾思而远身	yuan'ceng'si'er'yuan'shen	0
原陈列而无正	yuan'chen'lie'er'wu'zheng	0
原陈情以白行兮	yuan'chen'qing'yi'bai'xing'xi	0
原沉滞而不见兮	yuan'chen'zhi'er'bu'jian'xi	0
原陈志而无路	yuan'chen'zhi'er'wu'lu	0
原承风乎遗则	yuan'cheng'feng'hu'yi'ze	0
原承閒而效志兮	yuan'cheng'xian'er'xiao'zhi'xi	0
原承閒而自察兮	yuan'cheng'xian'er'zi'cha'xi	0
原承閒而自恃兮	yuan'cheng'xian'er'zi'shi'xi	0
爰出子文	yuan'chu'zi'wen	0
原春日以为糗芳	yuan'chun'ri'yi'wei'qiu'fang	0
原赐不肖之躯而别离兮	yuan'ci'bu'xiao'zhi'qu'er'bie'li'xi	0
原从容虖神明	yuan'cong'rong'hu'shen'ming	0
援芙蕖兮为盖	yuan'fu'qu'xi'wei'gai	0
怨公子兮怅忘归	yuan'gong'zi'xi'chang'wang'gui	0
圆果抟兮	yuan'guo'tuan'xi	0
原皓日之显行兮	yuan'hao'ri'zhi'xian'xing'xi	0
爰何云	yuan'he'yun	0
缘鹄饰玉	yuan'hu'shi'yu	0
原及白日之未暮也	yuan'ji'bai'ri'zhi'wei'mu'ye	0
原寄言夫流星兮	yuan'ji'yan'fu'liu'xing'xi	0
原寄言於浮云兮	yuan'ji'yan'yu'fu'yun'xi	0
原寄言於三鸟兮	yuan'ji'yan'yu'san'niao'xi	0
原假簧以舒忧兮	yuan'jia'huang'yi'shu'you'xi	0
原徼幸而有待兮	yuan'jiao'xing'er'you'dai'xi	0
原竭节兮隔无由	yuan'jie'jie'xi'ge'wu'you	0
冤结未舒长隐忿兮	yuan'jie'wei'shu'chang'yin'fen'xi	0
远近思而不同	yuan'jin'si'er'bu'tong	0
原径逝而不得兮	yuan'jing'shi'er'bu'de'xi	0
猨啾啾兮又夜鸣	yuan'jiu'jiu'xi'you'ye'ming	0
原咎杂而累重	yuan'jiu'za'er'lei'zhong	0
原离群而远举	yuan'li'qun'er'yuan'ju	0
远梁昌兮几迷	yuan'liang'chang'xi'ji'mi	0
怨灵修之浩荡兮	yuan'ling'xiu'zhi'hao'dang'xi	0
原慕先圣之遗教	yuan'mu'xian'sheng'zhi'yi'jiao	0
远迁臣而弗思	yuan'qian'chen'er'fu'si	0
原轻举而远游	yuan'qing'ju'er'yuan'you	0
冤屈而自抑	yuan'qu'er'zi'yi	0
原若今兮无亏	yuan'ruo'jin'xi'wu'kui	0
怨上令尹兮謷謷	yuan'shang'ling'yin'xi'ao'ao	0
原生受命于贞节兮	yuan'sheng'shou'ming'yu'zhen'jie'xi	0
怨世世沉淖而难论兮	yuan'shi'shi'chen'nao'er'nan'lun'xi	0
远逝志隐隐而郁怫兮	yuan'shi'zhi'yin'yin'er'yu'fu'xi	0
原舒志而抽冯兮	yuan'shu'zhi'er'chou'feng'xi	0
原俟时乎吾将刈	yuan'si'shi'hu'wu'jiang'yi	0
怨思士穷而隐处兮	yuan'si'shi'qiong'er'yin'chu'xi	0
怨思惟郁郁之忧毒兮	yuan'si'wei'yu'yu'zhi'you'du'xi	0
原岁并谢	yuan'sui'bing'xie	0
原遂推而为臧	yuan'sui'tui'er'wei'zang	0
原荪美之可完	yuan'sun'mei'zhi'ke'wan	0
缘天梯兮北上	yuan'tian'ti'xi'bei'shang	0
原退身而穷处	yuan'tui'shen'er'qiong'chu	0
鼋鼍兮欣欣	yuan'tuo'xi'xin'xin	0
原讬志乎素餐	yuan'tuo'zhi'hu'su'can	0
远望兮仟眠	yuan'wang'xi'qian'mian	0
原勿爱兮	yuan'wu'ai'xi	0
原无过之设行兮	yuan'wu'guo'zhi'she'xing'xi	0
原悉心之所闻兮	yuan'xi'xin'zhi'suo'wen'xi	0
原衔枚而无言兮	yuan'xian'mei'er'wu'yan'xi	0
鸳鸯兮噰噰	yuan'yang'xi'yong'yong	0
原摇起而横奔兮	yuan'yao'qi'er'heng'ben'xi	0
原壹见而陈辞	yuan'yi'jian'er'chen'ci	0
原一见而有明	yuan'yi'jian'er'you'ming	0
原一见兮道余意	yuan'yi'jian'xi'dao'yu'yi	0
原壹见阳春之白日兮	yuan'yi'jian'yang'chun'zhi'bai'ri'xi	0
原一列兮无从	yuan'yi'lie'xi'wu'cong	0
原依彭咸之遗则	yuan'yi'peng'xian'zhi'yi'ze	0
原壹往而径逝兮	yuan'yi'wang'er'jing'shi'xi	0
原因先生决之	yuan'yin'xian'sheng'jue'zhi	0
远游悲时俗之迫厄兮	yuan'you'bei'shi'su'zhi'po'e'xi	0
远游悲余性之不可改兮	yuan'you'bei'yu'xing'zhi'bu'ke'gai'xi	0
猿狖群啸兮虎豹原	yuan'you'qun'xiao'xi'hu'bao'yuan	0
沅有芷兮澧有兰	yuan'you'zhi'xi'li'you'lan	0
援玉枹兮击鸣鼓	yuan'yu'bao'xi'ji'ming'gu	0
原至昆仑之悬圃兮	yuan'zhi'kun'lun'zhi'xuan'pu'xi	0
原志之有像	yuan'zhi'zhi'you'xiang	0
远浊世而自藏	yuan'zhuo'shi'er'zi'cang	0
原自沉於江流兮	yuan'zi'chen'yu'jiang'liu'xi	0
原自申而不得	yuan'zi'shen'er'bu'de	0
原自往而径游兮	yuan'zi'wang'er'jing'you'xi	0
原尊节而式高兮	yuan'zun'jie'er'shi'gao'xi	0
曰黄昏以为期兮	yue'huang'hun'yi'wei'qi'xi	0
曰君可思而不可恃	yue'jun'ke'si'er'bu'ke'shi	0
越炎火兮万里	yue'yan'huo'xi'wan'li	0
越云汉兮南济	yue'yun'han'xi'nan'ji	0
云霏霏而承宇	yun'fei'fei'er'cheng'yu	0
云霏霏而陨集	yun'fei'fei'er'yun'ji	0
云服阴阳之正道兮	yun'fu'yin'yang'zhi'zheng'dao'xi	0
云何而逢	yun'he'er'feng	0
耘藜藿与蘘荷	yun'li'huo'yu'rang'he	0
云蒙蒙而蔽之	yun'meng'meng'er'bi'zhi	0
云蒙蒙兮电鯈烁	yun'meng'meng'xi'dian'chou'shuo	0
云靡贵兮仁义	yun'mi'gui'xi'ren'yi	0
云冥冥而闇前	yun'ming'ming'er'an'qian	0
云霓纷兮晻翳	yun'ni'fen'xi'yan'yi	0
云旗兮电骛	yun'qi'xi'dian'wu	0
云容容兮而在下	yun'rong'rong'xi'er'zai'xia	0
云雾会兮日冥晦	yun'wu'hui'xi'ri'ming'hui	0
云吸吸以湫戾	yun'xi'xi'yi'qiu'li	0
云依斐而承宇	yun'yi'fei'er'cheng'yu	0
殒余躬於沅湘	yun'yu'gong'yu'yuan'xiang	0
运余兮念兹	yun'yu'xi'nian'zi	0
云余肇祖于高阳兮	yun'yu'zhao'zu'yu'gao'yang'xi	0
云中君浴兰汤兮沐芳	yun'zhong'jun'yu'lan'tang'xi'mu'fang	0
杂斑駮与阘茸	za'ban'bo'yu'ta'rong	0
杂杜衡与芳芷	za'du'heng'yu'fang'zhi	0
杂芰荷些	za'ji'he'xie	0
杂橘柚以为囿兮	za'ju'you'yi'wei'you'xi	0
杂鹙鸧只	za'qiu'cang'zhi	0
杂申椒与菌桂兮	za'shen'jiao'yu'jun'gui'xi	0
杂瑶象以为车	za'yao'xiang'yi'wei'che	0
载赤霄而凌太清	zai'chi'xiao'er'ling'tai'qing	0
载雌霓而为旌	zai'ci'ni'er'wei'jing	0
再举兮	zai'ju'xi	0
载青云兮上昇	zai'qing'yun'xi'shang'sheng	0
载尸集战	zai'shi'ji'zhan	0
载象兮上行	zai'xiang'xi'shang'xing	0
载营魄而登霞兮	zai'ying'po'er'deng'xia'xi	0
载玉女於後车	zai'yu'nv'yu'hou'che	0
载云变化	zai'yun'bian'hua	0
载云旗兮委蛇	zai'yun'qi'xi'wei'yi	0
载云旗之逶蛇	zai'yun'qi'zhi'wei'she	0
载云旗之委蛇	zai'yun'qi'zhi'wei'yi	0
载云旗之委蛇兮	zai'yun'qi'zhi'wei'yi'xi	0
葬於江鱼之腹中	zang'yu'jiang'yu'zhi'fu'zhong	0
遭谗人而嫉之	zao'chan'ren'er'ji'zhi	0
遭沉浊而汙秽兮	zao'chen'zhuo'er'wu'hui'xi	0
遭厄悼屈子兮遭厄	zao'e'dao'qu'zi'xi'zao'e	0
遭纷逢凶蹇离尤兮	zao'fen'feng'xiong'jian'li'you'xi	0
造父为我操之	zao'fu'wei'wo'cao'zhi	0
遭桓缪兮识举	zao'huan'miu'xi'shi'ju	0
遭乱世而离尤	zao'luan'shi'er'li'you	0
遭倾遇祸不可救兮	zao'qing'yu'huo'bu'ke'jiu'xi	0
凿山楹而为室兮	zao'shan'ying'er'wei'shi'xi	0
造我车兮南端	zao'wo'che'xi'nan'duan	0
造新歌些	zao'xin'ge'xie	0
遭玄鸟而致诒	zao'xuan'niao'er'zhi'yi	0
造旬始而观清都	zao'xun'shi'er'guan'qing'dou	0
遭值君之不聪	zao'zhi'jun'zhi'bu'cong	0
遭周文而得举	zao'zhou'wen'er'de'ju	0
遭周文而舒志	zao'zhou'wen'er'shu'zhi	0
增冰峨峨	zeng'bing'e'e	0
增城九重	zeng'cheng'jiu'chong	0
罾何为兮木上	zeng'he'wei'xi'mu'shang	0
矰弋机而在上兮	zeng'yi'ji'er'zai'shang'xi	0
憎愠惀之修美兮	zeng'yun'lun'zhi'xiu'mei'xi	0
吒增叹兮如雷	zha'zeng'tan'xi'ru'lei	0
邅彼南道兮	zhan'bi'nan'dao'xi	0
斩伐橘柚兮	zhan'fa'ju'you'xi	0
鱣鲇兮延延	zhan'nian'xi'yan'yan	0
瞻前而顾後兮	zhan'qian'er'gu'hou'xi	0
展诗兮会舞	zhan'shi'xi'hui'wu	0
邅吾道夫昆仑兮	zhan'wu'dao'fu'kun'lun'xi	0
邅吾道兮洞庭	zhan'wu'dao'xi'dong'ting	0
鹯鹞兮轩轩	zhan'yao'xi'xuan'xuan	0
邅翼翼而无终兮	zhan'yi'yi'er'wu'zhong'xi	0
詹尹乃端策拂龟曰	zhan'yin'nai'duan'ce'fu'gui'yue	0
詹尹乃释策而谢曰	zhan'yin'nai'shi'ce'er'xie'yue	0
霑余襟之浪浪	zhan'yu'jin'zhi'lang'lang	0
湛湛江水兮	zhan'zhan'jiang'shui'xi	0
障覆天兮祲氛	zhang'fu'tian'xi'jin'fen	0
璋珪杂於甑窐兮	zhang'gui'za'yu'zeng'wa'xi	0
章画志墨兮	zhang'hua'zhi'mo'xi	0
张绛帷以襜襜兮	zhang'jiang'wei'yi'chan'chan'xi	0
掌梦上帝其难从	zhang'meng'shang'di'qi'nan'cong	0
张咸池奏承云兮	zhang'xian'chi'zou'cheng'yun'xi	0
杖玉策与硃旗兮	zhang'yu'ce'yu'zhu'qi'xi	0
兆出名曰正则兮	zhao'chu'ming'yue'zheng'ze'xi	0
召丰隆使先导兮	zhao'feng'long'shi'xian'dao'xi	0
昭后成游	zhao'hou'cheng'you	0
招魂朕幼清以廉洁兮	zhao'hun'zhen'you'qing'yi'lian'jie'xi	0
招具该备	zhao'ju'gai'bei	0
照彭咸之所闻	zhao'peng'xian'zhi'suo'wen	0
召黔嬴而见之兮	zhao'qian'ying'er'jian'zhi'xi	0
昭世世溷兮冥昏	zhao'shi'shi'hun'xi'ming'hun	0
照四海只	zhao'si'hai'zhi	0
照吾槛兮扶桑	zhao'wu'kan'xi'fu'sang	0
诏西皇使涉予	zhao'xi'huang'shi'she'yu	0
肇锡余以嘉名	zhao'xi'yu'yi'jia'ming	0
赵箫倡只	zhao'xiao'chang'zhi	0
召玄武而奔属	zhao'xuan'wu'er'ben'shu	0
招隐士桂树丛生兮山之幽	zhao'yin'shi'gui'shu'cong'sheng'xi'shan'zhi'you	0
招贞良与明智	zhao'zhen'liang'yu'ming'zhi	0
昭质既设	zhao'zhi'ji'she	0
棹舟杭以横濿兮	zhao'zhou'hang'yi'heng'li'xi	0
折芳馨兮遗所思	zhe'fang'xin'xi'yi'suo'si	0
折芳枝与琼华兮	zhe'fang'zhi'yu'qiong'hua'xi	0
折琼枝以继佩	zhe'qiong'zhi'yi'ji'pei	0
折琼枝以为羞兮	zhe'qiong'zhi'yi'wei'xiu'xi	0
折锐摧矜凝氾滥兮	zhe'rui'cui'jin'ning'fan'lan'xi	0
折若椒以自处	zhe'ruo'jiao'yi'zi'chu	0
折若木以蔽光兮	zhe'ruo'mu'yi'bi'guang'xi	0
折若木以拂日兮	zhe'ruo'mu'yi'fu'ri'xi	0
折疏麻兮瑶华	zhe'shu'ma'xi'yao'hua	0
哲王又不寤	zhe'wang'you'bu'wu	0
朕皇考曰伯庸	zhen'huang'kao'yue'bo'yong	0
贞良兮茕独	zhen'liang'xi'qiong'du	0
轸石崴嵬	zhen'shi'wei'wei	0
贞枝抑兮枯槁	zhen'zhi'yi'xi'ku'gao	0
正臣端其操行兮	zheng'chen'duan'qi'cao'xing'xi	0
证此言之不可聊	zheng'ci'yan'zhi'bu'ke'liao	0
正法弧而不公	zheng'fa'hu'er'bu'gong	0
征夫皇皇其孰依兮	zheng'fu'huang'huang'qi'shu'yi'xi	0
征夫劳於周行兮	zheng'fu'lao'yu'zhou'hang'xi	0
征夫罔极谁可语兮	zheng'fu'wang'ji'shui'ke'yu'xi	0
征夫宵行	zheng'fu'xiao'xing	0
徵九神於回极兮	zheng'jiu'shen'yu'hui'ji'xi	0
郑绵络些	zheng'mian'luo'xie	0
争遣伐器	zheng'qian'fa'qi	0
正始昆只	zheng'shi'kun'zhi	0
郑卫妖玩	zheng'wei'yao'wan	0
指嶓冢之西隈兮	zhi'bo'zhong'zhi'xi'wei'xi	0
指苍天以为正	zhi'cang'tian'yi'wei'zheng	0
志沉菀而莫达	zhi'chen'wan'er'mo'da	0
志沉抑而不扬	zhi'chen'yi'er'bu'yang	0
陟丹山兮炎野	zhi'dan'shan'xi'yan'ye	0
枝烦挐而交横	zhi'fan'ru'er'jiao'heng	0
质菲薄而无因兮	zhi'fei'bo'er'wu'yin'xi	0
蹠飞杭兮越海	zhi'fei'hang'xi'yue'hai	0
执弓挟矢	zhi'gong'xie'shi	0
直躬指而信志	zhi'gong'zhi'er'xin'zhi	0
炙鸹烝凫	zhi'gua'zheng'fu	0
志憾恨而不逞兮	zhi'han'hen'er'bu'cheng'xi	0
志浩荡而伤怀	zhi'hao'dang'er'shang'huai	0
志怀逝兮心懰栗	zhi'huai'shi'xi'xin'liu'li	0
制芰荷以为衣兮	zhi'ji'he'yi'wei'yi'xi	0
至今九年而不复	zhi'jin'jiu'nian'er'bu'fu	0
指九天以为正兮	zhi'jiu'tian'yi'wei'zheng'xi	0
挚咎繇而能调	zhi'jiu'yao'er'neng'tiao	0
直怐愗而自苦	zhi'ju'mao'er'zi'ku	0
志欿憾而不憺兮	zhi'kan'han'er'bu'dan'xi	0
志坎壈而不违	zhi'kan'lan'er'bu'wei	0
至会稽而且止	zhi'kuai'ji'er'qie'zhi	0
志恋恋兮依依	zhi'lian'lian'xi'yi'yi	0
指列宿以白情兮	zhi'lie'su'yi'bai'qing'xi	0
芷闾兮药房	zhi'lv'xi'yao'fang	0
志瞀迷而不知路	zhi'mao'mi'er'bu'zhi'lu	0
致命於帝	zhi'ming'yu'di	0
至南巢而壹息	zhi'nan'chao'er'yi'xi	0
鸷鸟之不群兮	zhi'niao'zhi'bu'qun'xi	0
志怦怦而内直兮	zhi'peng'peng'er'nei'zhi'xi	0
指彭咸以为仪	zhi'peng'xian'yi'wei'yi	0
芷葺兮荷屋	zhi'qi'xi'he'wu	0
志迁蹇而左倾	zhi'qian'jian'er'zuo'qing	0
知前辙之不遂兮	zhi'qian'zhe'zhi'bu'sui'xi	0
执权衡而无私兮	zhi'quan'heng'er'wu'si'xi	0
指日月使延照兮	zhi'ri'yue'shi'yan'zhao'xi	0
知山川之纡曲	zhi'shan'chuan'zhi'yu'qu	0
陟升皇之赫戏兮	zhi'sheng'huang'zhi'he'xi'xi	0
志升降以高驰	zhi'sheng'jiang'yi'gao'chi	0
知时固而不反	zhi'shi'gu'er'bu'fan	0
直士隐而避匿兮	zhi'shi'yin'er'bi'ni'xi	0
知死不可让	zhi'si'bu'ke'rang	0
知贪饵而近死兮	zhi'tan'er'er'jin'si'xi	0
执棠溪以刜蓬兮	zhi'tang'xi'yi'fu'peng'xi	0
指西海以为期	zhi'xi'hai'yi'wei'qi	0
雉咸雊兮相求	zhi'xian'gou'xi'xiang'qiu	0
质销铄以汋约兮	zhi'xiao'shuo'yi'que'yue'xi	0
志欣乐兮反征	zhi'xin'le'xi'fan'zheng	0
志蓄积兮未通	zhi'xu'ji'xi'wei'tong	0
志阏绝兮安如	zhi'yan'jue'xi'an'ru	0
指炎神而直驰兮	zhi'yan'shen'er'zhi'chi'xi	0
置以为像兮	zhi'yi'wei'xiang'xi	0
直赢在位	zhi'ying'zai'wei	0
志犹卑夫禹汤	zhi'you'bei'fu'yu'tang	0
智有所不明	zhi'you'suo'bu'ming	0
志纡郁其难释	zhi'yu'yu'qi'nan'shi	0
置援狖於櫺槛兮	zhi'yuan'you'yu'ling'kan'xi	0
指正义兮为曲	zhi'zheng'yi'xi'wei'qu	0
稚硃颜只	zhi'zhu'yan'zhi	0
执组者不能制兮	zhi'zu'zhe'bu'neng'zhi'xi	0
众薆然而蔽之	zhong'ai'ran'er'bi'zhi	0
中坂蹉跎	zhong'ban'cuo'tuo	0
众比周以肩迫兮	zhong'bi'zhou'yi'jian'po'xi	0
众并谐以妒贤兮	zhong'bing'xie'yi'du'xian'xi	0
忠不必用兮	zhong'bu'bi'yong'xi	0
终不变而死节兮	zhong'bu'bian'er'si'jie'xi	0
终不察夫民心	zhong'bu'cha'fu'min'xin	0
终不反其故都	zhong'bu'fan'qi'gu'dou	0
众不可户说兮	zhong'bu'ke'hu'shuo'xi	0
终不以邪枉害方	zhong'bu'yi'xie'wang'hai'fang	0
众不知余之异采	zhong'bu'zhi'yu'zhi'yi'cai	0
众谗人之嫉妒兮	zhong'chan'ren'zhi'ji'du'xi	0
终长夜之曼曼兮	zhong'chang'ye'zhi'man'man'xi	0
忠臣贞而欲谏兮	zhong'chen'zhen'er'yu'jian'xi	0
众多兮阿媚	zhong'duo'xi'a'mei	0
终刚强兮不可凌	zhong'gang'qiang'xi'bu'ke'ling	0
众果以我为患	zhong'guo'yi'wo'wei'huan	0
众骇遽以离心兮	zhong'hai'ju'yi'li'xin'xi	0
忠何罪以遇罚兮	zhong'he'zui'yi'yu'fa'xi	0
众秽盛兮沓沓	zhong'hui'sheng'xi'ta'ta	0
中皎洁而淑清	zhong'jiao'jie'er'shu'qing	0
众皆竞进以贪婪兮	zhong'jie'jing'jin'yi'tan'lan'xi	0
中结轸而增伤	zhong'jie'zhen'er'zeng'shang	0
踵九阳兮戏荡	zhong'jiu'yang'xi'xi'dang	0
中憀恻之悽怆兮	zhong'liao'ce'zhi'qi'chuang'xi	0
中瞀乱兮迷惑	zhong'mao'luan'xi'mi'huo	0
中闷瞀之忳忳	zhong'men'mao'zhi'tun'tun	0
忠名弥彰	zhong'ming'mi'zhang	0
众莫知兮余所为	zhong'mo'zhi'xi'yu'suo'wei	0
仲尼兮困厄	zhong'ni'xi'kun'e	0
众鸟皆有行列兮	zhong'niao'jie'you'hang'lie'xi	0
众鸟皆有所登栖兮	zhong'niao'jie'you'suo'deng'qi'xi	0
众女嫉余之蛾眉兮	zhong'nv'ji'yu'zhi'e'mei'xi	0
众踥蹀而日进兮	zhong'qie'die'er'ri'jin'xi	0
众轻积而折轴兮	zhong'qing'ji'er'zhe'zhou'xi	0
终然为害	zhong'ran'wei'hai	0
终然殀乎羽之野	zhong'ran'yao'hu'yu'zhi'ye	0
众人皆醉	zhong'ren'jie'zui	0
众人皆醉我独醒	zhong'ren'jie'zui'wo'du'xing	0
众人莫可与论道兮	zhong'ren'mo'ke'yu'lun'dao'xi	0
重任石之何益	zhong'ren'shi'zhi'he'yi	0
重仁袭义兮	zhong'ren'xi'yi'xi	0
众孰可与深谋	zhong'shu'ke'yu'shen'mou	0
众体错兮交纷	zhong'ti'cuo'xi'jiao'fen	0
众枉聚而矫直	zhong'wang'ju'er'jiao'zhi	0
终危独以离异兮	zhong'wei'du'yi'li'yi'xi	0
重无怨而生离兮	zhong'wu'yuan'er'sheng'li'xi	0
锺牙已死谁为声兮	zhong'ya'yi'si'shui'wei'sheng'xi	0
中央共牧	zhong'yang'gong'mu	0
终以灭丧	zhong'yi'mie'sang	0
重曰	zhong'yue	0
忠湛湛而原进兮	zhong'zhan'zhan'er'yuan'jin'xi	0
忠昭昭而原见兮	zhong'zhao'zhao'er'yuan'jian'xi	0
周八极兮历九州	zhou'ba'ji'xi'li'jiu'zhou	0
纣暴虐以失位兮	zhou'bao'nve'yi'shi'wei'xi	0
周得佐乎吕望	zhou'de'zuo'hu'lv'wang	0
周鼎潜潜乎深渊	zhou'ding'qian'qian'hu'shen'yuan	0
骤谏君而不听兮	zhou'jian'jun'er'bu'ting'xi	0
周流观乎上下	zhou'liu'guan'hu'shang'xia	0
周流乎天余乃下	zhou'liu'hu'tian'yu'nai'xia	0
周流览於四海兮	zhou'liu'lan'yu'si'hai'xi	0
周流六漠	zhou'liu'liu'mo	0
周论道而莫差	zhou'lun'dao'er'mo'cha	0
酎清凉些	zhou'qing'liang'xie	0
周容容而无识	zhou'rong'rong'er'wu'shi	0
周邵兮负刍	zhou'shao'xi'fu'chu	0
酎饮尽欢	zhou'yin'jin'huan	0
周幽谁诛	zhou'you'shui'zhu	0
硃尘筵些	zhu'chen'yan'xie	0
硃脣皓齿	zhu'chun'hao'chi	0
主此盛德兮	zhu'ci'sheng'de'xi	0
诸侯毕极	zhu'hou'bi'ji	0
株秽除兮兰芷睹	zhu'hui'chu'xi'lan'zhi'du	0
诛讥罢只	zhu'ji'ba'zhi	0
逐江湘之顺流	zhu'jiang'xiang'zhi'shun'liu	0
伫立兮忉怛	zhu'li'xi'dao'da	0
烛龙何照	zhu'long'he'zhao	0
硃明承夜兮	zhu'ming'cheng'ye'xi	0
逐人駓駓些	zhu'ren'pi'pi'xie	0
祝融戒而跸御兮	zhu'rong'jie'er'bi'yu'xi	0
筑室兮水中	zhu'shi'xi'shui'zhong	0
跓俟兮须明	zhu'si'xi'xu'ming	0
逐下袟於後堂兮	zhu'xia'zhi'yu'hou'tang'xi	0
硃颜酡些	zhu'yan'tuo'xie	0
株昭悲哉于嗟兮	zhu'zhao'bei'zai'yu'jie'xi	0
株榛兮岳岳	zhu'zhen'xi'yue'yue	0
杼中情而属诗	zhu'zhong'qing'er'shu'shi	0
硃紫兮杂乱	zhu'zi'xi'za'luan	0
专精爽以自明兮	zhuan'jing'shuang'yi'zi'ming'xi	0
专思君兮不可化	zhuan'si'jun'xi'bu'ke'hua	0
撰体胁鹿	zhuan'ti'xie'lu	0
专惟君而无他兮	zhuan'wei'jun'er'wu'ta'xi	0
撰余辔而正策兮	zhuan'yu'pei'er'zheng'ce'xi	0
撰余辔兮高驰翔	zhuan'yu'pei'xi'gao'chi'xiang	0
状皃崟崟兮峨峨	zhuang'mao'yin'yin'xi'e'e	0
缀鬼谷於北辰	zhui'gui'gu'yu'bei'chen	0
坠何故以东南倾	zhui'he'gu'yi'dong'nan'qing	0
追悔过之无及兮	zhui'hui'guo'zhi'wu'ji'xi	0
斫冰兮积雪	zhuo'bing'xi'ji'xue	0
啄害下人些	zhuo'hai'xia'ren'xie	0
浞娶纯狐	zhuo'qu'chun'hu	0
浞又贪夫厥家	zhuo'you'tan'fu'jue'jia	0
自悲居愁懃其谁告兮	zi'bei'ju'chou'qin'qi'shui'gao'xi	0
紫贝阙而玉堂	zi'bei'que'er'yu'tang	0
紫贝阙兮硃宫	zi'bei'que'xi'zhu'gong	0
子非三闾大夫与	zi'fei'san'lv'da'fu'yu	0
自古而固然兮	zi'gu'er'gu'ran'xi	0
自恨兮无友	zi'hen'xi'wu'you	0
子交手兮东行	zi'jiao'shou'xi'dong'xing	0
紫茎屏风	zi'jing'ping'feng	0
兹历情以陈辞兮	zi'li'qing'yi'chen'ci'xi	0
自令放为	zi'ling'fang'wei	0
薋菉葹以盈室兮	zi'lu'shi'yi'ying'shi'xi	0
自明及晦	zi'ming'ji'hui	0
子慕予兮善窈窕	zi'mu'yu'xi'shan'yao'tiao	0
自前世而固然	zi'qian'shi'er'gu'ran	0
自前世之嫉贤兮	zi'qian'shi'zhi'ji'xian'xi	0
姿盛质而无愆	zi'sheng'zhi'er'wu'qian	0
恣所便只	zi'suo'bian'zhi	0
恣所尝只	zi'suo'chang'zhi	0
恣所择只	zi'suo'ze'zhi	0
子推自割而饲君兮	zi'tui'zi'ge'er'si'jun'xi	0
子胥谏而靡躯兮	zi'xu'jian'er'mi'qu'xi	0
子胥死而不葬	zi'xu'si'er'bu'zang	0
子胥死而成义兮	zi'xu'si'er'cheng'yi'xi	0
子胥死而後忧	zi'xu'si'er'hou'you	0
自厌按而学诵	zi'yan'an'er'xue'song	0
訿玉璧兮为石	zi'yu'bi'xi'wei'shi	0
字余曰灵均	zi'yu'yue'ling'jun	0
恣志虑只	zi'zhi'lv'zhi	0
自恣荆楚	zi'zi'jing'chu	0
宗鬼神之无次	zong'gui'shen'zhi'wu'ci	0
纵欲而不忍	zong'yu'er'bu'ren	0
总余辔乎扶桑	zong'yu'pei'hu'fu'sang	0
走鬯罔兮乍东西	zou'chang'wang'xi'zha'dong'xi	0
奏大吕些	zou'da'lv'xie	0
奏九歌而舞韶兮	zou'jiu'ge'er'wu'shao'xi	0
邹衍兮幽囚	zou'yan'xi'you'qiu	0
奏虞舜於苍梧	zou'yu'shun'yu'cang'wu	0
卒不得效其心容兮	zu'bu'de'xiao'qi'xin'rong'xi	0
卒抚情以寂寞兮	zu'fu'qing'yi'ji'mo'xi	0
卒见弃乎原野	zu'jian'qi'hu'yuan'ye	0
卒没身而绝名兮	zu'mo'shen'er'jue'ming'xi	0
卒莫有兮纤介	zu'mo'you'xi'xian'jie	0
卒其异方	zu'qi'yi'fang	0
阻穷西征	zu'qiong'xi'zheng	0
卒然离蠥	zu'ran'li'nie	0
卒然身杀	zu'ran'shen'sha	0
卒无禄	zu'wu'lu	0
卒夭隐而不荣	zu'yao'yin'er'bu'rong	0
卒廱蔽此浮云	zu'yong'bi'ci'fu'yun	0
纂就前绪	zuan'jiu'qian'xu	0
纂组绮缟	zuan'zu'qi'gao	0
遵赤水而容与	zun'chi'shui'er'rong'yu	0
遵河皋兮周流	zun'he'gao'xi'zhou'liu	0
尊嘉季春兮阳阳	zun'jia'ji'chun'xi'yang'yang	0
遵江曲之逶移兮	zun'jiang'qu'zhi'wei'yi'xi	0
遵江夏以流亡	zun'jiang'xia'yi'liu'wang	0
遵江夏以娱忧	zun'jiang'xia'yi'yu'you	0
尊食宗绪	zun'shi'zong'xu	0
遵野莽以呼风兮	zun'ye'mang'yi'hu'feng'xi	0
左骖殪兮右刃伤	zuo'can'yi'xi'you'ren'shang	0
左长薄	zuo'chang'bo	0
左见兮鸣鵙	zuo'jian'xi'ming'ju	0
左袪挂於榑桑	zuo'qu'gua'yu'fu'sang	0
糳申椒以为粮	zuo'shen'jiao'yi'wei'liang	0
坐堂伏槛	zuo'tang'fu'kan	0
左雨师使径待兮	zuo'yu'shi'shi'jing'dai'xi	0
左硃雀之茇茇兮	zuo'zhu'que'zhi'ba'ba'xi	0
