安徽淮北矿业集团有限责任公司朔里煤矿	an'hui'huai'bei'kuang'ye'ji'tuan'you'xian'ze'ren'gong'si'shuo'li'mei'kuang	0
安全管理八字方针	an'quan'guan'li'ba'zi'fang'zhen	0
安全管理四个手段行政手段	an'quan'guan'li'si'ge'shou'duan'xing'zheng'shou'duan	0
奥亚膨胀度	ao'ya'peng'zhang'du	0
白煤	bai'mei	0
白云来	bai'yun'lai	0
斑裂	ban'lie	0
刨煤	bao'mei	0
北京煤矿机械厂煤矿机械	bei'jing'mei'kuang'ji'xie'chang'mei'kuang'ji'xie	0
北码	bei'ma	0
北绕道	bei'rao'dao	0
泵矿用电气	beng'kuang'yong'dian'qi	0
玻璃水	bo'li'shui	0
不缴煤	bu'jiao'mei	0
不粘煤	bu'zhan'mei	0
采空区	cai'kong'qu	0
采煤机械化	cai'mei'ji'xie'hua	0
采煤掘进机	cai'mei'jue'jin'ji	0
仓壁	cang'bi	0
长钢	chang'gang	0
常建新	chang'jian'xin	0
长焰煤	chang'yan'mei	0
长治市东华机械有限公司	chang'zhi'shi'dong'hua'ji'xie'you'xian'gong'si	0
沉陷治理	chen'xian'zhi'li	0
陈新明	chen'xin'ming	0
程长真	cheng'chang'zhen	0
臭块	chou'kuai	0
出水煤浆高压隔膜泵	chu'shui'mei'jiang'gao'ya'ge'mo'beng	0
措施	cuo'shi	0
大抽放泵	da'chou'fang'beng	0
大管径	da'guan'jing	0
打孔	da'kong	0
大同煤矿	da'tong'mei'kuang	0
大同煤业集团	da'tong'mei'ye'ji'tuan	0
大同市煤矿机械修造厂煤矿机械	da'tong'shi'mei'kuang'ji'xie'xiu'zao'chang'mei'kuang'ji'xie	0
大雁二矿	da'yan'er'kuang	0
大禹沟煤矿	da'yu'gou'mei'kuang	0
大钻机	da'zuan'ji	0
大钻孔	da'zuan'kong	0
带式输送机自移机尾	dai'shi'shu'song'ji'zi'yi'ji'wei	0
单孔岩石钻孔	dan'kong'yan'shi'zuan'kong	0
氮氧化合物	dan'yang'hua'he'wu	0
当代矿工	dang'dai'kuang'gong	0
底板瓦斯巷抽采	di'ban'wa'si'xiang'chou'cai	0
低浓度瓦斯	di'nong'du'wa'si	0
低渗透率	di'shen'tou'lv	0
电石化学	dian'shi'hua'xue	0
电冶分公司	dian'ye'fen'gong'si	0
调度楼	diao'du'lou	0
丁百元	ding'bai'yuan	0
动力煤	dong'li'mei	0
杜工会	du'gong'hui	0
断层	duan'ceng	0
断面够	duan'mian'gou	0
对拉采煤面	dui'la'cai'mei'mian	0
多环芳烃类	duo'huan'fang'ting'lei	0
鄂州市东方煤机厂煤矿机械	e'zhou'shi'dong'fang'mei'ji'chang'mei'kuang'ji'xie	0
鄂州市江南煤矿机械制造有限公司煤矿机械	e'zhou'shi'jiang'nan'mei'kuang'ji'xie'zhi'zao'you'xian'gong'si'mei'kuang'ji'xie	0
发电用煤	fa'dian'yong'mei	0
防爆指挥车	fang'bao'zhi'hui'che	0
防突十二个字基本要求	fang'tu'shi'er'ge'zi'ji'ben'yao'qiu	0
方庄煤矿	fang'zhuang'mei'kuang	0
非炼焦煤类	fei'lian'jiao'mei'lei	0
肥煤	fei'mei	0
分合管理	fen'he'guan'li	0
峰峰集团	feng'feng'ji'tuan	0
风机	feng'ji	0
风井	feng'jing	0
风量	feng'liang	0
风量足	feng'liang'zu	0
冯营电力公司	feng'ying'dian'li'gong'si	0
富华矿难	fu'hua'kuang'nan	0
福建省煤矿机械厂煤矿机械	fu'jian'sheng'mei'kuang'ji'xie'chang'mei'kuang'ji'xie	0
福建省永安永煤机械有限公司	fu'jian'sheng'yong'an'yong'mei'ji'xie'you'xian'gong'si	0
副井	fu'jing	0
干馏	gan'liu	0
矸石排放	gan'shi'pai'fang	0
甘肃华亭煤电股份有限公司砚北煤矿	gan'su'hua'ting'mei'dian'gu'fen'you'xian'gong'si'yan'bei'mei'kuang	0
干燥无灰基挥发分	gan'zao'wu'hui'ji'hui'fa'fen	0
高档普采	gao'dang'pu'cai	0
高建中	gao'jian'zhong	0
高炉喷吹用无烟煤	gao'lu'pen'chui'yong'wu'yan'mei	0
高炉喷煤专用混合器	gao'lu'pen'mei'zhuan'yong'hun'he'qi	0
高渗透率	gao'shen'tou'lv	0
高唐县龙鑫机械制造有限公司	gao'tang'xian'long'xin'ji'xie'zhi'zao'you'xian'gong'si	0
膏体充填	gao'ti'chong'tian	0
膏体自流充填工艺	gao'ti'zi'liu'chong'tian'gong'yi	0
高位钻孔抽采	gao'wei'zuan'kong'chou'cai	0
高效刮板输送机	gao'xiao'gua'ban'shu'song'ji	0
高效治理煤矿瓦斯	gao'xiao'zhi'li'mei'kuang'wa'si	0
高压变频装置	gao'ya'bian'pin'zhuang'zhi	0
跟班	gen'ban	0
工作面	gong'zuo'mian	0
工作面输送机	gong'zuo'mian'shu'song'ji	0
古汉山矿	gu'han'shan'kuang	0
管理	guan'li	0
国家安全生产监督管理总局	guo'jia'an'quan'sheng'chan'jian'du'guan'li'zong'ju	0
郭建周	guo'jian'zhou	0
海孜煤矿	hai'zi'mei'kuang	0
好人谢延信	hao'ren'xie'yan'xin	0
河北开滦精煤股份有限公司吕家坨矿业分公司	he'bei'kai'luan'jing'mei'gu'fen'you'xian'gong'si'lv'jia'tuo'kuang'ye'fen'gong'si	0
褐煤	he'mei	0
鹤煤	he'mei	0
河南焦煤集团	he'nan'jiao'mei'ji'tuan	0
河南焦作煤业集团有限责任公司古汉山矿	he'nan'jiao'zuo'mei'ye'ji'tuan'you'xian'ze'ren'gong'si'gu'han'shan'kuang	0
河南省荥阳煤矿机械厂煤矿机械	he'nan'sheng'xing'yang'mei'kuang'ji'xie'chang'mei'kuang'ji'xie	0
黑龙江省牡丹江煤矿机械厂	hei'long'jiang'sheng'mu'dan'jiang'mei'kuang'ji'xie'chang	0
黑龙江省瑞丰机械制造有限责任公司	hei'long'jiang'sheng'rui'feng'ji'xie'zhi'zao'you'xian'ze'ren'gong'si	0
黑龙江双鸭山矿业集团有限公司东荣二矿	hei'long'jiang'shuang'ya'shan'kuang'ye'ji'tuan'you'xian'gong'si'dong'rong'er'kuang	0
黑煤	hei'mei	0
黑烟	hei'yan	0
亨南煤矿	heng'nan'mei'kuang	0
横向摆动	heng'xiang'bai'dong	0
宏程工程建设有限公司	hong'cheng'gong'cheng'jian'she'you'xian'gong'si	0
后退式工作面	hou'tui'shi'gong'zuo'mian	0
呼和浩特市强力煤矿机械有限责任公司	hu'he'hao'te'shi'qiang'li'mei'kuang'ji'xie'you'xian'ze'ren'gong'si	0
湖南省煤矿机械厂煤矿机械	hu'nan'sheng'mei'kuang'ji'xie'chang'mei'kuang'ji'xie	0
湖南远杨煤矿机械厂煤矿机械	hu'nan'yuan'yang'mei'kuang'ji'xie'chang'mei'kuang'ji'xie	0
华丰	hua'feng	0
花园式矿山	hua'yuan'shi'kuang'shan	0
淮化集团	huai'hua'ji'tuan	0
淮南矿业集团	huai'nan'kuang'ye'ji'tuan	0
淮南煤矿	huai'nan'mei'kuang	0
淮南煤矿机械厂煤矿机械	huai'nan'mei'kuang'ji'xie'chang'mei'kuang'ji'xie	0
黄推工程机械网	huang'tui'gong'cheng'ji'xie'wang	0
灰分	hui'fen	0
回风石门	hui'feng'shi'men	0
回风巷	hui'feng'xiang	0
活性炭	huo'xing'tan	0
济宁市永利机械有限责任公司	ji'ning'shi'yong'li'ji'xie'you'xian'ze'ren'gong'si	0
鸡西煤矿	ji'xi'mei'kuang	0
鸡西煤矿机械有限公司配件厂	ji'xi'mei'kuang'ji'xie'you'xian'gong'si'pei'jian'chang	0
机械行业资料网	ji'xie'hang'ye'zi'liao'wang	0
机械化采煤	ji'xie'hua'cai'mei	0
佳木斯煤矿机械有限公司煤矿机械	jia'mu'si'mei'kuang'ji'xie'you'xian'gong'si'mei'kuang'ji'xie	0
贾学勤	jia'xue'qin	0
建材用煤	jian'cai'yong'mei	0
检修硐室	jian'xiu'dong'shi	0
江苏徐州矿务集团有限公司张双楼煤矿	jiang'su'xu'zhou'kuang'wu'ji'tuan'you'xian'gong'si'zhang'shuang'lou'mei'kuang	0
焦化	jiao'hua	0
焦煤	jiao'mei	0
焦煤车板	jiao'mei'che'ban	0
焦炭	jiao'tan	0
胶质层最大厚度	jiao'zhi'ceng'zui'da'hou'du	0
焦作巨龙泵业有限公司	jiao'zuo'ju'long'beng'ye'you'xian'gong'si	0
焦作矿工报	jiao'zuo'kuang'gong'bao	0
焦作矿务局	jiao'zuo'kuang'wu'ju	0
焦作煤业	jiao'zuo'mei'ye	0
焦作煤业集团东方宾馆	jiao'zuo'mei'ye'ji'tuan'dong'fang'bin'guan	0
焦作煤业集团千业水泥	jiao'zuo'mei'ye'ji'tuan'qian'ye'shui'ni	0
焦作煤业集团职工医学院	jiao'zuo'mei'ye'ji'tuan'zhi'gong'yi'xue'yuan	0
焦作煤业集团中央医院	jiao'zuo'mei'ye'ji'tuan'zhong'yang'yi'yuan	0
焦作神华重型机械有限公司	jiao'zuo'shen'hua'zhong'xing'ji'xie'you'xian'gong'si	0
焦作神瑞工贸有限公司	jiao'zuo'shen'rui'gong'mao'you'xian'gong'si	0
焦作市弘光橡胶有限责任公司	jiao'zuo'shi'hong'guang'xiang'jiao'you'xian'ze'ren'gong'si	0
解放中路群英桥向东米路北	jie'fang'zhong'lu'qun'ying'qiao'xiang'dong'mi'lu'bei	0
截割头电机	jie'ge'tou'dian'ji	0
节能	jie'neng	0
接应巷道	jie'ying'hang'dao	0
晋城煤业	jin'cheng'mei'ye	0
进风闸门	jin'feng'zha'men	0
井底煤泥加工系统	jing'di'mei'ni'jia'gong'xi'tong	0
经济手段	jing'ji'shou'duan	0
井架	jing'jia	0
靖江煤矿机械厂	jing'jiang'mei'kuang'ji'xie'chang	0
靖江市巨星锻造有限公司煤矿机械	jing'jiang'shi'ju'xing'duan'zao'you'xian'gong'si'mei'kuang'ji'xie	0
精煤	jing'mei	0
精煤市场	jing'mei'shi'chang	0
井上矸石填充	jing'shang'gan'shi'tian'chong	0
井田	jing'tian	0
井筒	jing'tong	0
井下胶鞋	jing'xia'jiao'xie	0
井下排水处理站	jing'xia'pai'shui'chu'li'zhan	0
井下水平定向钻进技术	jing'xia'shui'ping'ding'xiang'zuan'jin'ji'shu	0
井下原生矸石	jing'xia'yuan'sheng'gan'shi	0
救护救援装备	jiu'hu'jiu'yuan'zhuang'bei	0
九里山矿	jiu'li'shan'kuang	0
举高一面旗	ju'gao'yi'mian'qi	0
聚乙烯抽放瓦斯管	ju'yi'xi'chou'fang'wa'si'guan	0
聚乙烯秸秆燃气管	ju'yi'xi'jie'gan'ran'qi'guan	0
掘进	jue'jin	0
掘砌	jue'qi	0
卡钻	ka'zuan	0
开采一体化	kai'cai'yi'ti'hua	0
开滦集团	kai'luan'ji'tuan	0
凯马煤冶化有限公司	kai'ma'mei'ye'hua'you'xian'gong'si	0
空气炮	kong'qi'pao	0
宽中部槽	kuan'zhong'bu'cao	0
矿灯	kuang'deng	0
矿井	kuang'jing	0
矿井水	kuang'jing'shui	0
矿井通风	kuang'jing'tong'feng	0
矿帽	kuang'mao	0
矿难	kuang'nan	0
李长军	li'chang'jun	0
李封公司	li'feng'gong'si	0
联合建筑	lian'he'jian'zhu	0
炼焦煤	lian'jiao'mei	0
炼焦炭	lian'jiao'tan	0
两改两营	liang'gai'liang'ying	0
辽宁铁法煤业集团有限责任公司大平煤矿	liao'ning'tie'fa'mei'ye'ji'tuan'you'xian'ze'ren'gong'si'da'ping'mei'kuang	0
劣质煤种	lie'zhi'mei'zhong	0
六大无烟煤生产基地之一	liu'da'wu'yan'mei'sheng'chan'ji'di'zhi'yi	0
硫化物	liu'hua'wu	0
刘九学	liu'jiu'xue	0
刘魁景	liu'kui'jing	0
硫酸盐	liu'suan'yan	0
吕茂盛	lv'mao'sheng	0
码头门	ma'tou'men	0
冒顶	mao'ding	0
锚杆	mao'gan	0
锚索	mao'suo	0
煤仓	mei'cang	0
煤仓滞煤率	mei'cang'zhi'mei'lv	0
煤层	mei'ceng	0
煤的恒湿无灰基高位发热量	mei'de'heng'shi'wu'hui'ji'gao'wei'fa're'liang	0
煤粉	mei'fen	0
煤粉输出孔	mei'fen'shu'chu'kong	0
煤矸石	mei'gan'shi	0
煤矸石山	mei'gan'shi'shan	0
煤高压加氢液化	mei'gao'ya'jia'qing'ye'hua	0
煤化工	mei'hua'gong	0
煤浆	mei'jiang	0
煤矿尘肺病	mei'kuang'chen'fei'bing	0
煤矿井下工作面	mei'kuang'jing'xia'gong'zuo'mian	0
煤气化	mei'qi'hua	0
煤炭加工化验设备	mei'tan'jia'gong'hua'yan'she'bei	0
煤炭科学研究总院	mei'tan'ke'xue'yan'jiu'zong'yuan	0
煤炭清洁生产网	mei'tan'qing'jie'sheng'chan'wang	0
煤炭信息	mei'tan'xin'xi	0
煤炭信息交易网	mei'tan'xin'xi'jiao'yi'wang	0
煤田	mei'tian	0
煤样透光性	mei'yang'tou'guang'xing	0
密闭墙	mi'bi'qiang	0
名誉理事长王显政	ming'yu'li'shi'zhang'wang'xian'zheng	0
慕松利	mu'song'li	0
南京江南机械厂有限公司	nan'jing'jiang'nan'ji'xie'chang'you'xian'gong'si	0
南码	nan'ma	0
内蒙古扎赉诺尔煤业有限责任公司灵泉煤矿	nei'meng'gu'zha'lai'nuo'er'mei'ye'you'xian'ze'ren'gong'si'ling'quan'mei'kuang	0
粘结指数	nian'jie'zhi'shu	0
配煤合格率	pei'mei'he'ge'lv	0
培训手段	pei'xun'shou'duan	0
喷煤	pen'mei	0
喷煤专用混合器	pen'mei'zhuan'yong'hun'he'qi	0
皮代队	pi'dai'dui	0
贫煤	pin'mei	0
贫瘦煤	pin'shou'mei	0
平顶山煤矿机械厂煤矿机械	ping'ding'shan'mei'kuang'ji'xie'chang'mei'kuang'ji'xie	0
平顶山煤业	ping'ding'shan'mei'ye	0
平煤	ping'mei	0
破碎机	po'sui'ji	0
普采	pu'cai	0
气肥煤	qi'fei'mei	0
气煤	qi'mei	0
七台河市鑫泰机械制造有限责任公司	qi'tai'he'shi'xin'tai'ji'xie'zhi'zao'you'xian'ze'ren'gong'si	0
牵住一个魂	qian'zhu'yi'ge'hun	0
区队	qu'dui	0
醛类等污染物	quan'lei'deng'wu'ran'wu	0
热效率	re'xiao'lv	0
认识	ren'shi	0
绒衣	rong'yi	0
入井人员	ru'jing'ren'yuan	0
弱碱煤	ruo'jian'mei	0
弱粘煤	ruo'zhan'mei	0
山东煤矿济南机械厂煤矿机械	shan'dong'mei'kuang'ji'nan'ji'xie'chang'mei'kuang'ji'xie	0
山东新汶矿业集团有限责任公司华丰煤矿	shan'dong'xin'wen'kuang'ye'ji'tuan'you'xian'ze'ren'gong'si'hua'feng'mei'kuang	0
山东枣庄矿业集团有限责任公司蒋庄煤矿	shan'dong'zao'zhuang'kuang'ye'ji'tuan'you'xian'ze'ren'gong'si'jiang'zhuang'mei'kuang	0
山东枣庄矿业集团有限责任公司田陈煤矿	shan'dong'zao'zhuang'kuang'ye'ji'tuan'you'xian'ze'ren'gong'si'tian'chen'mei'kuang	0
山西大同煤矿集团有限责任公司马脊梁矿	shan'xi'da'tong'mei'kuang'ji'tuan'you'xian'ze'ren'gong'si'ma'ji'liang'kuang	0
山西焦煤集团汾西矿业集团有限责任公司贺西煤矿	shan'xi'jiao'mei'ji'tuan'fen'xi'kuang'ye'ji'tuan'you'xian'ze'ren'gong'si'he'xi'mei'kuang	0
山西晋城无烟煤矿业集团有限责任公司寺河煤矿	shan'xi'jin'cheng'wu'yan'mei'kuang'ye'ji'tuan'you'xian'ze'ren'gong'si'si'he'mei'kuang	0
山西省忻州市煤矿机械厂	shan'xi'sheng'xin'zhou'shi'mei'kuang'ji'xie'chang	0
山西忻州通用机械有限责任公司煤矿机械	shan'xi'xin'zhou'tong'yong'ji'xie'you'xian'ze'ren'gong'si'mei'kuang'ji'xie	0
山西阳泉煤业集团有限责任公司三矿	shan'xi'yang'quan'mei'ye'ji'tuan'you'xian'ze'ren'gong'si'san'kuang	0
上海宝山煤矿机械有限公司煤矿机械	shang'hai'bao'shan'mei'kuang'ji'xie'you'xian'gong'si'mei'kuang'ji'xie	0
烧结	shao'jie	0
设施牢	she'shi'lao	0
神华	shen'hua	0
神华集团神东煤炭公司补连塔煤矿	shen'hua'ji'tuan'shen'dong'mei'tan'gong'si'bu'lian'ta'mei'kuang	0
神华集团神东煤炭公司榆家梁煤矿	shen'hua'ji'tuan'shen'dong'mei'tan'gong'si'yu'jia'liang'mei'kuang	0
神火	shen'huo	0
深井高瓦斯	shen'jing'gao'wa'si	0
沈阳天安矿山机械科技有限公司	shen'yang'tian'an'kuang'shan'ji'xie'ke'ji'you'xian'gong'si	0
沈阳冶金机械公司	shen'yang'ye'jin'ji'xie'gong'si	0
生活用煤	sheng'huo'yong'mei	0
盛天宝	sheng'tian'bao	0
石壕煤矿	shi'hao'mei'kuang	0
十级主焦煤	shi'ji'zhu'jiao'mei	0
石家庄煤机公司	shi'jia'zhuang'mei'ji'gong'si	0
瘦煤	shou'mei	0
双刨煤面开采	shuang'bao'mei'mian'kai'cai	0
四川华蓥山广能集团李子垭煤业有限责任公司	si'chuan'hua'ying'shan'guang'neng'ji'tuan'li'zi'ya'mei'ye'you'xian'ze'ren'gong'si	0
四川南充成发矿机制造有限公司	si'chuan'nan'chong'cheng'fa'kuang'ji'zhi'zao'you'xian'gong'si	0
四个一	si'ge'yi	0
四增两减	si'zeng'liang'jian	0
松藻煤矿	song'zao'mei'kuang	0
随钻准确测量定向	sui'zuan'zhun'que'ce'liang'ding'xiang	0
泰安市华光煤矿机械厂	tai'an'shi'hua'guang'mei'kuang'ji'xie'chang	0
碳酸盐	tan'suan'yan	0
套管	tao'guan	0
特别能战斗	te'bie'neng'zhan'dou	0
提升贮运设备	ti'sheng'zhu'yun'she'bei	0
天然焦	tian'ran'jiao	0
调速耦合器软启动装置	tiao'su'ou'he'qi'ruan'qi'dong'zhuang'zhi	0
铁法集团	tie'fa'ji'tuan	0
通风区调度室	tong'feng'qu'diao'du'shi	0
通风区机房	tong'feng'qu'ji'fang	0
桶直道	tong'zhi'dao	0
透水	tou'shui	0
团结奋进务实创新	tuan'jie'fen'jin'wu'shi'chuang'xin	0
瓦斯	wa'si	0
瓦斯抽采	wa'si'chou'cai	0
瓦斯抽采率	wa'si'chou'cai'lv	0
瓦斯抽采浓度	wa'si'chou'cai'nong'du	0
瓦斯抽采钻孔	wa'si'chou'cai'zuan'kong	0
瓦斯抽放	wa'si'chou'fang	0
瓦斯抽放四大	wa'si'chou'fang'si'da	0
瓦斯工区九里山站	wa'si'gong'qu'jiu'li'shan'zhan	0
瓦斯工区位村站	wa'si'gong'qu'wei'cun'zhan	0
瓦斯工区演马矿西风井站	wa'si'gong'qu'yan'ma'kuang'xi'feng'jing'zhan	0
瓦斯工区中马站	wa'si'gong'qu'zhong'ma'zhan	0
瓦斯治理	wa'si'zhi'li	0
皖北祁东煤矿	wan'bei'qi'dong'mei'kuang	0
王庄煤矿	wang'zhuang'mei'kuang	0
渭南市煤矿机械厂	wei'nan'shi'mei'kuang'ji'xie'chang	0
魏世义	wei'shi'yi	0
温县中业煤矿机械有限公司	wen'xian'zhong'ye'mei'kuang'ji'xie'you'xian'gong'si	0
温州巨隆液压设备有限公司煤矿机械	wen'zhou'ju'long'ye'ya'she'bei'you'xian'gong'si'mei'kuang'ji'xie	0
无锁防滑	wu'suo'fang'hua	0
无烟煤	wu'yan'mei	0
无烟喷吹煤	wu'yan'pen'chui'mei	0
西北煤矿机械二厂煤矿机械	xi'bei'mei'kuang'ji'xie'er'chang'mei'kuang'ji'xie	0
西风井注浆站	xi'feng'jing'zhu'jiang'zhan	0
洗精煤	xi'jing'mei	0
洗煤厂	xi'mei'chang	0
洗煤工	xi'mei'gong	0
系统顺	xi'tong'shun	0
下井	xia'jing	0
现场手段	xian'chang'shou'duan	0
现代化大型企业集团	xian'dai'hua'da'xing'qi'ye'ji'tuan	0
香块	xiang'kuai	0
香砟	xiang'zha	0
新丰矿难	xin'feng'kuang'nan	0
新疆乌鲁木齐矿业集团有限责任公司大洪沟煤矿	xin'jiang'wu'lu'mu'qi'kuang'ye'ji'tuan'you'xian'ze'ren'gong'si'da'hong'gou'mei'kuang	0
新乡能源有限公司	xin'xiang'neng'yuan'you'xian'gong'si	0
新亚商厦有限责任公司	xin'ya'shang'sha'you'xian'ze'ren'gong'si	0
鑫珠春工业有限公司	xin'zhu'chun'gong'ye'you'xian'gong'si	0
许昌永盛达煤矿机械制造有限责任公司	xu'chang'yong'sheng'da'mei'kuang'ji'xie'zhi'zao'you'xian'ze'ren'gong'si	0
许成富	xu'cheng'fu	0
徐州煤矿机械厂煤矿机械	xu'zhou'mei'kuang'ji'xie'chang'mei'kuang'ji'xie	0
徐州天能煤矿机械制造有限公司	xu'zhou'tian'neng'mei'kuang'ji'xie'zhi'zao'you'xian'gong'si	0
悬臂式掘进机	xuan'bi'shi'jue'jin'ji	0
选矿设备	xuan'kuang'she'bei	0
压缩分离设备	ya'suo'fen'li'she'bei	0
演马电厂	yan'ma'dian'chang	0
演马矿	yan'ma'kuang	0
兖州煤业	yan'zhou'mei'ye	0
阳泉煤业	yang'quan'mei'ye	0
冶金用动力煤	ye'jin'yong'dong'li'mei	0
液压密封	ye'ya'mi'feng	0
液压元件	ye'ya'yuan'jian	0
以矸换煤绿色开采节能技术	yi'gan'huan'mei'lv'se'kai'cai'jie'neng'ji'shu	0
义煤	yi'mei	0
义县煤矿机械厂煤矿机械	yi'xian'mei'kuang'ji'xie'chang'mei'kuang'ji'xie	0
营城煤矿机械厂煤矿机械	ying'cheng'mei'kuang'ji'xie'chang'mei'kuang'ji'xie	0
用好一套法	yong'hao'yi'tao'fa	0
永煤	yong'mei	0
有烟煤	you'yan'mei	0
榆林阳泉无烟煤	yu'lin'yang'quan'wu'yan'mei	0
运输区矸石车房	yun'shu'qu'gan'shi'che'fang	0
运修区支部	yun'xiu'qu'zhi'bu	0
翟镇煤矿	zhai'zhen'mei'kuang	0
张家口第一煤矿机械有限公司煤矿机械	zhang'jia'kou'di'yi'mei'kuang'ji'xie'you'xian'gong'si'mei'kuang'ji'xie	0
张家口煤矿机械有限公司煤矿机械	zhang'jia'kou'mei'kuang'ji'xie'you'xian'gong'si'mei'kuang'ji'xie	0
张家口市正达煤矿机械有限公司	zhang'jia'kou'shi'zheng'da'mei'kuang'ji'xie'you'xian'gong'si	0
赵固二矿	zhao'gu'er'kuang	0
赵固一矿	zhao'gu'yi'kuang	0
正定县鑫山煤矿机械厂煤矿机械	zheng'ding'xian'xin'shan'mei'kuang'ji'xie'chang'mei'kuang'ji'xie	0
正龙煤业	zheng'long'mei'ye	0
郑煤	zheng'mei	0
蒸汽机车用煤	zheng'qi'ji'che'yong'mei	0
郑州煤矿机械集团有限责任公司煤矿机械	zheng'zhou'mei'kuang'ji'xie'ji'tuan'you'xian'ze'ren'gong'si'mei'kuang'ji'xie	0
郑州市东兴机械化工有限公司	zheng'zhou'shi'dong'xing'ji'xie'hua'gong'you'xian'gong'si	0
郑州市嵩山煤矿机械制造有限公司	zheng'zhou'shi'song'shan'mei'kuang'ji'xie'zhi'zao'you'xian'gong'si	0
滞仓	zhi'cang	0
支护设备	zhi'hu'she'bei	0
滞煤	zhi'mei	0
重点	zhong'dian	0
中国安全产生	zhong'guo'an'quan'chan'sheng	0
中国传动机械网	zhong'guo'chuan'dong'ji'xie'wang	0
中国第一机械网	zhong'guo'di'yi'ji'xie'wang	0
中国煤矿安全网	zhong'guo'mei'kuang'an'quan'wang	0
中国煤矿尘肺病治疗基金会	zhong'guo'mei'kuang'chen'fei'bing'zhi'liao'ji'jin'hui	0
中国煤矿机电网	zhong'guo'mei'kuang'ji'dian'wang	0
中国煤矿机械网	zhong'guo'mei'kuang'ji'xie'wang	0
中国煤矿资源网	zhong'guo'mei'kuang'zi'yuan'wang	0
中国煤炭	zhong'guo'mei'tan	0
中国桩机钻机网	zhong'guo'zhuang'ji'zuan'ji'wang	0
中硫肥煤	zhong'liu'fei'mei	0
中马矿	zhong'ma'kuang	0
中煤	zhong'mei	0
中煤能源集团大屯煤电集团有限公司徐庄煤矿	zhong'mei'neng'yuan'ji'tuan'da'tun'mei'dian'ji'tuan'you'xian'gong'si'xu'zhuang'mei'kuang	0
中煤三建	zhong'mei'san'jian	0
中煤五建	zhong'mei'wu'jian	0
中粘煤	zhong'zhan'mei	0
周口项城市水寨鑫源煤矿机械有限公司煤矿机械	zhou'kou'xiang'cheng'shi'shui'zhai'xin'yuan'mei'kuang'ji'xie'you'xian'gong'si'mei'kuang'ji'xie	0
注浆	zhu'jiang	0
注浆锚杆	zhu'jiang'mao'gan	0
主焦煤	zhu'jiao'mei	0
主井	zhu'jing	0
主扇风机	zhu'shan'feng'ji	0
转载机	zhuan'zai'ji	0
涿州市光明福利煤矿机械厂	zhuo'zhou'shi'guang'ming'fu'li'mei'kuang'ji'xie'chang	0
自动净压水清洗过滤技术	zi'dong'jing'ya'shui'qing'xi'guo'lv'ji'shu	0
综采	zong'cai	0
综采队	zong'cai'dui	0
综采工作面	zong'cai'gong'zuo'mian	0
综采库	zong'cai'ku	0
宗贵民	zong'gui'min	0
走出一条路	zou'chu'yi'tiao'lu	0
钻杆	zuan'gan	0
钻机设备	zuan'ji'she'bei	0
钻进效率	zuan'jin'xiao'lv	0
钻孔纵向偏差	zuan'kong'zong'xiang'pian'cha	0
钻头刀片	zuan'tou'dao'pian	0
