包络线	bao'luo'xian	0
标称值	biao'cheng'zhi	0
波动	bo'dong	0
不平衡因子	bu'ping'heng'yin'zi	0
低次谐波	di'ci'xie'bo	0
电磁干扰	dian'ci'gan'rao	0
电力系统频率允许偏差	dian'li'xi'tong'pin'lv'yun'xu'pian'cha	0
电流不平衡	dian'liu'bu'ping'heng	0
电能质量	dian'neng'zhi'liang	0
电能质量五项标准	dian'neng'zhi'liang'wu'xiang'biao'zhun	0
电能质量五项指标	dian'neng'zhi'liang'wu'xiang'zhi'biao	0
电压不平衡	dian'ya'bu'ping'heng	0
电压短时中断	dian'ya'duan'shi'zhong'duan	0
电压幅值	dian'ya'fu'zhi	0
电压偏差	dian'ya'pian'cha	0
电压切痕	dian'ya'qie'hen	0
电压调幅波	dian'ya'tiao'fu'bo	0
电压允许波动与闪变	dian'ya'yun'xu'bo'dong'yu'shan'bian	0
电压中断	dian'ya'zhong'duan	0
电压骤降	dian'ya'zhou'jiang	0
电压骤升	dian'ya'zhou'sheng	0
动态电能质量	dong'tai'dian'neng'zhi'liang	0
方均根	fang'jun'gen	0
方均根值	fang'jun'gen'zhi	0
非线性	fei'xian'xing	0
非线性负荷	fei'xian'xing'fu'he	0
傅立叶分解	fu'li'ye'fen'jie	0
负偏差	fu'pian'cha	0
负序电流	fu'xu'dian'liu	0
负序电压	fu'xu'dian'ya	0
负序分量	fu'xu'fen'liang	0
高次	gao'ci	0
高次谐波	gao'ci'xie'bo	0
供电电压允许偏差	gong'dian'dian'ya'yun'xu'pian'cha	0
工频	gong'pin	0
公用电网谐波	gong'yong'dian'wang'xie'bo	0
国标	guo'biao	0
过电压	guo'dian'ya	0
含量	han'liang	0
含有率	han'you'lv	0
畸变率	ji'bian'lv	0
基波	ji'bo	0
间谐波	jian'xie'bo	0
零序电流	ling'xu'dian'liu	0
零序电压	ling'xu'dian'ya	0
零序分量	ling'xu'fen'liang	0
录波	lu'bo	0
偶次	ou'ci	0
偶次畸变率	ou'ci'ji'bian'lv	0
偶次谐波	ou'ci'xie'bo	0
频率偏差	pin'lv'pian'cha	0
频谱特征	pin'pu'te'zheng	0
奇次	qi'ci	0
奇次畸变率	qi'ci'ji'bian'lv	0
奇次谐波	qi'ci'xie'bo	0
欠电压	qian'dian'ya	0
三相不对称	san'xiang'bu'dui'chen	0
三相电压允许不平衡度	san'xiang'dian'ya'yun'xu'bu'ping'heng'du	0
闪变	shan'bian	0
瞬变	shun'bian	0
瞬态过电压	shun'tai'guo'dian'ya	0
铁磁饱和	tie'ci'bao'he	0
稳态	wen'tai	0
稳态电压扰动	wen'tai'dian'ya'rao'dong	0
无功补偿	wu'gong'bu'chang	0
无功功率	wu'gong'gong'lv	0
无功功率象限	wu'gong'gong'lv'xiang'xian	0
无源	wu'yuan	0
无源滤波器	wu'yuan'lv'bo'qi	0
谐波	xie'bo	0
谐波电流含量	xie'bo'dian'liu'han'liang	0
谐波电流含有率	xie'bo'dian'liu'han'you'lv	0
谐波电压含量	xie'bo'dian'ya'han'liang	0
谐波电压含有率	xie'bo'dian'ya'han'you'lv	0
谐波抑制	xie'bo'yi'zhi	0
有功功率	you'gong'gong'lv	0
有源	you'yuan	0
有源滤波器	you'yuan'lv'bo'qi	0
载波干扰	zai'bo'gan'rao	0
暂态	zan'tai	0
暂态过电压	zan'tai'guo'dian'ya	0
正偏差	zheng'pian'cha	0
正序电流	zheng'xu'dian'liu	0
正序电压	zheng'xu'dian'ya	0
正序分量	zheng'xu'fen'liang	0
总畸变率	zong'ji'bian'lv	0
