艾布拉姆斯坦克	ai'bu'la'mu'si'tan'ke	0
爱国者导弹	ai'guo'zhe'dao'dan	0
暴风雪坦克	bao'feng'xue'tan'ke	0
冰雹攻城平台	bing'bao'gong'cheng'ping'tai	0
冰冻直升机	bing'dong'zhi'sheng'ji	0
兵营	bing'ying	0
长剑动力机甲	chang'jian'dong'li'ji'jia	0
超时空传送	chao'shi'kong'chuan'song	0
超时空传送仪	chao'shi'kong'chuan'song'yi	0
超时空军团兵	chao'shi'kong'jun'tuan'bing	0
超时空矿车	chao'shi'kong'kuang'che	0
超时空起重机	chao'shi'kong'qi'zhong'ji	0
超时空实验传送平台	chao'shi'kong'shi'yan'chuan'song'ping'tai	0
传送探矿车	chuan'song'tan'kuang'che	0
定点炮台	ding'dian'pao'tai	0
动力涡轮	dong'li'wo'lun	0
斗牛犬轻型坦克	dou'niu'quan'qing'xing'tan'ke	0
发电厂	fa'dian'chang	0
反转士	fan'zhuan'shi	0
防御指挥部	fang'yu'zhi'hui'bu	0
风暴之子	feng'bao'zhi'zi	0
蜂鸟支援机	feng'niao'zhi'yuan'ji	0
工程师	gong'cheng'shi	0
光棱攻城兵	guang'leng'gong'cheng'bing	0
光棱塔	guang'leng'ta	0
光棱坦克	guang'leng'tan'ke	0
海豹突击队	hai'bao'tu'ji'dui	0
海军船坞建造场	hai'jun'chuan'wu'jian'zao'chang	0
海豚	hai'tun	0
航空母舰	hang'kong'mu'jian	0
河童悬浮坦克	he'tong'xuan'fu'tan'ke	0
黑寡妇干扰机	hei'gua'fu'gan'rao'ji	0
黑鹰战机	hei'ying'zhan'ji	0
幻影坦克	huan'ying'tan'ke	0
回溯	hui'su	0
混凝土墙	hun'ning'tu'qiang	0
火箭飞行兵	huo'jian'fei'xing'bing	0
火控节点	huo'kong'jie'dian	0
机器人控制中心	ji'qi'ren'kong'zhi'zhong'xin	0
机器人坦克	ji'qi'ren'tan'ke	0
机枪碉堡	ji'qiang'diao'bao	0
间谍	jian'die	0
狙击手	ju'ji'shou	0
聚能针	ju'neng'zhen	0
巨炮	ju'pao	0
军犬	jun'quan	0
军医	jun'yi	0
科技中心	ke'ji'zhong'xin	0
空降部队	kong'jiang'bu'dui	0
空降控制室	kong'jiang'kong'zhi'shi	0
空军指挥部	kong'jun'zhi'hui'bu	0
矿石精炼厂	kuang'shi'jing'lian'chang	0
矿石提纯器	kuang'shi'ti'chun'qi	0
扩展跑道	kuo'zhan'pao'dao	0
雷达干扰器	lei'da'gan'rao'qi	0
雷神炮艇	lei'shen'pao'ting	0
力场护盾	li'chang'hu'dun	0
猎犬小队	lie'quan'xiao'dui	0
猎杀机器人	lie'sha'ji'qi'ren	0
旅行者运输艇	lv'xing'zhe'yun'shu'ting	0
盟军大兵	meng'jun'da'bing	0
盟军机动建设车	meng'jun'ji'dong'jian'she'che	0
冥卫坦克	ming'wei'tan'ke	0
墨丘利卫星打击	mo'qiu'li'wei'xing'da'ji	0
墨丘利卫星上航站	mo'qiu'li'wei'xing'shang'hang'zhan	0
目标锁定	mu'biao'suo'ding	0
骑士重型坦克	qi'shi'zhong'xing'tan'ke	0
千里马运输机	qian'li'ma'yun'shu'ji	0
驱逐舰	qu'zhu'jian	0
闪电风暴	shan'dian'feng'bao	0
神盾巡航舰	shen'dun'xun'hang'jian	0
守卫大兵	shou'wei'da'bing	0
斯特瑞克步兵战车	si'te'rui'ke'bu'bing'zhan'che	0
梭鱼轰炸机	suo'yu'hong'zha'ji	0
谭雅	tan'ya	0
天光防空炮	tian'guang'fang'kong'pao	0
天火防空坦克	tian'huo'fang'kong'tan'ke	0
天气控制机	tian'qi'kong'zhi'ji	0
西风火炮	xi'feng'huo'pao	0
西风机器人	xi'feng'ji'qi'ren	0
西格弗里德	xi'ge'fu'li'de	0
玄武级战斗要塞	xuan'wu'ji'zhan'dou'yao'sai	0
雅典娜炮	ya'dian'na'pao	0
鹞式战机	yao'shi'zhan'ji	0
友川纪夫	you'chuan'ji'fu	0
闸门	zha'men	0
战车工厂	zhan'che'gong'chang	0
战列舰	zhan'lie'jian	0
战鹰直升机	zhan'ying'zhi'sheng'ji	0
镇暴部队	zhen'bao'bu'dui	0
侦察卫星	zhen'cha'wei'xing	0
执政官装甲步兵车	zhi'zheng'guan'zhuang'jia'bu'bing'che	0
