报名考啦学车	bao'ming'kao'la'xue'che	0
报名学车考啦	bao'ming'xue'che'kao'la	0
驾校考啦	jia'xiao'kao'la	0
驾照考啦	jia'zhao'kao'la	0
驾照考啦学车	jia'zhao'kao'la'xue'che	0
驾照学车考啦	jia'zhao'xue'che'kao'la	0
考啦	kao'la	0
考啦报名学车	kao'la'bao'ming'xue'che	0
考啦驾校	kao'la'jia'xiao	0
考啦驾照	kao'la'jia'zhao	0
考啦驾照学车	kao'la'jia'zhao'xue'che	0
考啦上海学车	kao'la'shang'hai'xue'che	0
考啦学车	kao'la'xue'che	0
考啦学车报名	kao'la'xue'che'bao'ming	0
考啦学车驾照	kao'la'xue'che'jia'zhao	0
考啦学车领驾照上海	kao'la'xue'che'ling'jia'zhao'shang'hai	0
考啦学车上海	kao'la'xue'che'shang'hai	0
考啦学车上海领驾照	kao'la'xue'che'shang'hai'ling'jia'zhao	0
上海考啦学车	shang'hai'kao'la'xue'che	0
上海考啦学车领驾照	shang'hai'kao'la'xue'che'ling'jia'zhao	0
上海领驾照考啦学车	shang'hai'ling'jia'zhao'kao'la'xue'che	0
上海学车考啦	shang'hai'xue'che'kao'la	0
学车	xue'che	0
学车报名考啦	xue'che'bao'ming'kao'la	0
学车驾照考啦	xue'che'jia'zhao'kao'la	0
学车考啦	xue'che'kao'la	0
学车考啦报名	xue'che'kao'la'bao'ming	0
学车考啦驾照	xue'che'kao'la'jia'zhao	0
学车考啦上海	xue'che'kao'la'shang'hai	0
学车上海考啦	xue'che'shang'hai'kao'la	0
