艾叶治崩漏安胎而医痢红	ai'ye'zhi'beng'lou'an'tai'er'yi'li'hong	0
安息香辟恶且止心腹之痛	an'xi'xiang'pi'e'qie'zhi'xin'fu'zhi'tong	0
巴豆利痰水能破寒积	ba'dou'li'tan'shui'neng'po'han'ji	0
巴戟天治阴疝白浊补肾尤滋	ba'ji'tian'zhi'yin'shan'bai'zhuo'bu'shen'you'zi	0
百部治肺热咳嗽可止	bai'bu'zhi'fei're'ke'sou'ke'zhi	0
白豆蔻治泠泻疗痈止痛于乳香	bai'dou'kou'zhi'ling'xie'liao'yong'zhi'tong'yu'ru'xiang	0
白茯苓补虚劳多在心脾之有眚	bai'fu'ling'bu'xu'lao'duo'zai'xin'pi'zhi'you'sheng	0
白附子去面风之游走	bai'fu'zi'qu'mian'feng'zhi'you'zou	0
百合恋肺痨之嗽萎	bai'he'lian'fei'lao'zhi'sou'wei	0
白花蛇治瘫痪疗风痒之癣疹	bai'hua'she'zhi'tan'huan'liao'feng'yang'zhi'xuan'zhen	0
白芍药补虚而生新血退热尤良	bai'shao'yao'bu'xu'er'sheng'xin'xue'tui're'you'liang	0
白石英医咳嗽吐脓之人	bai'shi'ying'yi'ke'sou'tu'nong'zhi'ren	0
白藓皮去风治筋弱而疗足顽痹	bai'xian'pi'qu'feng'zhi'jin'ruo'er'liao'zu'wan'bi	0
白芷止崩治肿疗痔瘘疮痈	bai'zhi'zhi'beng'zhi'zhong'liao'zhi'lou'chuang'yong	0
白术消痰壅温胃兼止吐泻	bai'zhu'xiao'tan'yong'wen'wei'jian'zhi'tu'xie	0
柏子仁养心神而有益	bai'zi'ren'yang'xin'shen'er'you'yi	0
半夏主于痰湿	ban'xia'zhu'yu'tan'shi	0
贝母清痰止咳嗽而利心肝	bei'mu'qing'tan'zhi'ke'sou'er'li'xin'gan	0
扁豆助脾破结之用	bian'dou'zhu'pi'po'jie'zhi'yong	0
鳖甲治痨疟兼破症葭	bie'jia'zhi'lao'nve'jian'po'zheng'jia	0
槟榔豁痰而逐水杀刺白虫	bing'lang'huo'tan'er'zhu'shui'sha'ci'bai'chong	0
补虚弱排疮脓莫若黄耆	bu'xu'ruo'pai'chuang'nong'mo'ruo'huang'qi	0
苍耳子透脑止涕威灵仙宣风通气	cang'er'zi'tou'nao'zhi'ti'wei'ling'xian'xuan'feng'tong'qi	0
苍术治目盲燥脾去湿宜用	cang'zhu'zhi'mu'mang'zao'pi'qu'shi'yi'yong	0
草果仁温脾胃而止呕吐	cao'guo'ren'wen'pi'wei'er'zhi'ou'tu	0
菖蒲开心气散泠更治耳聋	chang'pu'kai'xin'qi'san'ling'geng'zhi'er'long	0
常山理痰结而治温疟	chang'shan'li'tan'jie'er'zhi'wen'nve	0
车前子止泻利小便兮尤能明目	che'qian'zi'zhi'xie'li'xiao'bian'xi'you'neng'ming'mu	0
沉香下气补肾定霍乱之心痛	chen'xiang'xia'qi'bu'shen'ding'huo'luan'zhi'xin'tong	0
赤茯苓破结血独利水道以无毒	chi'fu'ling'po'jie'xue'du'li'shui'dao'yi'wu'du	0
赤芍药破血而疗腹痛烦热亦解	chi'shao'yao'po'xue'er'liao'fu'tong'fan're'yi'jie	0
赤石脂治精浊而止泄兼补崩中	chi'shi'zhi'zhi'jing'zhuo'er'zhi'xie'jian'bu'beng'zhong	0
赤小豆解热毒疮肿宜用	chi'xiao'dou'jie're'du'chuang'zhong'yi'yong	0
除结气破瘀血牡丹皮之用同	chu'jie'qi'po'yu'xue'mu'dan'pi'zhi'yong'tong	0
川椒达下干姜暖中	chuan'jiao'da'xia'gan'jiang'nuan'zhong	0
川乌破积有消痰治风痹之功	chuan'wu'po'ji'you'xiao'tan'zhi'feng'bi'zhi'gong	0
川芎怯风湿补血清头	chuan'xiong'qie'feng'shi'bu'xue'qing'tou	0
椿根白皮主泻血	chun'gen'bai'pi'zhu'xie'xue	0
大腹皮治水肿之泛溢	da'fu'pi'zhi'shui'zhong'zhi'fan'yi	0
大腹子去膨下气亦令胃和	da'fu'zi'qu'peng'xia'qi'yi'ling'wei'he	0
大小蓟除诸血之鲜	da'xiao'ji'chu'zhu'xue'zhi'xian	0
淡豆豉发伤寒之表	dan'dou'chi'fa'shang'han'zhi'biao	0
当归补虚而养血	dang'gui'bu'xu'er'yang'xue	0
地肤子利膀胱可洗皮肤之风	di'fu'zi'li'pang'guang'ke'xi'pi'fu'zhi'feng	0
地榆疗崩漏止血止痢	di'yu'liao'beng'lou'zhi'xue'zhi'li	0
丁香快脾胃而止吐逆	ding'xiang'kuai'pi'wei'er'zhi'tu'ni	0
冬瓜仁醒脾实为饮食之资	dong'gua'ren'xing'pi'shi'wei'yin'shi'zhi'zi	0
独活疗诸风不论新久	du'huo'liao'zhu'feng'bu'lun'xin'jiu	0
杜仲益肾而添精去腰膝重	du'zhong'yi'shen'er'tian'jing'qu'yao'xi'zhong	0
防己宜消肿去风湿之施	fang'ji'yi'xiao'zhong'qu'feng'shi'zhi'shi	0
茯神宁心益智除惊悸之疴	fu'shen'ning'xin'yi'zhi'chu'jing'ji'zhi'ke	0
抚芎走经络之痛	fu'xiong'zou'jing'luo'zhi'tong	0
附子疗虚寒反胃壮元阳之方	fu'zi'liao'xu'han'fan'wei'zhuang'yuan'yang'zhi'fang	0
甘草和诸药而解百毒盖以气平	gan'cao'he'zhu'yao'er'jie'bai'du'gai'yi'qi'ping	0
甘松理风气而痛止	gan'song'li'feng'qi'er'tong'zhi	0
蛤蚧治痨嗽牛蒡子疏风壅之痰	ge'jie'zhi'lao'sou'niu'bang'zi'shu'feng'yong'zhi'tan	0
谷芽养脾阿魏除邪气而破积	gu'ya'yang'pi'a'wei'chu'xie'qi'er'po'ji	0
瓜蒌根疗黄疸毒痈消渴解痰之忧	gua'lou'gen'liao'huang'dan'du'yong'xiao'ke'jie'tan'zhi'you	0
瓜瘿子下气润肺喘兮又且宽中	gua'ying'zi'xia'qi'run'fei'chuan'xi'you'qie'kuan'zhong	0
龟甲坚筋骨更疗崩疾	gui'jia'jian'jin'gu'geng'liao'beng'ji	0
蒿本除风主妇人阴痛之用	hao'ben'chu'feng'zhu'fu'ren'yin'tong'zhi'yong	0
何首乌志疮疥之资	he'shou'wu'zhi'chuang'jie'zhi'zi	0
诃子生精止渴兼疗滑泄之痾	he'zi'sheng'jing'zhi'ke'jian'liao'hua'xie'zhi'ke	0
红豆蔻止吐酸消血杀虫于干漆	hong'dou'kou'zhi'tu'suan'xiao'xue'sha'chong'yu'gan'qi	0
红蓝花通经治产后恶血之余	hong'lan'hua'tong'jing'zhi'chan'hou'e'xue'zhi'yu	0
厚朴温胃而去呕胀消痰亦验	hou'pu'wen'wei'er'qu'ou'zhang'xiao'tan'yi'yan	0
虎骨壮筋骨寒湿毒风之并怯	hu'gu'zhuang'jin'gu'han'shi'du'feng'zhi'bing'qie	0
胡椒主去痰而除泠	hu'jiao'zhu'qu'tan'er'chu'ling	0
胡芦巴治虚泠之疝气	hu'lu'ba'zhi'xu'ling'zhi'shan'qi	0
琥珀安神而散血	hu'po'an'shen'er'san'xue	0
花蕊石治金疮血行则却	hua'rui'shi'zhi'jin'chuang'xue'hang'ze'que	0
槐花治肠风亦医痔痢	huai'hua'zhi'chang'feng'yi'yi'zhi'li	0
黄芩治诸热兼主五淋	huang'qin'zhi'zhu're'jian'zhu'wu'lin	0
茴香治疝气肾疼之用	hui'xiang'zhi'shan'qi'shen'teng'zhi'yong	0
藿香叶辟恶气而定霍乱	huo'xiang'ye'pi'e'qi'er'ding'huo'luan	0
蒺藜疗风疮而目明	ji'li'liao'feng'chuang'er'mu'ming	0
减风湿之痛则茵芋叶	jian'feng'shi'zhi'tong'ze'yin'yu'ye	0
僵蚕治诸风之喉闭	jiang'can'zhi'zhu'feng'zhi'hou'bi	0
姜黄能下气破恶血之积	jiang'huang'neng'xia'qi'po'e'xue'zhi'ji	0
桔梗开肺利胸膈而治咽喉	jie'geng'kai'fei'li'xiong'ge'er'zhi'yan'hou	0
金樱子兮涩遗精	jin'ying'zi'xi'se'yi'jing	0
荆芥穗清头目便血疏风散疮之用	jing'jie'sui'qing'tou'mu'bian'xie'shu'feng'san'chuang'zhi'yong	0
韭子壮阳而医白浊	jiu'zi'zhuang'yang'er'yi'bai'zhuo	0
橘核仁治腰痛疝气之真	ju'he'ren'zhi'yao'tong'shan'qi'zhi'zhen	0
橘皮开胃去痰导壅滞之逆气	ju'pi'kai'wei'qu'tan'dao'yong'zhi'zhi'ni'qi	0
决明和肝气治眼之剂	jue'ming'he'gan'qi'zhi'yan'zhi'ji	0
款冬花润肺去痰嗽以定喘	kuan'dong'hua'run'fei'qu'tan'sou'yi'ding'chuan	0
宽中下气枳壳缓而枳实速也	kuan'zhong'xia'qi'zhi'ke'huan'er'zhi'shi'su'ye	0
昆布破疝气散瘿散瘤	kun'bu'po'shan'qi'san'ying'san'liu	0
连翘排疮脓与肿毒	lian'qiao'pai'chuang'nong'yu'zhong'du	0
莲肉有清心醒脾之用	lian'rou'you'qing'xin'xing'pi'zhi'yong	0
良姜止心气痛之攻冲	liang'jiang'zhi'xin'qi'tong'zhi'gong'chong	0
疗肌解表干葛先而柴胡次之	liao'ji'jie'biao'gan'ge'xian'er'chai'hu'ci'zhi	0
疗伤寒解虚烦淡竹叶之功倍	liao'shang'han'jie'xu'fan'dan'zhu'ye'zhi'gong'bei	0
疗心痛破积聚用蓬莪术	liao'xin'tong'po'ji'ju'yong'peng'e'zhu	0
疗折伤之症责骨碎补	liao'zhe'shang'zhi'zheng'ze'gu'sui'bu	0
灵砂定心脏之怔忡	ling'sha'ding'xin'zang'zhi'zheng'chong	0
刘寄奴散血疗烫火金疮之苦	liu'ji'nu'san'xue'liao'tang'huo'jin'chuang'zhi'ku	0
龙骨止汗住泄更治血崩	long'gu'zhi'han'zhu'xie'geng'zhi'xue'beng	0
鹿角胶住血崩能补虚羸劳绝	lu'jiao'jiao'zhu'xue'beng'neng'bu'xu'lei'lao'jue	0
鹿角秘精髓而腰脊之痛除	lu'jiao'mi'jing'sui'er'yao'ji'zhi'tong'chu	0
鹿茸生精血腰脊崩漏之均补	lu'rong'sheng'jing'xue'yao'ji'beng'lou'zhi'jun'bu	0
萝卜去膨胀下气治面尤堪	luo'bo'qu'peng'zhang'xia'qi'zhi'mian'you'kan	0
麻黄表汗以疗咳逆	ma'huang'biao'han'yi'liao'ke'ni	0
麻仁润肺利六腑之燥坚	ma'ren'run'fei'li'liu'fu'zhi'zao'jian	0
麦门冬清心解烦渴而除肺热	mai'men'dong'qing'xin'jie'fan'ke'er'chu'fei're	0
麦芽有助脾化食之功	mai'ya'you'zhu'pi'hua'shi'zhi'gong	0
茅根止血与吐衄石苇通淋与小肠	mao'gen'zhi'xue'yu'tu'nv'shi'wei'tong'lin'yu'xiao'chang	0
没食主泄泻而神效	mei'shi'zhu'xie'xie'er'shen'xiao	0
没药乃治疮散血之科	mei'yao'nai'zhi'chuang'san'xue'zhi'ke	0
糜茸壮阳以助肾	mi'rong'zhuang'yang'yi'zhu'shen	0
木通猪苓尤为利水之多	mu'tong'zhu'ling'you'wei'li'shui'zhi'duo	0
木香理乎气滞	mu'xiang'li'hu'qi'zhi	0
木贼草去目翳崩漏亦医	mu'zei'cao'qu'mu'yi'beng'lou'yi'yi	0
南星醒脾去惊风痰吐之忧	nan'xing'xing'pi'qu'jing'feng'tan'tu'zhi'you	0
牛膝强足补精兼疗腰痛	niu'xi'qiang'zu'bu'jing'jian'liao'yao'tong	0
枇杷叶下逆气哕呕可医	pi'pa'ye'xia'ni'qi'hui'ou'ke'yi	0
破故纸温肾补精髓与劳伤	po'gu'zhi'wen'shen'bu'jing'sui'yu'lao'shang	0
朴硝通大肠破血而止痰僻	po'xiao'tong'da'chang'po'xue'er'zhi'tan'pi	0
蒲黄止崩治衄消痨调经	pu'huang'zhi'beng'zhi'nv'xiao'lao'tiao'jing	0
麒麟竭止血出疗金疮之伤折	qi'lin'jie'zhi'xue'chu'liao'jin'chuang'zhi'shang'zhe	0
前胡除内外滑石利六腑之涩结	qian'hu'chu'nei'wai'hua'shi'li'liu'fu'zhi'se'jie	0
芡实益精治白浊兼补真元	qian'shi'yi'jing'zhi'bai'zhuo'jian'bu'zhen'yuan	0
羌活明目驱风除湿毒肿痛	qiang'huo'ming'mu'qu'feng'chu'shi'du'zhong'tong	0
强腰脚壮筋骨无如狗脊	qiang'yao'jiao'zhuang'jin'gu'wu'ru'gou'ji	0
秦艽攻风逐水又除肢节之痛	qin'jiao'gong'feng'zhu'shui'you'chu'zhi'jie'zhi'tong	0
秦椒主攻痛而去风	qin'jiao'zhu'gong'tong'er'qu'feng	0
青皮快膈除膨胀且利脾胃	qing'pi'kuai'ge'chu'peng'zhang'qie'li'pi'wei	0
青盐治腹痛且滋肾水	qing'yan'zhi'fu'tong'qie'zi'shen'shui	0
全蝎主风瘫酸枣仁去怔忡之病	quan'xie'zhu'feng'tan'suan'zao'ren'qu'zheng'chong'zhi'bing	0
人参润肺宁心开脾助胃	ren'shen'run'fei'ning'xin'kai'pi'zhu'wei	0
肉苁蓉填精益肾	rou'cong'rong'tian'jing'yi'shen	0
肉豆蔻温中止霍乱而助脾	rou'dou'kou'wen'zhong'zhi'huo'luan'er'zhu'pi	0
肉桂行血而疗心痛止汗如神	rou'gui'xing'xue'er'liao'xin'tong'zhi'han'ru'shen	0
三棱破积除血块气滞之症	san'leng'po'ji'chu'xie'kuai'qi'zhi'zhi'zheng	0
散肾泠助脾胃须毕澄茄	san'shen'ling'zhu'pi'wei'xu'bi'cheng'qie	0
桑根白皮主喘息	sang'gen'bai'pi'zhu'chuan'xi	0
桑寄生益血安胎且止腰痛	sang'ji'sheng'yi'xue'an'tai'qie'zhi'yao'tong	0
桑螵蛸疗遗精之泄	sang'piao'xiao'liao'yi'jing'zhi'xie	0
山豆根解热毒能止咽喉之痛	shan'dou'gen'jie're'du'neng'zhi'yan'hou'zhi'tong	0
山药而腰湿能医阿胶而痢嗽皆止	shan'yao'er'yao'shi'neng'yi'e'jiao'er'li'sou'jie'zhi	0
山茱萸治头晕遗精之药	shan'zhu'yu'zhi'tou'yun'yi'jing'zhi'yao	0
商陆治肿覆盆益精	shang'lu'zhi'zhong'fu'pen'yi'jing	0
麝香开窍中发汗之需	she'xiang'kai'qiao'zhong'fa'han'zhi'xu	0
神曲健脾胃而进饮食	shen'qu'jian'pi'wei'er'jin'yin'shi	0
生卷柏破症葭而血通	sheng'juan'bai'po'zheng'jia'er'xue'tong	0
升麻清风热肿毒发散疮痍	sheng'ma'qing'feng're'zhong'du'fa'san'chuang'yi	0
石膏治头痛解肌而消烦渴	shi'gao'zhi'tou'tong'jie'ji'er'xiao'fan'ke	0
石斛平胃气而补肾虚更医脚弱	shi'hu'ping'wei'qi'er'bu'shen'xu'geng'yi'jiao'ruo	0
石硫黄暖胃驱虫	shi'liu'huang'nuan'wei'qu'chong	0
石南叶利筋骨与毛皮	shi'nan'ye'li'jin'gu'yu'mao'pi	0
是以黄柏疮用兜铃嗽医	shi'yi'huang'bai'chuang'yong'dou'ling'sou'yi	0
熟地黄补血生地黄宜血更医眼疮	shu'di'huang'bu'xue'sheng'di'huang'yi'xue'geng'yi'yan'chuang	0
缩砂止吐泻安胎化酒食之剂	suo'sha'zhi'tu'xie'an'tai'hua'jiu'shi'zhi'ji	0
檀香定霍乱而心气之痛愈	tan'xiang'ding'huo'luan'er'xin'qi'zhi'tong'yu	0
桃仁破瘀血兼治腰痛	tao'ren'po'yu'xue'jian'zhi'yao'tong	0
天麻主头眩祛风之药	tian'ma'zhu'tou'xuan'qu'feng'zhi'yao	0
天门冬止嗽补血涸而润心肝	tian'men'dong'zhi'sou'bu'xue'he'er'run'xin'gan	0
天雄散寒为去湿助精阳之药	tian'xiong'san'han'wei'qu'shi'zhu'jing'yang'zhi'yao	0
葶苈泻肺喘而通水气	ting'li'xie'fei'chuan'er'tong'shui'qi	0
通秘结导瘀血必资大黄	tong'mi'jie'dao'yu'xue'bi'zi'da'huang	0
菟丝子补肾马兰花治疝而有益	tu'si'zi'bu'shen'ma'lan'hua'zhi'shan'er'you'yi	0
腽肭脐疗痨瘵更壮元阳	wa'na'qi'liao'lao'zhai'geng'zhuang'yuan'yang	0
五加皮坚筋骨以立行	wu'jia'pi'jian'jin'gu'yi'li'xing	0
五灵脂治崩漏理血气之刺痛	wu'ling'zhi'zhi'beng'lou'li'xue'qi'zhi'ci'tong	0
乌梅主便血疟疾之用	wu'mei'zhu'bian'xie'nve'ji'zhi'yong	0
乌梢蛇疗不仁去疮疡之风热	wu'shao'she'liao'bu'ren'qu'chuang'yang'zhi'feng're	0
五味子止嗽痰且滋肾水	wu'wei'zi'zhi'sou'tan'qie'zi'shen'shui	0
乌贼骨止带下且除崩漏目翳	wu'zei'gu'zhi'dai'xia'qie'chu'beng'lou'mu'yi	0
吴茱萸疗心腹之泠气	wu'zhu'yu'liao'xin'fu'zhi'ling'qi	0
犀角解乎心热羚羊清乎肺肝	xi'jiao'jie'hu'xin're'ling'yang'qing'hu'fei'gan	0
细辛去头风止嗽而疗齿痛	xi'xin'qu'tou'feng'zhi'sou'er'liao'chi'tong	0
仙茅益肾扶元气虚弱之衰	xian'mao'yi'shen'fu'yuan'qi'xu'ruo'zhi'shuai	0
小草远志俱有宁心之妙	xiao'cao'yuan'zhi'ju'you'ning'xin'zhi'miao	0
小麦有止汗养心之力	xiao'mai'you'zhi'han'yang'xin'zhi'li	0
消肿益血散寒于紫苏	xiao'zhong'yi'xue'san'han'yu'zi'su	0
杏仁润肺燥止嗽之剂	xing'ren'run'fei'zao'zhi'sou'zhi'ji	0
续断治崩漏益筋强脚	xu'duan'zhi'beng'lou'yi'jin'qiang'jiao	0
旋覆花明目治头风而消痰嗽壅	xuan'fu'hua'ming'mu'zhi'tou'feng'er'xiao'tan'sou'yong	0
宣木瓜入肝疗脚气并水肿	xuan'mu'gua'ru'gan'liao'jiao'qi'bing'shui'zhong	0
玄参治结热毒痈清利咽膈	xuan'shen'zhi'jie're'du'yong'qing'li'yan'ge	0
鸭头血医水肿之盛	ya'tou'xue'yi'shui'zhong'zhi'sheng	0
阳起石暖子宫以壮阳更疗阴痿	yang'qi'shi'nuan'zi'gong'yi'zhuang'yang'geng'liao'yin'wei	0
以磠砂而去积用龙齿以安魂	yi'lu'sha'er'qu'ji'yong'long'chi'yi'an'hun	0
薏苡里脚气藕节消瘀血而止吐衄	yi'yi'li'jiao'qi'ou'jie'xiao'yu'xue'er'zhi'tu'nv	0
益智安神治小便之频数	yi'zhi'an'shen'zhi'xiao'bian'zhi'pin'shuo	0
茵陈主黄疸瞿麦治热淋之有血	yin'chen'zhu'huang'dan'qu'mai'zhi're'lin'zhi'you'xue	0
用发散以生姜	yong'fa'san'yi'sheng'jiang	0
又闻治虚烦除秽呕须用竹茹	you'wen'zhi'xu'fan'chu'hui'ou'xu'yong'zhu'ru	0
郁李仁润肠宣血去浮肿之疾	yu'li'ren'run'chang'xuan'xue'qu'fu'zhong'zhi'ji	0
欲温中以荜拨	yu'wen'zhong'yi'bi'bo	0
元胡索理气痛血凝调经有助	yuan'hu'suo'li'qi'tong'xue'ning'tiao'jing'you'zhu	0
皂角治风痰而响应	zao'jiao'zhi'feng'tan'er'xiang'ying	0
栀子凉心肾鼻衄最宜	zhi'zi'liang'xin'shen'bi'nv'zui'yi	0
锺乳粉补肺气兼疗肺虚	zhong'ru'fen'bu'fei'qi'jian'liao'fei'xu	0
竹沥治中风声音之失	zhu'li'zhi'zhong'feng'sheng'yin'zhi'shi	0
朱砂镇心而有灵	zhu'sha'zhen'xin'er'you'ling	0
紫河车补血大枣和药性以开脾	zi'he'che'bu'xue'da'zao'he'yao'xing'yi'kai'pi	0
紫石英疗惊悸崩中之疾	zi'shi'ying'liao'jing'ji'beng'zhong'zhi'ji	0
紫苏子兮下气涎	zi'su'zi'xi'xia'qi'xian	0
紫苑治嗽防风祛风	zi'yuan'zhi'sou'fang'feng'qu'feng	0
