阿狄森氏病	a'di'sen'shi'bing	0
白喉	bai'hou	0
变应性关节炎	bian'ying'xing'guan'jie'yan	0
病毒性脑膜炎	bing'du'xing'nao'mo'yan	0
病毒性脑炎	bing'du'xing'nao'yan	0
丙型肝炎后肝硬化失代偿期	bing'xing'gan'yan'hou'gan'ying'hua'shi'dai'chang'qi	0
陈旧性心肌梗死	chen'jiu'xing'xin'ji'geng'si	0
传染性单核细胞增多症	chuan'ran'xing'dan'he'xi'bao'zeng'duo'zheng	0
垂体瘤	chui'ti'liu	0
大便失禁	da'bian'shi'jin	0
代谢性酸中毒	dai'xie'xing'suan'zhong'du	0
蛋白尿	dan'bai'niao	0
胆囊结石伴胆囊炎	dan'nang'jie'shi'ban'dan'nang'yan	0
胆囊切除术后	dan'nang'qie'chu'shu'hou	0
氮质血症	dan'zhi'xue'zheng	0
低钾性麻痹	di'jia'xing'ma'bi	0
动脉瘤	dong'mai'liu	0
窦性心律失常	dou'xing'xin'lv'shi'chang	0
放射性脊髓病	fang'she'xing'ji'sui'bing	0
肺动脉高压	fei'dong'mai'gao'ya	0
腓骨骨折	fei'gu'gu'zhe	0
肺含铁血黄素沉着症	fei'han'tie'xue'huang'su'chen'zhuo'zheng	0
肺隐球菌病	fei'yin'qiu'jun'bing	0
复发性甲状腺癌	fu'fa'xing'jia'zhuang'xian'ai	0
浮肿	fu'zhong	0
肝癌术后状态	gan'ai'shu'hou'zhuang'tai	0
感染性休克	gan'ran'xing'xiu'ke	0
高血压	gao'xue'ya	0
高血压性肾病	gao'xue'ya'xing'shen'bing	0
股骨头无菌性坏死	gu'gu'tou'wu'jun'xing'huai'si	0
踝骨关节病	huai'gu'guan'jie'bing	0
蛔虫病	hui'chong'bing	0
继发性血小板增多症	ji'fa'xing'xue'xiao'ban'zeng'duo'zheng	0
急性出血坏死性胰腺炎	ji'xing'chu'xie'huai'si'xing'yi'xian'yan	0
急性脑血管病	ji'xing'nao'xue'guan'bing	0
急性气管炎	ji'xing'qi'guan'yan	0
急性腮腺炎	ji'xing'sai'xian'yan	0
急性肾小球肾炎	ji'xing'shen'xiao'qiu'shen'yan	0
脊柱骨折伴截瘫	ji'zhu'gu'zhe'ban'jie'tan	0
焦虑性抑郁症	jiao'lv'xing'yi'yu'zheng	0
角膜白斑	jiao'mo'bai'ban	0
胫骨成骨肉瘤	jing'gu'cheng'gu'rou'liu	0
颈椎骨质增生颈椎骨关节炎	jing'zhui'gu'zhi'zeng'sheng'jing'zhui'gu'guan'jie'yan	0
颈椎退行性变	jing'zhui'tui'xing'xing'bian	0
菌血症	jun'xue'zheng	0
口腔炎	kou'qiang'yan	0
髋关节脱位	kuan'guan'jie'tuo'wei	0
溃疡性结肠炎	kui'yang'xing'jie'chang'yan	0
肋骨恶性肿瘤	lei'gu'e'xing'zhong'liu	0
流行性感冒	liu'xing'xing'gan'mao	0
麻痹性肠梗阻	ma'bi'xing'chang'geng'zu	0
慢性喉咽炎	man'xing'hou'yan'yan	0
慢性结肠炎	man'xing'jie'chang'yan	0
慢性迁延性丙型病毒性肝炎	man'xing'qian'yan'xing'bing'xing'bing'du'xing'gan'yan	0
慢性肾功能衰竭	man'xing'shen'gong'neng'shuai'jie	0
面部蜂窝织炎	mian'bu'feng'wo'zhi'yan	0
木僵嗜睡和昏迷	mu'jiang'shi'shui'he'hun'mi	0
脑卒中	nao'cu'zhong	0
脑膜炎	nao'mo'yan	0
脑栓塞	nao'shuan'sai	0
脑炎后遗症	nao'yan'hou'yi'zheng	0
内痔	nei'zhi	0
尿道炎	niao'dao'yan	0
帕金森病	pa'jin'sen'bing	0
脾大	pi'da	0
桡骨颈骨折	rao'gu'jing'gu'zhe	0
桡骨下端骨折	rao'gu'xia'duan'gu'zhe	0
桡神经损伤	rao'shen'jing'sun'shang	0
软组织风湿	ruan'zu'zhi'feng'shi	0
弱视	ruo'shi	0
上肢静脉炎	shang'zhi'jing'mai'yan	0
舌根癌	she'gen'ai	0
肾功能不全	shen'gong'neng'bu'quan	0
神经衰弱	shen'jing'shuai'ruo	0
十二指肠憩室	shi'er'zhi'chang'qi'shi	0
视网膜静脉闭塞	shi'wang'mo'jing'mai'bi'se	0
食物中毒	shi'wu'zhong'du	0
糖尿病并泌尿系感染	tang'niao'bing'bing'mi'niao'xi'gan'ran	0
外阴白斑	wai'yin'bai'ban	0
外阴炎	wai'yin'yan	0
胃癌术后化疗	wei'ai'shu'hou'hua'liao	0
胃肠神经官能症	wei'chang'shen'jing'guan'neng'zheng	0
胃窦炎	wei'dou'yan	0
无月经	wu'yue'jing	0
消化性溃疡	xiao'hua'xing'kui'yang	0
心悸	xin'ji	0
心绞痛	xin'jiao'tong	0
心源性休克	xin'yuan'xing'xiu'ke	0
眩晕	xuan'yun	0
血管神经性头痛	xue'guan'shen'jing'xing'tou'tong	0
血管性偏头痛	xue'guan'xing'pian'tou'tong	0
血吸虫性肝炎	xue'xi'chong'xing'gan'yan	0
亚急性肝炎	ya'ji'xing'gan'yan	0
眼外直肌麻痹	yan'wai'zhi'ji'ma'bi	0
药物性肝损害	yao'wu'xing'gan'sun'hai	0
腰椎病变	yao'zhui'bing'bian	0
腰椎间盘脱出	yao'zhui'jian'pan'tuo'chu	0
腰椎峡部断裂并滑脱	yao'zhui'xia'bu'duan'lie'bing'hua'tuo	0
癔病痉挛发作	yi'bing'jing'luan'fa'zuo	0
遗传性共济失调	yi'chuan'xing'gong'ji'shi'tiao	0
乙肝后肝硬化	yi'gan'hou'gan'ying'hua	0
胰腺炎	yi'xian'yan	0
阴道恶性黑色素瘤	yin'dao'e'xing'hei'se'su'liu	0
阴茎勃起功能障碍	yin'jing'bo'qi'gong'neng'zhang'ai	0
营养不良	ying'yang'bu'liang	0
幽门梗阻	you'men'geng'zu	0
幽门狭窄	you'men'xia'zhai	0
晕厥	yun'jue	0
阵发性心房纤颤	zhen'fa'xing'xin'fang'xian'chan	0
症状性癫痫	zheng'zhuang'xing'dian'xian	0
直肠前切除术后状态	zhi'chang'qian'qie'chu'shu'hou'zhuang'tai	0
直肠前突	zhi'chang'qian'tu	0
脂肪坏死	zhi'fang'huai'si	0
中毒性痢疾	zhong'du'xing'li'ji	0
周围动脉栓塞	zhou'wei'dong'mai'shuan'sai	0
子宫颈糜烂	zi'gong'jing'mi'lan	0
阻塞性肺气肿	zu'se'xing'fei'qi'zhong	0
