阿莫西林胶囊哈药集团制药总厂	a'mo'xi'lin'jiao'nang'ha'yao'ji'tuan'zhi'yao'zong'chang	0
氨茶碱片山西云鹏制药有限公司	an'cha'jian'pian'shan'xi'yun'peng'zhi'yao'you'xian'gong'si	0
保和丸山西华康药	bao'he'wan'shan'xi'hua'kang'yao	0
鼻炎康片佛山德众药业有限公司	bi'yan'kang'pian'fo'shan'de'zhong'yao'ye'you'xian'gong'si	0
鼻渊丸武汉太福制药有限公司	bi'yuan'wan'wu'han'tai'fu'zhi'yao'you'xian'gong'si	0
布洛芬片甘肃兰药药业有限公司	bu'luo'fen'pian'gan'su'lan'yao'yao'ye'you'xian'gong'si	0
补脾益肠丸广州陈李济药厂	bu'pi'yi'chang'wan'guang'zhou'chen'li'ji'yao'chang	0
炒白芍安徽	chao'bai'shao'an'hui	0
炒白术安徽	chao'bai'zhu'an'hui	0
炒薏米仁贵州	chao'yi'mi'ren'gui'zhou	0
川芎四川	chuan'xiong'si'chuan	0
当归甘肃	dang'gui'gan'su	0
酚氨咖敏片扑感敏国药控股星	fen'an'ka'min'pian'pu'gan'min'guo'yao'kong'gu'xing	0
复方丹参滴丸天士力制药	fu'fang'dan'shen'di'wan'tian'shi'li'zhi'yao	0
妇炎康片广东德鑫制药有限公司	fu'yan'kang'pian'guang'dong'de'xin'zhi'yao'you'xian'gong'si	0
甘草甘肃	gan'cao'gan'su	0
感冒灵颗粒华润三九医	gan'mao'ling'ke'li'hua'run'san'jiu'yi	0
感冒疏风丸昆明中药厂有限公司	gan'mao'shu'feng'wan'kun'ming'zhong'yao'chang'you'xian'gong'si	0
肛泰栓烟台荣昌制药有限公司	gang'tai'shuan'yan'tai'rong'chang'zhi'yao'you'xian'gong'si	0
骨刺平片广东罗浮山白鹤制药厂	gu'ci'ping'pian'guang'dong'luo'fu'shan'bai'he'zhi'yao'chang	0
骨肽片安徽宏业药业有限公司	gu'tai'pian'an'hui'hong'ye'yao'ye'you'xian'gong'si	0
关节止痛膏河南羚锐制	guan'jie'zhi'tong'gao'he'nan'ling'rui'zhi	0
胱氨酸片山西云鹏制药有限公司	guang'an'suan'pian'shan'xi'yun'peng'zhi'yao'you'xian'gong'si	0
猴耳环消炎片广州市花城制药厂	hou'er'huan'xiao'yan'pian'guang'zhou'shi'hua'cheng'zhi'yao'chang	0
猴头菌片山西云鹏制药有限公司	hou'tou'jun'pian'shan'xi'yun'peng'zhi'yao'you'xian'gong'si	0
藿胆丸广州市花城制药厂	huo'dan'wan'guang'zhou'shi'hua'cheng'zhi'yao'chang	0
藿胆丸武汉太福制药有限公司	huo'dan'wan'wu'han'tai'fu'zhi'yao'you'xian'gong'si	0
金鸡胶囊广西灵峰药业有限公司	jin'ji'jiao'nang'guang'xi'ling'feng'yao'ye'you'xian'gong'si	0
橘红丸甘肃河西制	ju'hong'wan'gan'su'he'xi'zhi	0
卡马西平片上海复旦	ka'ma'xi'ping'pian'shang'hai'fu'dan	0
抗病毒口服液广州市花城制药厂	kang'bing'du'kou'fu'ye'guang'zhou'shi'hua'cheng'zhi'yao'chang	0
连翘山西	lian'qiao'shan'xi	0
六神丸雷允上药业有限公司	liu'shen'wan'lei'yun'shang'yao'ye'you'xian'gong'si	0
罗红霉素片丽珠集团丽	luo'hong'mei'su'pian'li'zhu'ji'tuan'li	0
马来酸依那普利片扬子江药业	ma'lai'suan'yi'na'pu'li'pian'yang'zi'jiang'yao'ye	0
摩罗丹邯郸制药股份有限公司	mo'luo'dan'han'dan'zhi'yao'gu'fen'you'xian'gong'si	0
木瓜丸武汉太福制药有限公司	mu'gua'wan'wu'han'tai'fu'zhi'yao'you'xian'gong'si	0
清肺化痰丸昆明中药厂有限公司	qing'fei'hua'tan'wan'kun'ming'zhong'yao'chang'you'xian'gong'si	0
山萸肉河南	shan'yu'rou'he'nan	0
伤湿止痛膏河南羚锐制	shang'shi'zhi'tong'gao'he'nan'ling'rui'zhi	0
心宝丸广东心宝制药有限公司	xin'bao'wan'guang'dong'xin'bao'zhi'yao'you'xian'gong'si	0
熊去氧胆酸片成都市湔江制药厂	xiong'qu'yang'dan'suan'pian'cheng'du'shi'jian'jiang'zhi'yao'chang	0
盐酸西替利嗪片丽珠集团丽	yan'suan'xi'ti'li'qin'pian'li'zhu'ji'tuan'li	0
盐酸乙胺丁醇片成都锦华药	yan'suan'yi'an'ding'chun'pian'cheng'du'jin'hua'yao	0
腰肾膏佛山德众药业有限公司	yao'shen'gao'fo'shan'de'zhong'yao'ye'you'xian'gong'si	0
野木瓜片广东和平药业有限公司	ye'mu'gua'pian'guang'dong'he'ping'yao'ye'you'xian'gong'si	0
益肺胶囊山西黄河中药有限公司	yi'fei'jiao'nang'shan'xi'huang'he'zhong'yao'you'xian'gong'si	0
乙肝宁颗粒九芝堂股份有限公司	yi'gan'ning'ke'li'jiu'zhi'tang'gu'fen'you'xian'gong'si	0
薏米仁贵州	yi'mi'ren'gui'zhou	0
益血生胶囊吉林金复康	yi'xue'sheng'jiao'nang'ji'lin'jin'fu'kang	0
银杏叶片江苏晨牌药业有限公司	yin'xing'ye'pian'jiang'su'chen'pai'yao'ye'you'xian'gong'si	0
云南白药痔疮膏云南白药集	yun'nan'bai'yao'zhi'chuang'gao'yun'nan'bai'yao'ji	0
炙黄芪甘肃	zhi'huang'qi'gan'su	0
重感灵片广州市花城制药厂	zhong'gan'ling'pian'guang'zhou'shi'hua'cheng'zhi'yao'chang	0
