阿密特床盖四件套	a'mi'te'chuang'gai'si'jian'tao	0
爱的殿堂八件套	ai'de'dian'tang'ba'jian'tao	0
爱的嫁衣八件套粉	ai'de'jia'yi'ba'jian'tao'fen	0
爱的见证四件套	ai'de'jian'zheng'si'jian'tao	0
爱的乐园六件套粉	ai'de'le'yuan'liu'jian'tao'fen	0
爱的乐园六件套砖红	ai'de'le'yuan'liu'jian'tao'zhuan'hong	0
爱的乐园四件套粉红	ai'de'le'yuan'si'jian'tao'fen'hong	0
爱的乐园四件套砖红	ai'de'le'yuan'si'jian'tao'zhuan'hong	0
爱的牵线大红床盖六件套	ai'de'qian'xian'da'hong'chuang'gai'liu'jian'tao	0
爱的寓意四件套	ai'de'yu'yi'si'jian'tao	0
爱尔兰之恋床裙四件套直营	ai'er'lan'zhi'lian'chuang'qun'si'jian'tao'zhi'ying	0
艾菲床垫	ai'fei'chuang'dian	0
爱河之恋四件套	ai'he'zhi'lian'si'jian'tao	0
爱丽丝床罩四件套	ai'li'si'chuang'zhao'si'jian'tao	0
爱恋情深七件套米白	ai'lian'qing'shen'qi'jian'tao'mi'bai	0
爱情玫瑰床盖七件套	ai'qing'mei'gui'chuang'gai'qi'jian'tao	0
爱尚她床笠四件套	ai'shang'ta'chuang'li'si'jian'tao	0
爱时尚床笠四件套	ai'shi'shang'chuang'li'si'jian'tao	0
爱未来四件套	ai'wei'lai'si'jian'tao	0
安妮的童话床单四件套	an'ni'de'tong'hua'chuang'dan'si'jian'tao	0
安琪的婚礼八件套粉	an'qi'de'hun'li'ba'jian'tao'fen	0
安琪儿大红床盖八件套	an'qi'er'da'hong'chuang'gai'ba'jian'tao	0
安琪儿粉床盖六件套	an'qi'er'fen'chuang'gai'liu'jian'tao	0
暗香七件套驼	an'xiang'qi'jian'tao'tuo	0
奥维莉驼床盖四件套	ao'wei'li'tuo'chuang'gai'si'jian'tao	0
澳洲纯羊毛被	ao'zhou'chun'yang'mao'bei	0
澳洲精品羊毛被	ao'zhou'jing'pin'yang'mao'bei	0
芭比伦花园紫床盖八件套	ba'bi'lun'hua'yuan'zi'chuang'gai'ba'jian'tao	0
八件套	ba'jian'tao	0
巴黎春天四件套	ba'li'chun'tian'si'jian'tao	0
巴黎恋人六件套	ba'li'lian'ren'liu'jian'tao	0
巴黎之恋床单四件套	ba'li'zhi'lian'chuang'dan'si'jian'tao	0
巴黎之梦四件套	ba'li'zhi'meng'si'jian'tao	0
百变式全伸缩挂壁式蚊帐	bai'bian'shi'quan'shen'suo'gua'bi'shi'wen'zhang	0
百变竹丝坐垫	bai'bian'zhu'si'zuo'dian	0
白布护垫	bai'bu'hu'dian	0
百合梦八件套砖红	bai'he'meng'ba'jian'tao'zhuan'hong	0
百花争艳六件套	bai'hua'zheng'yan'liu'jian'tao	0
百花争艳四件套	bai'hua'zheng'yan'si'jian'tao	0
百鸟归巢六件套	bai'niao'gui'chao'liu'jian'tao	0
百鸟归巢四件套	bai'niao'gui'chao'si'jian'tao	0
白雪公主八件套	bai'xue'gong'zhu'ba'jian'tao	0
百子送福八件套大红	bai'zi'song'fu'ba'jian'tao'da'hong	0
宝贝大豆纤维夏被	bao'bei'da'dou'xian'wei'xia'bei	0
宝贝棉花夏被	bao'bei'mian'hua'xia'bei	0
保健型脱卸式床垫	bao'jian'xing'tuo'xie'shi'chuang'dian	0
豹纹腰枕	bao'wen'yao'zhen	0
保鲜盒三件套	bao'xian'he'san'jian'tao	0
抱枕	bao'zhen	0
碧波仙子六件套	bi'bo'xian'zi'liu'jian'tao	0
碧波仙子四件套	bi'bo'xian'zi'si'jian'tao	0
标准型活套枕	biao'zhun'xing'huo'tao'zhen	0
标准型老板席	biao'zhun'xing'lao'ban'xi	0
标准型老板竹枕套	biao'zhun'xing'lao'ban'zhu'zhen'tao	0
标准型蚊帐	biao'zhun'xing'wen'zhang	0
宾馆洒店用品布版卡	bin'guan'sa'dian'yong'pin'bu'ban'ka	0
冰凉镜面枕	bing'liang'jing'mian'zhen	0
冰麻席	bing'ma'xi	0
冰麻枕套	bing'ma'zhen'tao	0
冰玉老板竹凉席款	bing'yu'lao'ban'zhu'liang'xi'kuan	0
冰玉竹席三件套	bing'yu'zhu'xi'san'jian'tao	0
冰玉竹席三件套款	bing'yu'zhu'xi'san'jian'tao'kuan	0
薄荷蚕丝清凉被	bo'he'can'si'qing'liang'bei	0
玻璃钢支架	bo'li'gang'zhi'jia	0
玻璃樽异彩真丝床盖十件套直营	bo'li'zun'yi'cai'zhen'si'chuang'gai'shi'jian'tao'zhi'ying	0
玻璃樽异彩真丝床盖四件套直营	bo'li'zun'yi'cai'zhen'si'chuang'gai'si'jian'tao'zhi'ying	0
波墨异彩床单四件套	bo'mo'yi'cai'chuang'dan'si'jian'tao	0
波斯情怀床单四件套	bo'si'qing'huai'chuang'dan'si'jian'tao	0
布艺抱枕外贸	bu'yi'bao'zhen'wai'mao	0
蚕沙面包枕	can'sha'mian'bao'zhen	0
蚕沙木棉枕	can'sha'mu'mian'zhen	0
蚕丝被	can'si'bei	0
蚕丝春秋被	can'si'chun'qiu'bei	0
蚕丝棉花被	can'si'mian'hua'bei	0
蚕丝夏被	can'si'xia'bei	0
蚕丝夏被直营	can'si'xia'bei'zhi'ying	0
蚕丝休闲垫	can'si'xiu'xian'dian	0
潮流实用垫	chao'liu'shi'yong'dian	0
潮人一族纯棉三件套	chao'ren'yi'zu'chun'mian'san'jian'tao	0
潮人一族纯棉三件套锦秀年华	chao'ren'yi'zu'chun'mian'san'jian'tao'jin'xiu'nian'hua	0
潮人一族纯棉三件套轻歌细语	chao'ren'yi'zu'chun'mian'san'jian'tao'qing'ge'xi'yu	0
潮人一族纯棉三件套幸运圈	chao'ren'yi'zu'chun'mian'san'jian'tao'xing'yun'quan	0
潮人一族纯棉三件套溢满香径	chao'ren'yi'zu'chun'mian'san'jian'tao'yi'man'xiang'jing	0
超柔长枕	chao'rou'chang'zhen	0
超柔工艺毛毯	chao'rou'gong'yi'mao'tan	0
超柔枕	chao'rou'zhen	0
超细亲肤毛巾	chao'xi'qin'fu'mao'jin	0
超细亲肤浴巾	chao'xi'qin'fu'yu'jin	0
超值装休闲蚊帐	chao'zhi'zhuang'xiu'xian'wen'zhang	0
沉睡精灵四件套	chen'shui'jing'ling'si'jian'tao	0
沉睡精灵四件套蓝	chen'shui'jing'ling'si'jian'tao'lan	0
沉香床单四件套	chen'xiang'chuang'dan'si'jian'tao	0
城市格调床单三件套直营	cheng'shi'ge'diao'chuang'dan'san'jian'tao'zhi'ying	0
成长太空枕	cheng'zhang'tai'kong'zhen	0
初夏床单四件套	chu'xia'chuang'dan'si'jian'tao	0
床头柜	chuang'tou'gui	0
创意空间床单三件套直营蓝	chuang'yi'kong'jian'chuang'dan'san'jian'tao'zhi'ying'lan	0
纯不锈钢宫廷蚊帐二合一	chun'bu'xiu'gang'gong'ting'wen'zhang'er'he'yi	0
纯不锈钢宫廷蚊帐二合一天鹅花	chun'bu'xiu'gang'gong'ting'wen'zhang'er'he'yi'tian'e'hua	0
纯蚕丝被	chun'can'si'bei	0
纯蚕丝春秋被	chun'can'si'chun'qiu'bei	0
纯美红床单四件套热卖	chun'mei'hong'chuang'dan'si'jian'tao're'mai	0
纯美生活八件套	chun'mei'sheng'huo'ba'jian'tao	0
纯棉被套	chun'mian'bei'tao	0
纯棉长枕套	chun'mian'chang'zhen'tao	0
纯棉床单	chun'mian'chuang'dan	0
纯棉床单四件套	chun'mian'chuang'dan'si'jian'tao	0
纯棉床笠	chun'mian'chuang'li	0
纯棉床笠六件套外贸	chun'mian'chuang'li'liu'jian'tao'wai'mao	0
纯棉床笠四件套	chun'mian'chuang'li'si'jian'tao	0
纯棉床笠四件套外贸	chun'mian'chuang'li'si'jian'tao'wai'mao	0
纯棉床笠五件套外贸	chun'mian'chuang'li'wu'jian'tao'wai'mao	0
纯棉床罩	chun'mian'chuang'zhao	0
纯棉刺绣夏薄被	chun'mian'ci'xiu'xia'bo'bei	0
纯棉大方枕	chun'mian'da'fang'zhen	0
纯棉短枕套	chun'mian'duan'zhen'tao	0
纯棉短枕套外贸	chun'mian'duan'zhen'tao'wai'mao	0
纯棉活套被	chun'mian'huo'tao'bei	0
纯棉活套冷气被	chun'mian'huo'tao'leng'qi'bei	0
纯棉剌绣夏薄被	chun'mian'la'xiu'xia'bo'bei	0
纯棉毛巾毯	chun'mian'mao'jin'tan	0
纯棉四件套	chun'mian'si'jian'tao	0
纯棉四件套红	chun'mian'si'jian'tao'hong	0
纯棉四件套买一送二	chun'mian'si'jian'tao'mai'yi'song'er	0
纯棉四件套买一送二爱的寓意	chun'mian'si'jian'tao'mai'yi'song'er'ai'de'yu'yi	0
纯棉四件套买一送二巴黎春天	chun'mian'si'jian'tao'mai'yi'song'er'ba'li'chun'tian	0
纯棉四件套买一送二帝诺情怀	chun'mian'si'jian'tao'mai'yi'song'er'di'nuo'qing'huai	0
纯棉四件套买一送二典雅玫瑰	chun'mian'si'jian'tao'mai'yi'song'er'dian'ya'mei'gui	0
纯棉四件套买一送二都市精灵	chun'mian'si'jian'tao'mai'yi'song'er'du'shi'jing'ling	0
纯棉四件套买一送二粉蝴蝶飞飞	chun'mian'si'jian'tao'mai'yi'song'er'fen'hu'die'fei'fei	0
纯棉四件套买一送二芙蓉	chun'mian'si'jian'tao'mai'yi'song'er'fu'rong	0
纯棉四件套买一送二红	chun'mian'si'jian'tao'mai'yi'song'er'hong	0
纯棉四件套买一送二红心愿	chun'mian'si'jian'tao'mai'yi'song'er'hong'xin'yuan	0
纯棉四件套买一送二黄香奈儿	chun'mian'si'jian'tao'mai'yi'song'er'huang'xiang'nai'er	0
纯棉四件套买一送二快乐花季	chun'mian'si'jian'tao'mai'yi'song'er'kuai'le'hua'ji	0
纯棉四件套买一送二蓝调生活	chun'mian'si'jian'tao'mai'yi'song'er'lan'diao'sheng'huo	0
纯棉四件套买一送二蓝蝴蝶飞飞	chun'mian'si'jian'tao'mai'yi'song'er'lan'hu'die'fei'fei	0
纯棉四件套买一送二蓝心愿	chun'mian'si'jian'tao'mai'yi'song'er'lan'xin'yuan	0
纯棉四件套买一送二流年似水	chun'mian'si'jian'tao'mai'yi'song'er'liu'nian'si'shui	0
纯棉四件套买一送二玛丽雅	chun'mian'si'jian'tao'mai'yi'song'er'ma'li'ya	0
纯棉四件套买一送二玫瑰誓言	chun'mian'si'jian'tao'mai'yi'song'er'mei'gui'shi'yan	0
纯棉四件套买一送二美艳动人	chun'mian'si'jian'tao'mai'yi'song'er'mei'yan'dong'ren	0
纯棉四件套买一送二潜意幽香	chun'mian'si'jian'tao'mai'yi'song'er'qian'yi'you'xiang	0
纯棉四件套买一送二情感基调	chun'mian'si'jian'tao'mai'yi'song'er'qing'gan'ji'diao	0
纯棉四件套买一送二清香	chun'mian'si'jian'tao'mai'yi'song'er'qing'xiang	0
纯棉四件套买一送二清雅花香	chun'mian'si'jian'tao'mai'yi'song'er'qing'ya'hua'xiang	0
纯棉四件套买一送二身临其境	chun'mian'si'jian'tao'mai'yi'song'er'shen'lin'qi'jing	0
纯棉四件套买一送二世纪之恋	chun'mian'si'jian'tao'mai'yi'song'er'shi'ji'zhi'lian	0
纯棉四件套买一送二水灵佳人	chun'mian'si'jian'tao'mai'yi'song'er'shui'ling'jia'ren	0
纯棉四件套买一送二无花号	chun'mian'si'jian'tao'mai'yi'song'er'wu'hua'hao	0
纯棉四件套买一送二心灵小屋	chun'mian'si'jian'tao'mai'yi'song'er'xin'ling'xiao'wu	0
纯棉四件套买一送二心情小屋	chun'mian'si'jian'tao'mai'yi'song'er'xin'qing'xiao'wu	0
纯棉四件套买一送二永恒经典	chun'mian'si'jian'tao'mai'yi'song'er'yong'heng'jing'dian	0
纯棉四件套买一送二幽香心语	chun'mian'si'jian'tao'mai'yi'song'er'you'xiang'xin'yu	0
纯棉四件套买一送二优雅恋歌	chun'mian'si'jian'tao'mai'yi'song'er'you'ya'lian'ge	0
纯棉四件套买一送二鸳鸯玫瑰	chun'mian'si'jian'tao'mai'yi'song'er'yuan'yang'mei'gui	0
纯棉四件套买一送二紫	chun'mian'si'jian'tao'mai'yi'song'er'zi	0
纯棉四件套买一送二紫香	chun'mian'si'jian'tao'mai'yi'song'er'zi'xiang	0
纯棉四件套青梅竹马	chun'mian'si'jian'tao'qing'mei'zhu'ma	0
纯棉四件套情迷蝴蝶	chun'mian'si'jian'tao'qing'mi'hu'die	0
纯棉四件套天真小可爱	chun'mian'si'jian'tao'tian'zhen'xiao'ke'ai	0
纯棉四件套侏罗记公园	chun'mian'si'jian'tao'zhu'luo'ji'gong'yuan	0
纯棉四件套紫	chun'mian'si'jian'tao'zi	0
纯棉四件套紫薰衣草	chun'mian'si'jian'tao'zi'xun'yi'cao	0
纯棉绣花四季被	chun'mian'xiu'hua'si'ji'bei	0
纯荞麦壳枕	chun'qiao'mai'ke'zhen	0
春秋被	chun'qiu'bei	0
纯桑蚕丝夏被	chun'sang'can'si'xia'bei	0
纯桑蚕丝夏被直营	chun'sang'can'si'xia'bei'zhi'ying	0
纯桑蚕丝子母被	chun'sang'can'si'zi'mu'bei	0
春色满园八件套	chun'se'man'yuan'ba'jian'tao	0
春天的梦四件套	chun'tian'de'meng'si'jian'tao	0
纯羊毛被	chun'yang'mao'bei	0
春韵天丝床单四件套	chun'yun'tian'si'chuang'dan'si'jian'tao	0
磁石枕	ci'shi'zhen	0
刺绣草艺坐垫	ci'xiu'cao'yi'zuo'dian	0
大床床单床笠四件套无花号	da'chuang'chuang'dan'chuang'li'si'jian'tao'wu'hua'hao	0
大床床裙四件套无花号	da'chuang'chuang'qun'si'jian'tao'wu'hua'hao	0
大豆亲肤暖冬被	da'dou'qin'fu'nuan'dong'bei	0
大豆丝柔安眠枕	da'dou'si'rou'an'mian'zhen	0
大豆纤柔夏薄被直营	da'dou'xian'rou'xia'bo'bei'zhi'ying	0
大豆纤维被直营	da'dou'xian'wei'bei'zhi'ying	0
大豆纤维冬被	da'dou'xian'wei'dong'bei	0
大豆纤维夏被	da'dou'xian'wei'xia'bei	0
大方垫枕芯	da'fang'dian'zhen'xin	0
大提花印花床单四件套直营	da'ti'hua'yin'hua'chuang'dan'si'jian'tao'zhi'ying	0
大头米妮	da'tou'mi'ni	0
大头米奇	da'tou'mi'qi	0
大头维尼	da'tou'wei'ni	0
大学生枕款	da'xue'sheng'zhen'kuan	0
戴博娜天丝床单四件套	dai'bo'na'tian'si'chuang'dan'si'jian'tao	0
淡蓝情调床笠四件套	dan'lan'qing'diao'chuang'li'si'jian'tao	0
单人电热毯	dan'ren'dian're'tan	0
地巾平织支	di'jin'ping'zhi'zhi	0
涤棉锻条系列四件套	di'mian'duan'tiao'xi'lie'si'jian'tao	0
帝诺情怀四件套	di'nuo'qing'huai'si'jian'tao	0
帝若情怀七件套	di'ruo'qing'huai'qi'jian'tao	0
迪士尼床单三件套	di'shi'ni'chuang'dan'san'jian'tao	0
迪士尼床单四件套	di'shi'ni'chuang'dan'si'jian'tao	0
迪士尼方抱枕	di'shi'ni'fang'bao'zhen	0
迪士尼糖果枕	di'shi'ni'tang'guo'zhen	0
低碳超滑席	di'tan'chao'hua'xi	0
低碳棉花被	di'tan'mian'hua'bei	0
低碳棉花春秋被	di'tan'mian'hua'chun'qiu'bei	0
低碳暖绒棉花被	di'tan'nuan'rong'mian'hua'bei	0
低碳驼毛暖绒被	di'tan'tuo'mao'nuan'rong'bei	0
低碳御藤单人坐垫	di'tan'yu'teng'dan'ren'zuo'dian	0
低碳御藤三人坐垫	di'tan'yu'teng'san'ren'zuo'dian	0
低碳御藤席	di'tan'yu'teng'xi	0
低碳御藤席三件套	di'tan'yu'teng'xi'san'jian'tao	0
典藏纯蚕丝薄被直营	dian'cang'chun'can'si'bo'bei'zhi'ying	0
典藏木纹席直营	dian'cang'mu'wen'xi'zhi'ying	0
垫胶	dian'jiao	0
典雅精致小提花纯棉四件套	dian'ya'jing'zhi'xiao'ti'hua'chun'mian'si'jian'tao	0
典雅六件套	dian'ya'liu'jian'tao	0
典雅玫瑰四件套	dian'ya'mei'gui'si'jian'tao	0
典雅时尚帐支架	dian'ya'shi'shang'zhang'zhi'jia	0
典雅四件套	dian'ya'si'jian'tao	0
典雅型蚕丝薄被	dian'ya'xing'can'si'bo'bei	0
典雅型蚕丝棉被	dian'ya'xing'can'si'mian'bei	0
典雅型工艺四件套	dian'ya'xing'gong'yi'si'jian'tao	0
典雅型镜面席	dian'ya'xing'jing'mian'xi	0
典雅型镜面枕套	dian'ya'xing'jing'mian'zhen'tao	0
典雅型时尚帐	dian'ya'xing'shi'shang'zhang	0
典雅型时尚帐支架	dian'ya'xing'shi'shang'zhang'zhi'jia	0
定型长枕	ding'xing'chang'zhen	0
订做床笠六件套热卖品	ding'zuo'chuang'li'liu'jian'tao're'mai'pin	0
订做粉之浪漫两件套热卖品	ding'zuo'fen'zhi'lang'man'liang'jian'tao're'mai'pin	0
订做马首婴儿套件热卖品	ding'zuo'ma'shou'ying'er'tao'jian're'mai'pin	0
东风惹媚床单四件套	dong'feng're'mei'chuang'dan'si'jian'tao	0
动物乐园床单三件套直营	dong'wu'le'yuan'chuang'dan'san'jian'tao'zhi'ying	0
动物乐园床单四件套直营	dong'wu'le'yuan'chuang'dan'si'jian'tao'zhi'ying	0
豆寇年华床裙四件套咖	dou'kou'nian'hua'chuang'qun'si'jian'tao'ka	0
杜邦防螨枕	du'bang'fang'man'zhen	0
都市风情纯棉七件套杂花热卖品	du'shi'feng'qing'chun'mian'qi'jian'tao'za'hua're'mai'pin	0
都市精灵七件套	du'shi'jing'ling'qi'jian'tao	0
缎带	duan'dai	0
锻条桑拿浴衣	duan'tiao'sang'na'yu'yi	0
多彩印花活套被	duo'cai'yin'hua'huo'tao'bei	0
朵朵盛放四件套	duo'duo'cheng'fang'si'jian'tao	0
朵朵真爱八件套粉	duo'duo'zhen'ai'ba'jian'tao'fen	0
朵朵真爱八件套驼	duo'duo'zhen'ai'ba'jian'tao'tuo	0
多功能收纳盒	duo'gong'neng'shou'na'he	0
多功能羊毛二合一被子母被	duo'gong'neng'yang'mao'er'he'yi'bei'zi'mu'bei	0
二合一切蛋器	er'he'yi'qie'dan'qi	0
儿童床垫绵布	er'tong'chuang'dian'mian'bu	0
儿童镜面竹席二件套	er'tong'jing'mian'zhu'xi'er'jian'tao	0
儿童决明子枕	er'tong'jue'ming'zi'zhen	0
帆布坐垫直营	fan'bu'zuo'dian'zhi'ying	0
繁花共舞八件套	fan'hua'gong'wu'ba'jian'tao	0
繁花似锦大红床单四件套特	fan'hua'si'jin'da'hong'chuang'dan'si'jian'tao'te	0
帆影床单四件套	fan'ying'chuang'dan'si'jian'tao	0
防虫罩	fang'chong'zhao	0
仿貂皮拉舍尔毛毯	fang'diao'pi'la'she'er'mao'tan	0
芳华床单四件套	fang'hua'chuang'dan'si'jian'tao	0
方巾平织支	fang'jin'ping'zhi'zhi	0
防水床垫	fang'shui'chuang'dian	0
仿羊绒拉舍尔毛毯	fang'yang'rong'la'she'er'mao'tan	0
粉彩床笠四件套	fen'cai'chuang'li'si'jian'tao	0
粉色丽人六件套	fen'se'li'ren'liu'jian'tao	0
粉色丽人四件套	fen'se'li'ren'si'jian'tao	0
粉色恋情九件套	fen'se'lian'qing'jiu'jian'tao	0
粉漾春色床裙四件套	fen'yang'chun'se'chuang'qun'si'jian'tao	0
粉之浪漫抱枕	fen'zhi'lang'man'bao'zhen	0
粉之浪漫两件套	fen'zhi'lang'man'liang'jian'tao	0
风格型活套被	feng'ge'xing'huo'tao'bei	0
风影床单四件套	feng'ying'chuang'dan'si'jian'tao	0
佛罗伦萨灰床单四件套	fo'luo'lun'sa'hui'chuang'dan'si'jian'tao	0
佛罗伦萨紫床单四件套	fo'luo'lun'sa'zi'chuang'dan'si'jian'tao	0
复古花语十件套	fu'gu'hua'yu'shi'jian'tao	0
富贵花开床单四件套	fu'gui'hua'kai'chuang'dan'si'jian'tao	0
富贵花开七件套	fu'gui'hua'kai'qi'jian'tao	0
富贵人生床盖四件套	fu'gui'ren'sheng'chuang'gai'si'jian'tao	0
富贵一生八件套	fu'gui'yi'sheng'ba'jian'tao	0
芙美娜床单四件套	fu'mei'na'chuang'dan'si'jian'tao	0
芙蓉七件套	fu'rong'qi'jian'tao	0
馥郁芬芳床笠四件套	fu'yu'fen'fang'chuang'li'si'jian'tao	0
高档纯棉六件套依恋砖红热卖品	gao'dang'chun'mian'liu'jian'tao'yi'lian'zhuan'hong're'mai'pin	0
高级儿童蚕丝被	gao'ji'er'tong'can'si'bei	0
高支棉抱枕套	gao'zhi'mian'bao'zhen'tao	0
格调人生四件套灰	ge'diao'ren'sheng'si'jian'tao'hui	0
割绒和服式浴袍	ge'rong'he'fu'shi'yu'pao	0
格新一代四件套	ge'xin'yi'dai'si'jian'tao	0
格雅生活四件套	ge'ya'sheng'huo'si'jian'tao	0
贡缎超柔桑蚕丝棉被	gong'duan'chao'rou'sang'can'si'mian'bei	0
贡缎印花床单四件套	gong'duan'yin'hua'chuang'dan'si'jian'tao	0
公主屋八件套粉红	gong'zhu'wu'ba'jian'tao'fen'hong	0
公主屋八件套砖红	gong'zhu'wu'ba'jian'tao'zhuan'hong	0
公主屋方枕	gong'zhu'wu'fang'zhen	0
公主屋六件套粉	gong'zhu'wu'liu'jian'tao'fen	0
公主屋六件套砖红	gong'zhu'wu'liu'jian'tao'zhuan'hong	0
公主屋四件套粉红	gong'zhu'wu'si'jian'tao'fen'hong	0
公主屋四件套砖红	gong'zhu'wu'si'jian'tao'zhuan'hong	0
公主屋小枕	gong'zhu'wu'xiao'zhen	0
古典光阴长枕套	gu'dian'guang'yin'chang'zhen'tao	0
古典光阴床盖四件套	gu'dian'guang'yin'chuang'gai'si'jian'tao	0
古典花开八件套	gu'dian'hua'kai'ba'jian'tao	0
古色庄园床笠四件套	gu'se'zhuang'yuan'chuang'li'si'jian'tao	0
古韵花都床罩四件套	gu'yun'hua'du'chuang'zhao'si'jian'tao	0
古韵花都九件套驼	gu'yun'hua'du'jiu'jian'tao'tuo	0
逛街女孩床笠四件套	guang'jie'nv'hai'chuang'li'si'jian'tao	0
贵妃蚕丝夏凉被	gui'fei'can'si'xia'liang'bei	0
贵族型八件套倾城之恋粉热卖品	gui'zu'xing'ba'jian'tao'qing'cheng'zhi'lian'fen're'mai'pin	0
贵族型蚕丝被	gui'zu'xing'can'si'bei	0
贵族型蚕丝春秋被	gui'zu'xing'can'si'chun'qiu'bei	0
贵族型超柔毛毯	gui'zu'xing'chao'rou'mao'tan	0
贵族型纯天然蚕丝被	gui'zu'xing'chun'tian'ran'can'si'bei	0
贵族型纯天然蚕丝薄被	gui'zu'xing'chun'tian'ran'can'si'bo'bei	0
贵族型精选鸭绒被	gui'zu'xing'jing'xuan'ya'rong'bei	0
贵族型休闲蚊帐款坐床式	gui'zu'xing'xiu'xian'wen'zhang'kuan'zuo'chuang'shi	0
贵族型休闲蚊帐支架落地式	gui'zu'xing'xiu'xian'wen'zhang'zhi'jia'luo'di'shi	0
贵族型休闲蚊帐支架年款	gui'zu'xing'xiu'xian'wen'zhang'zhi'jia'nian'kuan	0
贵族型休闲蚊帐支架坐床式	gui'zu'xing'xiu'xian'wen'zhang'zhi'jia'zuo'chuang'shi	0
贵族型休闲帐款	gui'zu'xing'xiu'xian'zhang'kuan	0
贵族型休闲帐落地式白紫色	gui'zu'xing'xiu'xian'zhang'luo'di'shi'bai'zi'se	0
贵族型休闲帐落地式粉红	gui'zu'xing'xiu'xian'zhang'luo'di'shi'fen'hong	0
贵族型休闲帐落地式米黄	gui'zu'xing'xiu'xian'zhang'luo'di'shi'mi'huang	0
贵族型休闲帐落地式紫色	gui'zu'xing'xiu'xian'zhang'luo'di'shi'zi'se	0
贵族型休闲帐年款落地式	gui'zu'xing'xiu'xian'zhang'nian'kuan'luo'di'shi	0
贵族型休闲帐年款落地式白紫	gui'zu'xing'xiu'xian'zhang'nian'kuan'luo'di'shi'bai'zi	0
贵族型休闲帐年款落地式粉	gui'zu'xing'xiu'xian'zhang'nian'kuan'luo'di'shi'fen	0
贵族型休闲帐年款落地式米黄	gui'zu'xing'xiu'xian'zhang'nian'kuan'luo'di'shi'mi'huang	0
贵族型休闲帐年款落地式紫	gui'zu'xing'xiu'xian'zhang'nian'kuan'luo'di'shi'zi	0
贵族型休闲帐直营	gui'zu'xing'xiu'xian'zhang'zhi'ying	0
贵族型休闲帐座床式	gui'zu'xing'xiu'xian'zhang'zuo'chuang'shi	0
贵族休闲帐帐身款	gui'zu'xiu'xian'zhang'zhang'shen'kuan	0
贵族休闲帐支架款	gui'zu'xiu'xian'zhang'zhi'jia'kuan	0
贵族鸭绒被	gui'zu'ya'rong'bei	0
贵族鸭绒枕直营	gui'zu'ya'rong'zhen'zhi'ying	0
果绿盈香四件套	guo'lv'ying'xiang'si'jian'tao	0
国色天香四件套粉红	guo'se'tian'xiang'si'jian'tao'fen'hong	0
海派甜心蓝床单四件套	hai'pai'tian'xin'lan'chuang'dan'si'jian'tao	0
海派甜心绿床单四件套	hai'pai'tian'xin'lv'chuang'dan'si'jian'tao	0
海洋乐园床笠三件套	hai'yang'le'yuan'chuang'li'san'jian'tao	0
海洋乐园床笠四件套	hai'yang'le'yuan'chuang'li'si'jian'tao	0
汉方草本枕	han'fang'cao'ben'zhen	0
韩风纯棉四件套	han'feng'chun'mian'si'jian'tao	0
韩式风尚纯棉绣花四件套	han'shi'feng'shang'chun'mian'xiu'hua'si'jian'tao	0
含羞草四件套蓝	han'xiu'cao'si'jian'tao'lan	0
含羞草四件套紫	han'xiu'cao'si'jian'tao'zi	0
绗绣纯荞麦枕	hang'xiu'chun'qiao'mai'zhen	0
豪华决明子智能凉枕	hao'hua'jue'ming'zi'zhi'neng'liang'zhen	0
豪华浪漫四件套	hao'hua'lang'man'si'jian'tao	0
豪华粒粒凉枕	hao'hua'li'li'liang'zhen	0
豪华芦荟护颈枕	hao'hua'lu'hui'hu'jing'zhen	0
豪华如意多用凉枕	hao'hua'ru'yi'duo'yong'liang'zhen	0
豪华型加厚羊毛被	hao'hua'xing'jia'hou'yang'mao'bei	0
豪华油柑叶慧聪枕	hao'hua'you'gan'ye'hui'cong'zhen	0
豪华玉面安逸枕	hao'hua'yu'mian'an'yi'zhen	0
豪华玉藤浪漫枕	hao'hua'yu'teng'lang'man'zhen	0
豪门贵族七件套	hao'men'gui'zu'qi'jian'tao	0
豪情逸致六件套粉	hao'qing'yi'zhi'liu'jian'tao'fen	0
豪情逸致六件套血青	hao'qing'yi'zhi'liu'jian'tao'xue'qing	0
豪情逸致四件套粉	hao'qing'yi'zhi'si'jian'tao'fen	0
红粉瞭人九件套	hong'fen'liao'ren'jiu'jian'tao	0
红四件套	hong'si'jian'tao	0
蝴蝶飞飞四件套	hu'die'fei'fei'si'jian'tao	0
呼唤床单四件套	hu'huan'chuang'dan'si'jian'tao	0
护颈荞麦枕冬夏两用型	hu'jing'qiao'mai'zhen'dong'xia'liang'yong'xing	0
护颈舒压枕	hu'jing'shu'ya'zhen	0
弧形脊椎按摩枕	hu'xing'ji'zhui'an'mo'zhen	0
花春之都四件套	hua'chun'zhi'du'si'jian'tao	0
花丛馨香床单四件套	hua'cong'xin'xiang'chuang'dan'si'jian'tao	0
花丛馨香七件套	hua'cong'xin'xiang'qi'jian'tao	0
花丛馨香四件套	hua'cong'xin'xiang'si'jian'tao	0
华德床垫	hua'de'chuang'dian	0
花的思绪粉床盖六件套	hua'de'si'xu'fen'chuang'gai'liu'jian'tao	0
华夫格和服式浴袍	hua'fu'ge'he'fu'shi'yu'pao	0
华夫佳人七件套	hua'fu'jia'ren'qi'jian'tao	0
华贵蚕丝春秋被	hua'gui'can'si'chun'qiu'bei	0
华贵毛绒坐垫	hua'gui'mao'rong'zuo'dian	0
华贵型蚕丝棉被	hua'gui'xing'can'si'mian'bei	0
花好月圆八件套	hua'hao'yue'yuan'ba'jian'tao	0
花季年华套装	hua'ji'nian'hua'tao'zhuang	0
花间魅影八件套	hua'jian'mei'ying'ba'jian'tao	0
花间魅影四件套	hua'jian'mei'ying'si'jian'tao	0
花开季节床盖六件套大红直营	hua'kai'ji'jie'chuang'gai'liu'jian'tao'da'hong'zhi'ying	0
华俪型纯棉被套	hua'li'xing'chun'mian'bei'tao	0
华俪型纯棉床单	hua'li'xing'chun'mian'chuang'dan	0
华俪型纯棉床笠	hua'li'xing'chun'mian'chuang'li	0
华丽型宫廷蚊帐	hua'li'xing'gong'ting'wen'zhang	0
华丽型宫廷蚊帐支架	hua'li'xing'gong'ting'wen'zhang'zhi'jia	0
华丽型鸭丝绒毛被	hua'li'xing'ya'si'rong'mao'bei	0
花露香韵四件套黄	hua'lu'xiang'yun'si'jian'tao'huang	0
花前月下六件套	hua'qian'yue'xia'liu'jian'tao	0
花为媒床盖十件套大红	hua'wei'mei'chuang'gai'shi'jian'tao'da'hong	0
花舞盛宴床单四件套	hua'wu'sheng'yan'chuang'dan'si'jian'tao	0
花香满园七件套	hua'xiang'man'yuan'qi'jian'tao	0
花香弥漫床笠四件套	hua'xiang'mi'man'chuang'li'si'jian'tao	0
花香心语七件套	hua'xiang'xin'yu'qi'jian'tao	0
花香心语四件套	hua'xiang'xin'yu'si'jian'tao	0
花影叠香大红床盖十件套	hua'ying'die'xiang'da'hong'chuang'gai'shi'jian'tao	0
花雨朦胧四件套	hua'yu'meng'long'si'jian'tao	0
花语情缘八件套大红	hua'yu'qing'yuan'ba'jian'tao'da'hong	0
花语心情四件套	hua'yu'xin'qing'si'jian'tao	0
花悦怡情七件套驼	hua'yue'yi'qing'qi'jian'tao'tuo	0
花悦怡情七件套砖红	hua'yue'yi'qing'qi'jian'tao'zhuan'hong	0
花之俏床单四件套	hua'zhi'qiao'chuang'dan'si'jian'tao	0
花姿倩影四件套	hua'zi'qian'ying'si'jian'tao	0
怀贝零压记忆枕	huai'bei'ling'ya'ji'yi'zhen	0
怀贝时尚方抱枕	huai'bei'shi'shang'fang'bao'zhen	0
怀贝信封活套枕送枕套	huai'bei'xin'feng'huo'tao'zhen'song'zhen'tao	0
环保购物袋	huan'bao'gou'wu'dai	0
幻彩藤席二件套	huan'cai'teng'xi'er'jian'tao	0
幻彩之梦床笠四件套	huan'cai'zhi'meng'chuang'li'si'jian'tao	0
欢乐狗枕	huan'le'gou'zhen	0
欢乐之家四件套	huan'le'zhi'jia'si'jian'tao	0
欢乐之家四件套兰黛	huan'le'zhi'jia'si'jian'tao'lan'dai	0
唤莎丽床单四件套	huan'sha'li'chuang'dan'si'jian'tao	0
皇妃英式罗帐	huang'fei'ying'shi'luo'zhang	0
皇家风韵六件套	huang'jia'feng'yun'liu'jian'tao	0
皇家贵族八件套	huang'jia'gui'zu'ba'jian'tao	0
皇室鹅绒被	huang'shi'e'rong'bei	0
皇室鹅绒枕直营	huang'shi'e'rong'zhen'zhi'ying	0
皇室恩典七件套	huang'shi'en'dian'qi'jian'tao	0
皇室太空护颈枕	huang'shi'tai'kong'hu'jing'zhen	0
皇室养生枕	huang'shi'yang'sheng'zhen	0
皇室印象长枕套	huang'shi'yin'xiang'chang'zhen'tao	0
皇室印象床盖四件套	huang'shi'yin'xiang'chuang'gai'si'jian'tao	0
火红玫瑰床盖十件套	huo'hong'mei'gui'chuang'gai'shi'jian'tao	0
火玫瑰床幔	huo'mei'gui'chuang'man	0
活性印花床单四件套直营	huo'xing'yin'hua'chuang'dan'si'jian'tao'zhi'ying	0
活性印花四件套唯美	huo'xing'yin'hua'si'jian'tao'wei'mei	0
活性印花四件套缘聚今生	huo'xing'yin'hua'si'jian'tao'yuan'ju'jin'sheng	0
激情玫瑰玉色床单四件套特	ji'qing'mei'gui'yu'shai'chuang'dan'si'jian'tao'te	0
记忆颗粒按摩枕	ji'yi'ke'li'an'mo'zhen	0
记忆绵薄垫三折段	ji'yi'mian'bo'dian'san'zhe'duan	0
记忆绵功能垫按摩球颗粒搭配	ji'yi'mian'gong'neng'dian'an'mo'qiu'ke'li'da'pei	0
记忆绵厚垫常规搭配	ji'yi'mian'hou'dian'chang'gui'da'pei	0
记忆绵厚垫加竹炭搭配	ji'yi'mian'hou'dian'jia'zhu'tan'da'pei	0
家居良伴纯棉四件套	jia'ju'liang'ban'chun'mian'si'jian'tao	0
家居良伴纯棉四件套灰丰姿卓越	jia'ju'liang'ban'chun'mian'si'jian'tao'hui'feng'zi'zhuo'yue	0
家居良伴纯棉四件套浪潮	jia'ju'liang'ban'chun'mian'si'jian'tao'lang'chao	0
家居良伴纯棉四件套苹果乐园	jia'ju'liang'ban'chun'mian'si'jian'tao'ping'guo'le'yuan	0
家居良伴纯棉四件套身临其境	jia'ju'liang'ban'chun'mian'si'jian'tao'shen'lin'qi'jing	0
家居良伴纯棉四件套温情绽放	jia'ju'liang'ban'chun'mian'si'jian'tao'wen'qing'zhan'fang	0
家居良伴纯棉四件套星愿红	jia'ju'liang'ban'chun'mian'si'jian'tao'xing'yuan'hong	0
家居良伴纯棉四件套星愿蓝	jia'ju'liang'ban'chun'mian'si'jian'tao'xing'yuan'lan	0
家居良伴纯棉四件套星愿紫	jia'ju'liang'ban'chun'mian'si'jian'tao'xing'yuan'zi	0
家居良伴纯棉四件套真爱	jia'ju'liang'ban'chun'mian'si'jian'tao'zhen'ai	0
家居良伴纯棉四件套真情美丽	jia'ju'liang'ban'chun'mian'si'jian'tao'zhen'qing'mei'li	0
家居良伴四件身临其境	jia'ju'liang'ban'si'jian'shen'lin'qi'jing	0
家居良伴四件套	jia'ju'liang'ban'si'jian'tao	0
家居良伴四件套爱之羽	jia'ju'liang'ban'si'jian'tao'ai'zhi'yu	0
家居良伴四件套斑斓彩韵	jia'ju'liang'ban'si'jian'tao'ban'lan'cai'yun	0
家居良伴四件套贝诺	jia'ju'liang'ban'si'jian'tao'bei'nuo	0
家居良伴四件套纯爱	jia'ju'liang'ban'si'jian'tao'chun'ai	0
家居良伴四件套春日情歌	jia'ju'liang'ban'si'jian'tao'chun'ri'qing'ge	0
家居良伴四件套春日情歌桔	jia'ju'liang'ban'si'jian'tao'chun'ri'qing'ge'ju	0
家居良伴四件套帝诺情怀	jia'ju'liang'ban'si'jian'tao'di'nuo'qing'huai	0
家居良伴四件套帝若情怀	jia'ju'liang'ban'si'jian'tao'di'ruo'qing'huai	0
家居良伴四件套粉	jia'ju'liang'ban'si'jian'tao'fen	0
家居良伴四件套粉蝴蝶飞飞	jia'ju'liang'ban'si'jian'tao'fen'hu'die'fei'fei	0
家居良伴四件套粉童梦奇缘	jia'ju'liang'ban'si'jian'tao'fen'tong'meng'qi'yuan	0
家居良伴四件套风中情缘	jia'ju'liang'ban'si'jian'tao'feng'zhong'qing'yuan	0
家居良伴四件套格调	jia'ju'liang'ban'si'jian'tao'ge'diao	0
家居良伴四件套格格坊	jia'ju'liang'ban'si'jian'tao'ge'ge'fang	0
家居良伴四件套格格坊坊	jia'ju'liang'ban'si'jian'tao'ge'ge'fang'fang	0
家居良伴四件套格雅生活	jia'ju'liang'ban'si'jian'tao'ge'ya'sheng'huo	0
家居良伴四件套红	jia'ju'liang'ban'si'jian'tao'hong	0
家居良伴四件套红都市精灵	jia'ju'liang'ban'si'jian'tao'hong'du'shi'jing'ling	0
家居良伴四件套花香良缘	jia'ju'liang'ban'si'jian'tao'hua'xiang'liang'yuan	0
家居良伴四件套欢乐祝福	jia'ju'liang'ban'si'jian'tao'huan'le'zhu'fu	0
家居良伴四件套黄大笨驴	jia'ju'liang'ban'si'jian'tao'huang'da'ben'lv	0
家居良伴四件套灰丰姿卓越	jia'ju'liang'ban'si'jian'tao'hui'feng'zi'zhuo'yue	0
家居良伴四件套吉祥羽	jia'ju'liang'ban'si'jian'tao'ji'xiang'yu	0
家居良伴四件套简约都市	jia'ju'liang'ban'si'jian'tao'jian'yue'du'shi	0
家居良伴四件套快乐熊仔	jia'ju'liang'ban'si'jian'tao'kuai'le'xiong'zai	0
家居良伴四件套蓝大笨驴	jia'ju'liang'ban'si'jian'tao'lan'da'ben'lv	0
家居良伴四件套蓝童梦奇缘	jia'ju'liang'ban'si'jian'tao'lan'tong'meng'qi'yuan	0
家居良伴四件套浪潮	jia'ju'liang'ban'si'jian'tao'lang'chao	0
家居良伴四件套律动	jia'ju'liang'ban'si'jian'tao'lv'dong	0
家居良伴四件套满香庭	jia'ju'liang'ban'si'jian'tao'man'xiang'ting	0
家居良伴四件套美艳动人	jia'ju'liang'ban'si'jian'tao'mei'yan'dong'ren	0
家居良伴四件套朴实无暇	jia'ju'liang'ban'si'jian'tao'pu'shi'wu'xia	0
家居良伴四件套芊芊柔情	jia'ju'liang'ban'si'jian'tao'qian'qian'rou'qing	0
家居良伴四件套清纯息影	jia'ju'liang'ban'si'jian'tao'qing'chun'xi'ying	0
家居良伴四件套清闲雅兴	jia'ju'liang'ban'si'jian'tao'qing'xian'ya'xing	0
家居良伴四件套身临其境	jia'ju'liang'ban'si'jian'tao'shen'lin'qi'jing	0
家居良伴四件套天籁之音	jia'ju'liang'ban'si'jian'tao'tian'lai'zhi'yin	0
家居良伴四件套顽皮熊	jia'ju'liang'ban'si'jian'tao'wan'pi'xiong	0
家居良伴四件套顽皮熊热卖品	jia'ju'liang'ban'si'jian'tao'wan'pi'xiong're'mai'pin	0
家居良伴四件套温情绽放	jia'ju'liang'ban'si'jian'tao'wen'qing'zhan'fang	0
家居良伴四件套温馨家园	jia'ju'liang'ban'si'jian'tao'wen'xin'jia'yuan	0
家居良伴四件套小象帕特粉	jia'ju'liang'ban'si'jian'tao'xiao'xiang'pa'te'fen	0
家居良伴四件套心悦玫瑰	jia'ju'liang'ban'si'jian'tao'xin'yue'mei'gui	0
家居良伴四件套星愿红	jia'ju'liang'ban'si'jian'tao'xing'yuan'hong	0
家居良伴四件套星愿蓝	jia'ju'liang'ban'si'jian'tao'xing'yuan'lan	0
家居良伴四件套星愿紫	jia'ju'liang'ban'si'jian'tao'xing'yuan'zi	0
家居良伴四件套薰衣草	jia'ju'liang'ban'si'jian'tao'xun'yi'cao	0
家居良伴四件套雅致心语	jia'ju'liang'ban'si'jian'tao'ya'zhi'xin'yu	0
家居良伴四件套烟花三月	jia'ju'liang'ban'si'jian'tao'yan'hua'san'yue	0
家居良伴四件套茵茵花香紫	jia'ju'liang'ban'si'jian'tao'yin'yin'hua'xiang'zi	0
家居良伴四件套又见花期	jia'ju'liang'ban'si'jian'tao'you'jian'hua'qi	0
家居良伴四件套优雅生活	jia'ju'liang'ban'si'jian'tao'you'ya'sheng'huo	0
家居良伴四件套杂花热卖品	jia'ju'liang'ban'si'jian'tao'za'hua're'mai'pin	0
家居良伴四件套真爱	jia'ju'liang'ban'si'jian'tao'zhen'ai	0
家居良伴四件套真情美丽	jia'ju'liang'ban'si'jian'tao'zhen'qing'mei'li	0
家居良伴四件套真情绽放	jia'ju'liang'ban'si'jian'tao'zhen'qing'zhan'fang	0
家居良伴四件套紫	jia'ju'liang'ban'si'jian'tao'zi	0
家居良伴四件套紫静谧花醒	jia'ju'liang'ban'si'jian'tao'zi'jing'mi'hua'xing	0
加强型挂壁双轨套装蚊帐	jia'qiang'xing'gua'bi'shuang'gui'tao'zhuang'wen'zhang	0
假日海岸四件套蓝	jia'ri'hai'an'si'jian'tao'lan	0
嘉希亚床裙四件套	jia'xi'ya'chuang'qun'si'jian'tao	0
家园恋曲豪华四件套	jia'yuan'lian'qu'hao'hua'si'jian'tao	0
家园恋曲豪华四件套半糖主义红	jia'yuan'lian'qu'hao'hua'si'jian'tao'ban'tang'zhu'yi'hong	0
家园恋曲豪华四件套半糖主义兰	jia'yuan'lian'qu'hao'hua'si'jian'tao'ban'tang'zhu'yi'lan	0
家园恋曲豪华四件套城市节拍	jia'yuan'lian'qu'hao'hua'si'jian'tao'cheng'shi'jie'pai	0
家园恋曲豪华四件套花飞蝶舞	jia'yuan'lian'qu'hao'hua'si'jian'tao'hua'fei'die'wu	0
家园恋曲豪华四件套简约时光	jia'yuan'lian'qu'hao'hua'si'jian'tao'jian'yue'shi'guang	0
家园恋曲豪华四件套洛丽塔	jia'yuan'lian'qu'hao'hua'si'jian'tao'luo'li'ta	0
家园恋曲豪华四件套普罗旺斯	jia'yuan'lian'qu'hao'hua'si'jian'tao'pu'luo'wang'si	0
家园恋曲豪华四件套青春旋律	jia'yuan'lian'qu'hao'hua'si'jian'tao'qing'chun'xuan'lv	0
家园恋曲豪华四件套时空旅行	jia'yuan'lian'qu'hao'hua'si'jian'tao'shi'kong'lv'xing	0
家园恋曲豪华四件套双面佳人	jia'yuan'lian'qu'hao'hua'si'jian'tao'shuang'mian'jia'ren	0
家园恋曲豪华四件套维纳斯密语	jia'yuan'lian'qu'hao'hua'si'jian'tao'wei'na'si'mi'yu	0
家园恋曲豪华四件套星座	jia'yuan'lian'qu'hao'hua'si'jian'tao'xing'zuo	0
家园恋曲豪华四件套旭日咖	jia'yuan'lian'qu'hao'hua'si'jian'tao'xu'ri'ka	0
家园恋曲豪华四件套一米阳光	jia'yuan'lian'qu'hao'hua'si'jian'tao'yi'mi'yang'guang	0
家园恋曲豪华四件套易趣彩虹	jia'yuan'lian'qu'hao'hua'si'jian'tao'yi'qu'cai'hong	0
家园恋曲豪华四件套优雅生活	jia'yuan'lian'qu'hao'hua'si'jian'tao'you'ya'sheng'huo	0
家园恋曲豪华四件套月光曲红	jia'yuan'lian'qu'hao'hua'si'jian'tao'yue'guang'qu'hong	0
家园恋曲豪华四件套月光曲兰	jia'yuan'lian'qu'hao'hua'si'jian'tao'yue'guang'qu'lan	0
家园恋曲豪华四件套紫藤花	jia'yuan'lian'qu'hao'hua'si'jian'tao'zi'teng'hua	0
家园恋曲四件套	jia'yuan'lian'qu'si'jian'tao	0
家园恋曲四件套半糖主义红	jia'yuan'lian'qu'si'jian'tao'ban'tang'zhu'yi'hong	0
家园恋曲四件套半糖主义兰	jia'yuan'lian'qu'si'jian'tao'ban'tang'zhu'yi'lan	0
家园恋曲四件套贝诺	jia'yuan'lian'qu'si'jian'tao'bei'nuo	0
家园恋曲四件套城市节拍	jia'yuan'lian'qu'si'jian'tao'cheng'shi'jie'pai	0
家园恋曲四件套纯爱	jia'yuan'lian'qu'si'jian'tao'chun'ai	0
家园恋曲四件套纯美红	jia'yuan'lian'qu'si'jian'tao'chun'mei'hong	0
家园恋曲四件套纯美兰	jia'yuan'lian'qu'si'jian'tao'chun'mei'lan	0
家园恋曲四件套花飞蝶舞	jia'yuan'lian'qu'si'jian'tao'hua'fei'die'wu	0
家园恋曲四件套欢乐祝福	jia'yuan'lian'qu'si'jian'tao'huan'le'zhu'fu	0
家园恋曲四件套简约时光	jia'yuan'lian'qu'si'jian'tao'jian'yue'shi'guang	0
家园恋曲四件套克里斯汀	jia'yuan'lian'qu'si'jian'tao'ke'li'si'ting	0
家园恋曲四件套洛丽塔	jia'yuan'lian'qu'si'jian'tao'luo'li'ta	0
家园恋曲四件套摩登时代	jia'yuan'lian'qu'si'jian'tao'mo'deng'shi'dai	0
家园恋曲四件套普罗旺斯	jia'yuan'lian'qu'si'jian'tao'pu'luo'wang'si	0
家园恋曲四件套青春旋律	jia'yuan'lian'qu'si'jian'tao'qing'chun'xuan'lv	0
家园恋曲四件套秋意	jia'yuan'lian'qu'si'jian'tao'qiu'yi	0
家园恋曲四件套时空旅行	jia'yuan'lian'qu'si'jian'tao'shi'kong'lv'xing	0
家园恋曲四件套时尚生活	jia'yuan'lian'qu'si'jian'tao'shi'shang'sheng'huo	0
家园恋曲四件套双面佳人	jia'yuan'lian'qu'si'jian'tao'shuang'mian'jia'ren	0
家园恋曲四件套维纳斯密语	jia'yuan'lian'qu'si'jian'tao'wei'na'si'mi'yu	0
家园恋曲四件套星座	jia'yuan'lian'qu'si'jian'tao'xing'zuo	0
家园恋曲四件套旭日咖	jia'yuan'lian'qu'si'jian'tao'xu'ri'ka	0
家园恋曲四件套寻梦花园紫	jia'yuan'lian'qu'si'jian'tao'xun'meng'hua'yuan'zi	0
家园恋曲四件套一米阳光	jia'yuan'lian'qu'si'jian'tao'yi'mi'yang'guang	0
家园恋曲四件套易趣彩虹	jia'yuan'lian'qu'si'jian'tao'yi'qu'cai'hong	0
家园恋曲四件套优雅生活	jia'yuan'lian'qu'si'jian'tao'you'ya'sheng'huo	0
家园恋曲四件套幽幽花香	jia'yuan'lian'qu'si'jian'tao'you'you'hua'xiang	0
家园恋曲四件套月光曲红	jia'yuan'lian'qu'si'jian'tao'yue'guang'qu'hong	0
家园恋曲四件套月光曲兰	jia'yuan'lian'qu'si'jian'tao'yue'guang'qu'lan	0
家园恋曲四件套紫藤花	jia'yuan'lian'qu'si'jian'tao'zi'teng'hua	0
家园恋曲四件套踪迹	jia'yuan'lian'qu'si'jian'tao'zong'ji	0
简约床笠四件赛纳风情	jian'yue'chuang'li'si'jian'sai'na'feng'qing	0
简约床笠四件套波西米亚	jian'yue'chuang'li'si'jian'tao'bo'xi'mi'ya	0
简约床笠四件套菲尔	jian'yue'chuang'li'si'jian'tao'fei'er	0
简约床笠四件套风中情缘	jian'yue'chuang'li'si'jian'tao'feng'zhong'qing'yuan	0
简约床笠四件套格韵	jian'yue'chuang'li'si'jian'tao'ge'yun	0
简约床笠四件套古色庄园停用	jian'yue'chuang'li'si'jian'tao'gu'se'zhuang'yuan'ting'yong	0
简约床笠四件套古色庄园直营	jian'yue'chuang'li'si'jian'tao'gu'se'zhuang'yuan'zhi'ying	0
简约床笠四件套花海情深	jian'yue'chuang'li'si'jian'tao'hua'hai'qing'shen	0
简约床笠四件套花间小栖粉蓝	jian'yue'chuang'li'si'jian'tao'hua'jian'xiao'qi'fen'lan	0
简约床笠四件套欢乐祝福	jian'yue'chuang'li'si'jian'tao'huan'le'zhu'fu	0
简约床笠四件套简单生活	jian'yue'chuang'li'si'jian'tao'jian'dan'sheng'huo	0
简约床笠四件套简约都市	jian'yue'chuang'li'si'jian'tao'jian'yue'du'shi	0
简约床笠四件套咖啡物语	jian'yue'chuang'li'si'jian'tao'ka'fei'wu'yu	0
简约床笠四件套浪漫花意	jian'yue'chuang'li'si'jian'tao'lang'man'hua'yi	0
简约床笠四件套浪漫曲线	jian'yue'chuang'li'si'jian'tao'lang'man'qu'xian	0
简约床笠四件套流星花园蓝	jian'yue'chuang'li'si'jian'tao'liu'xing'hua'yuan'lan	0
简约床笠四件套漫舞花影	jian'yue'chuang'li'si'jian'tao'man'wu'hua'ying	0
简约床笠四件套梦幻花香	jian'yue'chuang'li'si'jian'tao'meng'huan'hua'xiang	0
简约床笠四件套名门望族直营	jian'yue'chuang'li'si'jian'tao'ming'men'wang'zu'zhi'ying	0
简约床笠四件套芊芊柔情	jian'yue'chuang'li'si'jian'tao'qian'qian'rou'qing	0
简约床笠四件套清晨依恋	jian'yue'chuang'li'si'jian'tao'qing'chen'yi'lian	0
简约床笠四件套青春记忆	jian'yue'chuang'li'si'jian'tao'qing'chun'ji'yi	0
简约床笠四件套赛纳风情	jian'yue'chuang'li'si'jian'tao'sai'na'feng'qing	0
简约床笠四件套时尚丽人紫	jian'yue'chuang'li'si'jian'tao'shi'shang'li'ren'zi	0
简约床笠四件套威尼斯之恋直营	jian'yue'chuang'li'si'jian'tao'wei'ni'si'zhi'lian'zhi'ying	0
简约床笠四件套心语	jian'yue'chuang'li'si'jian'tao'xin'yu	0
简约床笠四件套叶影随风	jian'yue'chuang'li'si'jian'tao'ye'ying'sui'feng	0
简约床笠四件套异域风情	jian'yue'chuang'li'si'jian'tao'yi'yu'feng'qing	0
简约床笠四件套月景	jian'yue'chuang'li'si'jian'tao'yue'jing	0
简约风情三件套	jian'yue'feng'qing'san'jian'tao	0
简约风情三件套花影飘香	jian'yue'feng'qing'san'jian'tao'hua'ying'piao'xiang	0
简约风情四件套	jian'yue'feng'qing'si'jian'tao	0
简约时光床单四件套热卖	jian'yue'shi'guang'chuang'dan'si'jian'tao're'mai	0
江山美人四件套	jiang'shan'mei'ren'si'jian'tao	0
金钱方抱枕	jin'qian'fang'bao'zhen	0
精编工艺竹凉席	jing'bian'gong'yi'zhu'liang'xi	0
经典人生七件套米白	jing'dian'ren'sheng'qi'jian'tao'mi'bai	0
经典人生七件套雪青	jing'dian'ren'sheng'qi'jian'tao'xue'qing	0
精纺毛毯	jing'fang'mao'tan	0
精工雪竹席	jing'gong'xue'zhu'xi	0
精工竹青席	jing'gong'zhu'qing'xi	0
精工竹青枕席	jing'gong'zhu'qing'zhen'xi	0
精工竹坐垫	jing'gong'zhu'zuo'dian	0
镜花缘四件套红	jing'hua'yuan'si'jian'tao'hong	0
镜花缘四件套紫	jing'hua'yuan'si'jian'tao'zi	0
静谧花香四件套	jing'mi'hua'xiang'si'jian'tao	0
精品纯棉被套	jing'pin'chun'mian'bei'tao	0
精品纯棉床单	jing'pin'chun'mian'chuang'dan	0
精品纯棉活性印花四件套	jing'pin'chun'mian'huo'xing'yin'hua'si'jian'tao	0
精品纯棉枕套	jing'pin'chun'mian'zhen'tao	0
精品骨瓷碗套装	jing'pin'gu'ci'wan'tao'zhuang	0
精品礼品杯	jing'pin'li'pin'bei	0
精品蔺草席三件套	jing'pin'lin'cao'xi'san'jian'tao	0
精品蔺草席三件套款	jing'pin'lin'cao'xi'san'jian'tao'kuan	0
精品磨毛纯棉活性印花四件套	jing'pin'mo'mao'chun'mian'huo'xing'yin'hua'si'jian'tao	0
精品拼花竹凉席	jing'pin'pin'hua'zhu'liang'xi	0
精品竹丝工艺席款	jing'pin'zhu'si'gong'yi'xi'kuan	0
精品竹丝工艺席印花直营	jing'pin'zhu'si'gong'yi'xi'yin'hua'zhi'ying	0
精品竹丝工艺枕套	jing'pin'zhu'si'gong'yi'zhen'tao	0
精品竹丝工艺坐垫	jing'pin'zhu'si'gong'yi'zuo'dian	0
精梳羽蚕丝被大润发	jing'shu'yu'can'si'bei'da'run'fa	0
精梳羽丝绒夏凉被	jing'shu'yu'si'rong'xia'liang'bei	0
精梳羽羊毛被大润发	jing'shu'yu'yang'mao'bei'da'run'fa	0
静水听歌床单四件套	jing'shui'ting'ge'chuang'dan'si'jian'tao	0
精选珍珠被	jing'xuan'zhen'zhu'bei	0
精致白鸭绒被	jing'zhi'bai'ya'rong'bei	0
精致记忆床单四件套	jing'zhi'ji'yi'chuang'dan'si'jian'tao	0
精致记忆床笠四件套直营	jing'zhi'ji'yi'chuang'li'si'jian'tao'zhi'ying	0
精致生活床笠四件套	jing'zhi'sheng'huo'chuang'li'si'jian'tao	0
精致驼毛被	jing'zhi'tuo'mao'bei	0
精致型毛毯	jing'zhi'xing'mao'tan	0
精致型蚊帐	jing'zhi'xing'wen'zhang	0
颈椎调节枕	jing'zhui'tiao'jie'zhen	0
九孔春秋被	jiu'kong'chun'qiu'bei	0
九孔驼绒春秋被	jiu'kong'tuo'rong'chun'qiu'bei	0
绝代伊人长枕套	jue'dai'yi'ren'chang'zhen'tao	0
绝代伊人床盖四件套	jue'dai'yi'ren'chuang'gai'si'jian'tao	0
决明子茶香枕	jue'ming'zi'cha'xiang'zhen	0
决明子长枕	jue'ming'zi'chang'zhen	0
决明子定型枕	jue'ming'zi'ding'xing'zhen	0
决明子木棉定型智能枕	jue'ming'zi'mu'mian'ding'xing'zhi'neng'zhen	0
决明子舒眠枕	jue'ming'zi'shu'mian'zhen	0
决明子学生枕送枕套	jue'ming'zi'xue'sheng'zhen'song'zhen'tao	0
决明子智能凉枕	jue'ming'zi'zhi'neng'liang'zhen	0
卡拉特床裙四件套直营	ka'la'te'chuang'qun'si'jian'tao'zhi'ying	0
卡通抱枕	ka'tong'bao'zhen	0
凯瑞床笠四件套直营	kai'rui'chuang'li'si'jian'tao'zhi'ying	0
可爱小猪枕	ke'ai'xiao'zhu'zhen	0
克里斯汀床单四件套热卖	ke'li'si'ting'chuang'dan'si'jian'tao're'mai	0
肯尼亚枕套外贸	ken'ni'ya'zhen'tao'wai'mao	0
恐龙枕	kong'long'zhen	0
空中旅行粉床笠三件套	kong'zhong'lv'xing'fen'chuang'li'san'jian'tao	0
空中旅行粉床笠四件套	kong'zhong'lv'xing'fen'chuang'li'si'jian'tao	0
快乐花季四件套	kuai'le'hua'ji'si'jian'tao	0
剌绣大红四件套	la'xiu'da'hong'si'jian'tao	0
莱普床笠四件套直营	lai'pu'chuang'li'si'jian'tao'zhi'ying	0
蓝调生活七件套	lan'diao'sheng'huo'qi'jian'tao	0
蓝色城堡床盖四件套	lan'se'cheng'bao'chuang'gai'si'jian'tao	0
阑珊六件套	lan'shan'liu'jian'tao	0
浪漫晨曦全伸缩折合蚊帐直营	lang'man'chen'xi'quan'shen'suo'zhe'he'wen'zhang'zhi'ying	0
浪漫风情四件套	lang'man'feng'qing'si'jian'tao	0
浪漫格调四件套	lang'man'ge'diao'si'jian'tao	0
浪漫满屋七件套	lang'man'man'wu'qi'jian'tao	0
浪漫满屋四件套	lang'man'man'wu'si'jian'tao	0
浪漫情怀天丝床单四件套	lang'man'qing'huai'tian'si'chuang'dan'si'jian'tao	0
浪漫时尚六件套	lang'man'shi'shang'liu'jian'tao	0
浪漫时尚四件套	lang'man'shi'shang'si'jian'tao	0
浪漫相依床单四件套	lang'man'xiang'yi'chuang'dan'si'jian'tao	0
浪漫一生六件套粉	lang'man'yi'sheng'liu'jian'tao'fen	0
浪漫之恋蚊帐直营	lang'man'zhi'lian'wen'zhang'zhi'ying	0
浪漫紫韵床盖十件套	lang'man'zi'yun'chuang'gai'shi'jian'tao	0
老公老婆	lao'gong'lao'po	0
老公老婆浴巾	lao'gong'lao'po'yu'jin	0
乐翻盛夏床单四件套	le'fan'sheng'xia'chuang'dan'si'jian'tao	0
蕾亚床垫	lei'ya'chuang'dian	0
丽嘉床垫	li'jia'chuang'dian	0
粒粒凉枕	li'li'liang'zhen	0
粒粒凉坐垫	li'li'liang'zuo'dian	0
立体按摩舒压枕	li'ti'an'mo'shu'ya'zhen	0
立姿米尼	li'zi'mi'ni	0
立姿米奇	li'zi'mi'qi	0
恋冬羊毛被	lian'dong'yang'mao'bei	0
恋恋情曲六件套砖红	lian'lian'qing'qu'liu'jian'tao'zhuan'hong	0
恋恋情曲四件套砖红	lian'lian'qing'qu'si'jian'tao'zhuan'hong	0
恋恋丝语八件套	lian'lian'si'yu'ba'jian'tao	0
恋曲九件套	lian'qu'jiu'jian'tao	0
靓彩靠枕	liang'cai'kao'zhen	0
两用麦饭玉石枕	liang'yong'mai'fan'yu'shi'zhen	0
良缘风情四件套	liang'yuan'feng'qing'si'jian'tao	0
零压记忆枕	ling'ya'ji'yi'zhen	0
流波浮萍床单四件套	liu'bo'fu'ping'chuang'dan'si'jian'tao	0
流光溢彩床单三件套直营	liu'guang'yi'cai'chuang'dan'san'jian'tao'zhi'ying	0
流光溢彩床单四件套直营	liu'guang'yi'cai'chuang'dan'si'jian'tao'zhi'ying	0
六件套	liu'jian'tao	0
六件套大红	liu'jian'tao'da'hong	0
流年似水四件套	liu'nian'si'shui'si'jian'tao	0
龙凤呈祥床盖十件套大红	long'feng'cheng'xiang'chuang'gai'shi'jian'tao'da'hong	0
龙凤吉祥六件套	long'feng'ji'xiang'liu'jian'tao	0
龙凤吉祥四件套	long'feng'ji'xiang'si'jian'tao	0
芦荟护颈枕	lu'hui'hu'jing'zhen	0
路易床垫	lu'yi'chuang'dian	0
罗布麻定型枕	luo'bu'ma'ding'xing'zhen	0
洛丽丝塔八件套大红	luo'li'si'ta'ba'jian'tao'da'hong	0
洛丽塔蕾丝八件套大红	luo'li'ta'lei'si'ba'jian'tao'da'hong	0
洛丽塔蕾丝八件套粉	luo'li'ta'lei'si'ba'jian'tao'fen	0
罗马风情九件套	luo'ma'feng'qing'jiu'jian'tao	0
罗马恋曲八件套	luo'ma'lian'qu'ba'jian'tao	0
罗曼之约红床单四件套	luo'man'zhi'yue'hong'chuang'dan'si'jian'tao	0
罗曼之约紫床单四件套	luo'man'zhi'yue'zi'chuang'dan'si'jian'tao	0
玛丽床垫	ma'li'chuang'dian	0
玛丽床裙四件套	ma'li'chuang'qun'si'jian'tao	0
马首单人套件外贸八件套	ma'shou'dan'ren'tao'jian'wai'mao'ba'jian'tao	0
麦饭石健康杯	mai'fan'shi'jian'kang'bei	0
麦秋圆型蚊帐直营	mai'qiu'yuan'xing'wen'zhang'zhi'ying	0
曼妙之音天丝床单四件套	man'miao'zhi'yin'tian'si'chuang'dan'si'jian'tao	0
曼舞人生床裙四件套直营	man'wu'ren'sheng'chuang'qun'si'jian'tao'zhi'ying	0
毛巾挂钩	mao'jin'gua'gou	0
毛绒坐垫	mao'rong'zuo'dian	0
玫瑰花六件套	mei'gui'hua'liu'jian'tao	0
玫瑰花香枕	mei'gui'hua'xiang'zhen	0
玫瑰佳人床盖四件套砖红	mei'gui'jia'ren'chuang'gai'si'jian'tao'zhuan'hong	0
玫瑰佳人六件套砖红	mei'gui'jia'ren'liu'jian'tao'zhuan'hong	0
玫瑰佳人十件套大红	mei'gui'jia'ren'shi'jian'tao'da'hong	0
玫瑰佳人四件套砖红	mei'gui'jia'ren'si'jian'tao'zhuan'hong	0
玫瑰情缘床盖六件套粉直营	mei'gui'qing'yuan'chuang'gai'liu'jian'tao'fen'zhi'ying	0
玫瑰誓言四件套大红	mei'gui'shi'yan'si'jian'tao'da'hong	0
玫瑰之恋八件套粉	mei'gui'zhi'lian'ba'jian'tao'fen	0
玫瑰之恋八件套粉红	mei'gui'zhi'lian'ba'jian'tao'fen'hong	0
玫瑰之恋八件套米黄	mei'gui'zhi'lian'ba'jian'tao'mi'huang	0
玫瑰之恋八件套砖红	mei'gui'zhi'lian'ba'jian'tao'zhuan'hong	0
玫红蜜糖床单四件套	mei'hong'mi'tang'chuang'dan'si'jian'tao	0
魅力生活床单四件套	mei'li'sheng'huo'chuang'dan'si'jian'tao	0
魅力太空护颈枕	mei'li'tai'kong'hu'jing'zhen	0
美丽心情床单四件套	mei'li'xin'qing'chuang'dan'si'jian'tao	0
美伦美焕床盖四件套直营	mei'lun'mei'huan'chuang'gai'si'jian'tao'zhi'ying	0
美容三件套	mei'rong'san'jian'tao	0
美舍保洁垫	mei'she'bao'jie'dian	0
美舍床垫伴侣磨毛	mei'she'chuang'dian'ban'lv'mo'mao	0
美艳动人七件套	mei'yan'dong'ren'qi'jian'tao	0
梦幻型休闲蚊帐支架	meng'huan'xing'xiu'xian'wen'zhang'zhi'jia	0
梦幻型休闲帐	meng'huan'xing'xiu'xian'zhang	0
梦里花香四件套	meng'li'hua'xiang'si'jian'tao	0
梦恋澳洲羊毛被	meng'lian'ao'zhou'yang'mao'bei	0
梦之铂桑蚕丝被	meng'zhi'bo'sang'can'si'bei	0
梦之欢豪华四件套	meng'zhi'huan'hao'hua'si'jian'tao	0
梦之欢豪华四件套帝诺情怀	meng'zhi'huan'hao'hua'si'jian'tao'di'nuo'qing'huai	0
梦之欢豪华四件套芳香满园	meng'zhi'huan'hao'hua'si'jian'tao'fang'xiang'man'yuan	0
梦之欢豪华四件套花香心语	meng'zhi'huan'hao'hua'si'jian'tao'hua'xiang'xin'yu	0
梦之欢豪华四件套美艳动人	meng'zhi'huan'hao'hua'si'jian'tao'mei'yan'dong'ren	0
梦之欢豪华四件套明媚花颜	meng'zhi'huan'hao'hua'si'jian'tao'ming'mei'hua'yan	0
梦之欢豪华四件套牡丹花开红	meng'zhi'huan'hao'hua'si'jian'tao'mu'dan'hua'kai'hong	0
梦之欢豪华四件套牡丹花开紫	meng'zhi'huan'hao'hua'si'jian'tao'mu'dan'hua'kai'zi	0
梦之欢豪华四件套情定巴黎	meng'zhi'huan'hao'hua'si'jian'tao'qing'ding'ba'li	0
梦之金床单四件套	meng'zhi'jin'chuang'dan'si'jian'tao	0
梦之金纯桑蚕丝被	meng'zhi'jin'chun'sang'can'si'bei	0
梦之恋四件套粉	meng'zhi'lian'si'jian'tao'fen	0
梦之绿被套	meng'zhi'lv'bei'tao	0
梦之绿床单	meng'zhi'lv'chuang'dan	0
梦之绿床单四件套	meng'zhi'lv'chuang'dan'si'jian'tao	0
梦之绿床笠	meng'zhi'lv'chuang'li	0
梦之绿豪华四件套	meng'zhi'lv'hao'hua'si'jian'tao	0
梦之绿枕套	meng'zhi'lv'zhen'tao	0
梦之柔双丝被	meng'zhi'rou'shuang'si'bei	0
梦之瑞床单四件套	meng'zhi'rui'chuang'dan'si'jian'tao	0
梦之甜床单四件套	meng'zhi'tian'chuang'dan'si'jian'tao	0
梦之馨四件套	meng'zhi'xin'si'jian'tao	0
梦之馨休闲毯	meng'zhi'xin'xiu'xian'tan	0
梦之炫三件套	meng'zhi'xuan'san'jian'tao	0
梦之炫四件套	meng'zhi'xuan'si'jian'tao	0
梦之雅四件套	meng'zhi'ya'si'jian'tao	0
梦之悦夏凉被	meng'zhi'yue'xia'liang'bei	0
梦之钻加厚型桑蚕丝被	meng'zhi'zuan'jia'hou'xing'sang'can'si'bei	0
梦之钻桑蚕丝被	meng'zhi'zuan'sang'can'si'bei	0
梦之钻双丝被	meng'zhi'zuan'shuang'si'bei	0
迷迭香枕	mi'die'xiang'zhen	0
咪咪数星星四件套红	mi'mi'shu'xing'xing'si'jian'tao'hong	0
面巾平织支	mian'jin'ping'zhi'zhi	0
棉绒毯	mian'rong'tan	0
名流淑女蚊帐直营	ming'liu'shu'nv'wen'zhang'zhi'ying	0
茗香淑女九件套	ming'xiang'shu'nv'jiu'jian'tao	0
明星羊毛被	ming'xing'yang'mao'bei	0
摩登佳丽床笠四件套	mo'deng'jia'li'chuang'li'si'jian'tao	0
魔术屋钢丝蚊帐	mo'shu'wu'gang'si'wen'zhang	0
魔术屋蚊账支架	mo'shu'wu'wen'zhang'zhi'jia	0
墨舞韵彩床单四件套	mo'wu'yun'cai'chuang'dan'si'jian'tao	0
牡丹花开七件套红	mu'dan'hua'kai'qi'jian'tao'hong	0
牡丹花开七件套紫	mu'dan'hua'kai'qi'jian'tao'zi	0
牡丹花开四件套红	mu'dan'hua'kai'si'jian'tao'hong	0
牡丹花开四件套紫	mu'dan'hua'kai'si'jian'tao'zi	0
木棉香薰枕	mu'mian'xiang'xun'zhen	0
霓裳花羽四件套	ni'chang'hua'yu'si'jian'tao	0
宁静花开六件套	ning'jing'hua'kai'liu'jian'tao	0
宁静花开四件套	ning'jing'hua'kai'si'jian'tao	0
牛奶柔肤被	niu'nai'rou'fu'bei	0
牛奶纤柔被	niu'nai'xian'rou'bei	0
暖冬被人人乐	nuan'dong'bei'ren'ren'le	0
欧典风格四件套	ou'dian'feng'ge'si'jian'tao	0
欧典风尚长枕套	ou'dian'feng'shang'chang'zhen'tao	0
欧典风尚床盖四件套	ou'dian'feng'shang'chuang'gai'si'jian'tao	0
欧蝶九件套	ou'die'jiu'jian'tao	0
欧风床裙四件套	ou'feng'chuang'qun'si'jian'tao	0
欧风纯棉四件套	ou'feng'chun'mian'si'jian'tao	0
欧风纯棉四件套爱的寓意	ou'feng'chun'mian'si'jian'tao'ai'de'yu'yi	0
欧风纯棉四件套纯正优雅	ou'feng'chun'mian'si'jian'tao'chun'zheng'you'ya	0
欧风纯棉四件套大红玫瑰誓言	ou'feng'chun'mian'si'jian'tao'da'hong'mei'gui'shi'yan	0
欧风纯棉四件套帝诺情怀	ou'feng'chun'mian'si'jian'tao'di'nuo'qing'huai	0
欧风纯棉四件套典雅玫瑰	ou'feng'chun'mian'si'jian'tao'dian'ya'mei'gui	0
欧风纯棉四件套都市精灵	ou'feng'chun'mian'si'jian'tao'du'shi'jing'ling	0
欧风纯棉四件套粉	ou'feng'chun'mian'si'jian'tao'fen	0
欧风纯棉四件套红	ou'feng'chun'mian'si'jian'tao'hong	0
欧风纯棉四件套花间小栖粉	ou'feng'chun'mian'si'jian'tao'hua'jian'xiao'qi'fen	0
欧风纯棉四件套花间小栖蓝	ou'feng'chun'mian'si'jian'tao'hua'jian'xiao'qi'lan	0
欧风纯棉四件套花妍风韵	ou'feng'chun'mian'si'jian'tao'hua'yan'feng'yun	0
欧风纯棉四件套花雨朦胧	ou'feng'chun'mian'si'jian'tao'hua'yu'meng'long	0
欧风纯棉四件套花语沁春红	ou'feng'chun'mian'si'jian'tao'hua'yu'qin'chun'hong	0
欧风纯棉四件套花语沁春蓝	ou'feng'chun'mian'si'jian'tao'hua'yu'qin'chun'lan	0
欧风纯棉四件套欢乐祝福	ou'feng'chun'mian'si'jian'tao'huan'le'zhu'fu	0
欧风纯棉四件套简约都市	ou'feng'chun'mian'si'jian'tao'jian'yue'du'shi	0
欧风纯棉四件套镜花缘红	ou'feng'chun'mian'si'jian'tao'jing'hua'yuan'hong	0
欧风纯棉四件套镜花缘紫	ou'feng'chun'mian'si'jian'tao'jing'hua'yuan'zi	0
欧风纯棉四件套蓝	ou'feng'chun'mian'si'jian'tao'lan	0
欧风纯棉四件套蓝调生活	ou'feng'chun'mian'si'jian'tao'lan'diao'sheng'huo	0
欧风纯棉四件套浪漫格调	ou'feng'chun'mian'si'jian'tao'lang'man'ge'diao	0
欧风纯棉四件套律动咖啡	ou'feng'chun'mian'si'jian'tao'lv'dong'ka'fei	0
欧风纯棉四件套绿光森林	ou'feng'chun'mian'si'jian'tao'lv'guang'sen'lin	0
欧风纯棉四件套梦里花香	ou'feng'chun'mian'si'jian'tao'meng'li'hua'xiang	0
欧风纯棉四件套霓裳花羽	ou'feng'chun'mian'si'jian'tao'ni'chang'hua'yu	0
欧风纯棉四件套浓请玫瑰	ou'feng'chun'mian'si'jian'tao'nong'qing'mei'gui	0
欧风纯棉四件套欧风时尚	ou'feng'chun'mian'si'jian'tao'ou'feng'shi'shang	0
欧风纯棉四件套品味生活	ou'feng'chun'mian'si'jian'tao'pin'wei'sheng'huo	0
欧风纯棉四件套倾城佳人	ou'feng'chun'mian'si'jian'tao'qing'cheng'jia'ren	0
欧风纯棉四件套清风似梦	ou'feng'chun'mian'si'jian'tao'qing'feng'si'meng	0
欧风纯棉四件套情感基调	ou'feng'chun'mian'si'jian'tao'qing'gan'ji'diao	0
欧风纯棉四件套清香	ou'feng'chun'mian'si'jian'tao'qing'xiang	0
欧风纯棉四件套身临其境	ou'feng'chun'mian'si'jian'tao'shen'lin'qi'jing	0
欧风纯棉四件套世纪之恋	ou'feng'chun'mian'si'jian'tao'shi'ji'zhi'lian	0
欧风纯棉四件套水灵佳人	ou'feng'chun'mian'si'jian'tao'shui'ling'jia'ren	0
欧风纯棉四件套陶醉	ou'feng'chun'mian'si'jian'tao'tao'zui	0
欧风纯棉四件套温馨家园	ou'feng'chun'mian'si'jian'tao'wen'xin'jia'yuan	0
欧风纯棉四件套夏花的森林	ou'feng'chun'mian'si'jian'tao'xia'hua'de'sen'lin	0
欧风纯棉四件套香奈儿黄	ou'feng'chun'mian'si'jian'tao'xiang'nai'er'huang	0
欧风纯棉四件套向阳花开	ou'feng'chun'mian'si'jian'tao'xiang'yang'hua'kai	0
欧风纯棉四件套小象帕特黄	ou'feng'chun'mian'si'jian'tao'xiao'xiang'pa'te'huang	0
欧风纯棉四件套小小爱乐园	ou'feng'chun'mian'si'jian'tao'xiao'xiao'ai'le'yuan	0
欧风纯棉四件套心悦玫瑰	ou'feng'chun'mian'si'jian'tao'xin'yue'mei'gui	0
欧风纯棉四件套幸福时光	ou'feng'chun'mian'si'jian'tao'xing'fu'shi'guang	0
欧风纯棉四件套雅致心语	ou'feng'chun'mian'si'jian'tao'ya'zhi'xin'yu	0
欧风纯棉四件套怡情叶姿	ou'feng'chun'mian'si'jian'tao'yi'qing'ye'zi	0
欧风纯棉四件套茵茵花香	ou'feng'chun'mian'si'jian'tao'yin'yin'hua'xiang	0
欧风纯棉四件套永恒经典	ou'feng'chun'mian'si'jian'tao'yong'heng'jing'dian	0
欧风纯棉四件套优雅恋歌	ou'feng'chun'mian'si'jian'tao'you'ya'lian'ge	0
欧风纯棉四件套真挚情感	ou'feng'chun'mian'si'jian'tao'zhen'zhi'qing'gan	0
欧风纯棉四件套砖红爱的乐园	ou'feng'chun'mian'si'jian'tao'zhuan'hong'ai'de'le'yuan	0
欧风纯棉四件套紫	ou'feng'chun'mian'si'jian'tao'zi	0
欧普艺术床单四件套	ou'pu'yi'shu'chuang'dan'si'jian'tao	0
欧式精纺纯棉四件套	ou'shi'jing'fang'chun'mian'si'jian'tao	0
片片真情八件套粉	pian'pian'zhen'qing'ba'jian'tao'fen	0
片片真情八件套粉红	pian'pian'zhen'qing'ba'jian'tao'fen'hong	0
片片真情八件套米白	pian'pian'zhen'qing'ba'jian'tao'mi'bai	0
片片真情八件套砖红	pian'pian'zhen'qing'ba'jian'tao'zhuan'hong	0
片片真情八件套砖红直营	pian'pian'zhen'qing'ba'jian'tao'zhuan'hong'zhi'ying	0
片片真情床罩八件套砖红	pian'pian'zhen'qing'chuang'zhao'ba'jian'tao'zhuan'hong	0
翩若惊鸿灰白床盖十件套	pian'ruo'jing'hong'hui'bai'chuang'gai'shi'jian'tao	0
飘香床单四件套	piao'xiang'chuang'dan'si'jian'tao	0
拼花工艺竹凉席	pin'hua'gong'yi'zhu'liang'xi	0
拼花工艺竹坐垫	pin'hua'gong'yi'zhu'zuo'dian	0
拼花三人坐垫	pin'hua'san'ren'zuo'dian	0
品味生活四件套	pin'wei'sheng'huo'si'jian'tao	0
苹果乐园纯棉被套	ping'guo'le'yuan'chun'mian'bei'tao	0
苹果乐园三件套	ping'guo'le'yuan'san'jian'tao	0
七孔呼吸枕	qi'kong'hu'xi'zhen	0
七里香四件套	qi'li'xiang'si'jian'tao	0
七色彩虹床单四件套	qi'se'cai'hong'chuang'dan'si'jian'tao	0
七色彩虹床笠四件套	qi'se'cai'hong'chuang'li'si'jian'tao	0
千禧玫瑰大红床盖六件套直营	qian'xi'mei'gui'da'hong'chuang'gai'liu'jian'tao'zhi'ying	0
蔷薇之恋四件套	qiang'wei'zhi'lian'si'jian'tao	0
荞麦定型枕	qiao'mai'ding'xing'zhen	0
荞麦壳定型枕	qiao'mai'ke'ding'xing'zhen	0
荞麦壳枕	qiao'mai'ke'zhen	0
巧韵八件套粉	qiao'yun'ba'jian'tao'fen	0
亲肤棉花薄被直营	qin'fu'mian'hua'bo'bei'zhi'ying	0
亲肤棉绒四季毯	qin'fu'mian'rong'si'ji'tan	0
倾城之恋八件套粉红	qing'cheng'zhi'lian'ba'jian'tao'fen'hong	0
倾城之恋八件套米白	qing'cheng'zhi'lian'ba'jian'tao'mi'bai	0
情定巴黎七件套	qing'ding'ba'li'qi'jian'tao	0
情定巴黎四件套	qing'ding'ba'li'si'jian'tao	0
情定花都床单四件套	qing'ding'hua'du'chuang'dan'si'jian'tao	0
情动时分四件套	qing'dong'shi'fen'si'jian'tao	0
晴风暖意床笠四件套	qing'feng'nuan'yi'chuang'li'si'jian'tao	0
清风似梦四件套	qing'feng'si'meng'si'jian'tao	0
情感基调四件套	qing'gan'ji'diao'si'jian'tao	0
清凉薄荷夏被	qing'liang'bo'he'xia'bei	0
清凉雅草童席	qing'liang'ya'cao'tong'xi	0
清凉雅草席	qing'liang'ya'cao'xi	0
清凉竹青席	qing'liang'zhu'qing'xi	0
情迷布拉格床盖四件套直营	qing'mi'bu'la'ge'chuang'gai'si'jian'tao'zhi'ying	0
情迷英伦床盖八件套	qing'mi'ying'lun'chuang'gai'ba'jian'tao	0
轻舞飞扬六件套砖红	qing'wu'fei'yang'liu'jian'tao'zhuan'hong	0
轻舞飞扬四件套粉	qing'wu'fei'yang'si'jian'tao'fen	0
轻舞飞扬四件套砖红	qing'wu'fei'yang'si'jian'tao'zhuan'hong	0
情系芊芊八件套	qing'xi'qian'qian'ba'jian'tao	0
清新芙蓉四件套	qing'xin'fu'rong'si'jian'tao	0
清馨竹炭枕	qing'xin'zhu'tan'zhen	0
清雅羽丝绒夏凉被	qing'ya'yu'si'rong'xia'liang'bei	0
清雅竹香枕直营	qing'ya'zhu'xiang'zhen'zhi'ying	0
情意绵绵七件套	qing'yi'mian'mian'qi'jian'tao	0
情意绵绵四件套	qing'yi'mian'mian'si'jian'tao	0
情意绵绵蚊账伊尔曼	qing'yi'mian'mian'wen'zhang'yi'er'man	0
清逸夏凉被	qing'yi'xia'liang'bei	0
秋水伊人床单四件套直营	qiu'shui'yi'ren'chuang'dan'si'jian'tao'zhi'ying	0
秋水伊人天丝床单四件套	qiu'shui'yi'ren'tian'si'chuang'dan'si'jian'tao	0
趣味童年四件套	qu'wei'tong'nian'si'jian'tao	0
全棉缎格系列四件套	quan'mian'duan'ge'xi'lie'si'jian'tao	0
全棉缎条系列四件套	quan'mian'duan'tiao'xi'lie'si'jian'tao	0
全棉锻条系列四件套	quan'mian'duan'tiao'xi'lie'si'jian'tao	0
全棉贡缎提花系列四件套	quan'mian'gong'duan'ti'hua'xi'lie'si'jian'tao	0
全棉贡缎系列四件套	quan'mian'gong'duan'xi'lie'si'jian'tao	0
全棉加密锻条系列四件套	quan'mian'jia'mi'duan'tiao'xi'lie'si'jian'tao	0
全棉平纹系列四件套	quan'mian'ping'wen'xi'lie'si'jian'tao	0
全棉平纹印花桑拿浴衣	quan'mian'ping'wen'yin'hua'sang'na'yu'yi	0
全棉平纹印花系列四件套	quan'mian'ping'wen'yin'hua'xi'lie'si'jian'tao	0
全棉斜纹系列四件套	quan'mian'xie'wen'xi'lie'si'jian'tao	0
全伸缩道轨式纯钢蚊帐支架	quan'shen'suo'dao'gui'shi'chun'gang'wen'zhang'zhi'jia	0
全伸缩道轨式蚊帐	quan'shen'suo'dao'gui'shi'wen'zhang	0
全伸缩道轨式帐身	quan'shen'suo'dao'gui'shi'zhang'shen	0
全新羊毛洁冬被	quan'xin'yang'mao'jie'dong'bei	0
日式儿童荞麦枕	ri'shi'er'tong'qiao'mai'zhen	0
日式精工草艺席	ri'shi'jing'gong'cao'yi'xi	0
日式精工草艺枕席	ri'shi'jing'gong'cao'yi'zhen'xi	0
日式婴儿草艺席	ri'shi'ying'er'cao'yi'xi	0
融意情情八件套	rong'yi'qing'qing'ba'jian'tao	0
柔美浪漫蚊帐	rou'mei'lang'man'wen'zhang	0
柔美浪漫蚊帐支架	rou'mei'lang'man'wen'zhang'zhi'jia	0
柔暖羽丝绒被	rou'nuan'yu'si'rong'bei	0
柔丝珍珠被人人乐	rou'si'zhen'zhu'bei'ren'ren'le	0
柔松长枕	rou'song'chang'zhen	0
柔松短枕	rou'song'duan'zhen	0
乳胶垫	ru'jiao'dian	0
如梦令灰床单四件套特	ru'meng'ling'hui'chuang'dan'si'jian'tao'te	0
如梦令浅黄床单四件套特	ru'meng'ling'qian'huang'chuang'dan'si'jian'tao'te	0
如意多用凉枕	ru'yi'duo'yong'liang'zhen	0
软床	ruan'chuang	0
软大水枕	ruan'da'shui'zhen	0
软水枕垫	ruan'shui'zhen'dian	0
软水坐垫	ruan'shui'zuo'dian	0
软小水枕	ruan'xiao'shui'zhen	0
润泽玉面席三件套	run'ze'yu'mian'xi'san'jian'tao	0
赛藤席三件套促销品	sai'teng'xi'san'jian'tao'cu'xiao'pin	0
赛藤席三件套款	sai'teng'xi'san'jian'tao'kuan	0
赛维床垫	sai'wei'chuang'dian	0
赛羽绒被	sai'yu'rong'bei	0
赛羽丝绒长枕	sai'yu'si'rong'chang'zhen	0
赛羽丝绒枕	sai'yu'si'rong'zhen	0
散花坊四件套	san'hua'fang'si'jian'tao	0
三人电热毯	san'ren'dian're'tan	0
伞式蚊帐	san'shi'wen'zhang	0
三维护颈枕	san'wei'hu'jing'zhen	0
三维中空棉被	san'wei'zhong'kong'mian'bei	0
散装长枕套	san'zhuang'chang'zhen'tao	0
散装短枕套	san'zhuang'duan'zhen'tao	0
桑蚕丝冬被	sang'can'si'dong'bei	0
沙发长水垫	sha'fa'chang'shui'dian	0
莎莉亚天丝床单四件套	sha'li'ya'tian'si'chuang'dan'si'jian'tao	0
珊瑚绒抱枕	shan'hu'rong'bao'zhen	0
神话床单四件套	shen'hua'chuang'dan'si'jian'tao	0
身临其境四件套	shen'lin'qi'jing'si'jian'tao	0
神秘园床单四件套	shen'mi'yuan'chuang'dan'si'jian'tao	0
绅士情怀四件套	shen'shi'qing'huai'si'jian'tao	0
深邃咖调床单四件套直营	shen'sui'ka'tiao'chuang'dan'si'jian'tao'zhi'ying	0
深邃咖调床笠四件套直营	shen'sui'ka'tiao'chuang'li'si'jian'tao'zhi'ying	0
生活点滴长枕套	sheng'huo'dian'di'chang'zhen'tao	0
生活点滴床盖四件套	sheng'huo'dian'di'chuang'gai'si'jian'tao	0
圣露床垫	sheng'lu'chuang'dian	0
盛世王朝大红床盖六件套	sheng'shi'wang'chao'da'hong'chuang'gai'liu'jian'tao	0
生态快眠枕	sheng'tai'kuai'mian'zhen	0
生态暖肤被	sheng'tai'nuan'fu'bei	0
生态亲肤席	sheng'tai'qin'fu'xi	0
生态亲肤枕套	sheng'tai'qin'fu'zhen'tao	0
时光琉璃床单四件套	shi'guang'liu'li'chuang'dan'si'jian'tao	0
世纪恋情六件套	shi'ji'lian'qing'liu'jian'tao	0
世纪恋情四件套	shi'ji'lian'qing'si'jian'tao	0
十孔春秋被	shi'kong'chun'qiu'bei	0
十孔暖冬被大润发	shi'kong'nuan'dong'bei'da'run'fa	0
十孔暖绒被纯棉面料	shi'kong'nuan'rong'bei'chun'mian'mian'liao	0
十孔舒雅被人人乐	shi'kong'shu'ya'bei'ren'ren'le	0
十孔枕	shi'kong'zhen	0
时尚定型枕	shi'shang'ding'xing'zhen	0
时尚方抱枕	shi'shang'fang'bao'zhen	0
时尚简约床笠四件套斑斓色彩	shi'shang'jian'yue'chuang'li'si'jian'tao'ban'lan'se'cai	0
时尚简约床笠四件套美妙眷恋	shi'shang'jian'yue'chuang'li'si'jian'tao'mei'miao'juan'lian	0
时尚简约床笠四件套闲静花舞	shi'shang'jian'yue'chuang'li'si'jian'tao'xian'jing'hua'wu	0
时尚节拍床单四件套	shi'shang'jie'pai'chuang'dan'si'jian'tao	0
时尚节拍七件套	shi'shang'jie'pai'qi'jian'tao	0
时尚空间纯棉四件套	shi'shang'kong'jian'chun'mian'si'jian'tao	0
时尚空间四件套	shi'shang'kong'jian'si'jian'tao	0
时尚空间四件套爱的见证	shi'shang'kong'jian'si'jian'tao'ai'de'jian'zheng	0
时尚空间四件套纯爱	shi'shang'kong'jian'si'jian'tao'chun'ai	0
时尚空间四件套花妍风韵	shi'shang'kong'jian'si'jian'tao'hua'yan'feng'yun	0
时尚空间四件套欢乐祝福	shi'shang'kong'jian'si'jian'tao'huan'le'zhu'fu	0
时尚空间四件套浪漫思语	shi'shang'kong'jian'si'jian'tao'lang'man'si'yu	0
时尚空间四件套律动咖啡	shi'shang'kong'jian'si'jian'tao'lv'dong'ka'fei	0
时尚空间四件套满香庭	shi'shang'kong'jian'si'jian'tao'man'xiang'ting	0
时尚空间四件套美味香橙	shi'shang'kong'jian'si'jian'tao'mei'wei'xiang'cheng	0
时尚空间四件套欧风时尚	shi'shang'kong'jian'si'jian'tao'ou'feng'shi'shang	0
时尚空间四件套时尚生活	shi'shang'kong'jian'si'jian'tao'shi'shang'sheng'huo	0
时尚空间四件套无花号	shi'shang'kong'jian'si'jian'tao'wu'hua'hao	0
时尚空间四件套小象帕特粉	shi'shang'kong'jian'si'jian'tao'xiao'xiang'pa'te'fen	0
时尚空间四件套幸福时光	shi'shang'kong'jian'si'jian'tao'xing'fu'shi'guang	0
时尚空间四件套茵茵花香红	shi'shang'kong'jian'si'jian'tao'yin'yin'hua'xiang'hong	0
时尚空间四件套茵茵花香玉	shi'shang'kong'jian'si'jian'tao'yin'yin'hua'xiang'yu	0
时尚空间四件套茵茵花香紫	shi'shang'kong'jian'si'jian'tao'yin'yin'hua'xiang'zi	0
时尚毛毯	shi'shang'mao'tan	0
时尚蒙古包蚊帐	shi'shang'meng'gu'bao'wen'zhang	0
时尚密码床盖四件套直营	shi'shang'mi'ma'chuang'gai'si'jian'tao'zhi'ying	0
时尚兔床单三件套直营	shi'shang'tu'chuang'dan'san'jian'tao'zhi'ying	0
时尚休闲垫	shi'shang'xiu'xian'dian	0
时尚旋律床盖十件套直营	shi'shang'xuan'lv'chuang'gai'shi'jian'tao'zhi'ying	0
时尚雅草席	shi'shang'ya'cao'xi	0
时尚印花被套	shi'shang'yin'hua'bei'tao	0
时尚印花床单	shi'shang'yin'hua'chuang'dan	0
时尚印花三件套	shi'shang'yin'hua'san'jian'tao	0
时尚印花四件套	shi'shang'yin'hua'si'jian'tao	0
舒肤绒四季毯	shu'fu'rong'si'ji'tan	0
舒眠羽绒枕	shu'mian'yu'rong'zhen	0
舒柔安眠枕	shu'rou'an'mian'zhen	0
舒柔被直营	shu'rou'bei'zhi'ying	0
舒柔亲肤被人人乐	shu'rou'qin'fu'bei'ren'ren'le	0
舒柔羽丝绒枕	shu'rou'yu'si'rong'zhen	0
舒适抱枕	shu'shi'bao'zhen	0
舒适被	shu'shi'bei	0
舒适长枕枕送套	shu'shi'chang'zhen'zhen'song'tao	0
舒适怀贝被人人乐	shu'shi'huai'bei'bei'ren'ren'le	0
舒适温床被	shu'shi'wen'chuang'bei	0
舒适温馨被	shu'shi'wen'xin'bei	0
舒适型毛巾被	shu'shi'xing'mao'jin'bei	0
舒压美眠枕	shu'ya'mei'mian'zhen	0
双层超柔中童毛毯	shuang'ceng'chao'rou'zhong'tong'mao'tan	0
双人电热毯	shuang'ren'dian're'tan	0
双丝尊享薄被直营	shuang'si'zun'xiang'bo'bei'zhi'ying	0
水晶之恋八件套	shui'jing'zhi'lian'ba'jian'tao	0
水晶之恋床盖八件套粉	shui'jing'zhi'lian'chuang'gai'ba'jian'tao'fen	0
水灵佳人四件套	shui'ling'jia'ren'si'jian'tao	0
水坐垫	shui'zuo'dian	0
丝光流影幻彩床单四件套特	si'guang'liu'ying'huan'cai'chuang'dan'si'jian'tao'te	0
四季如春八件套粉红	si'ji'ru'chun'ba'jian'tao'fen'hong	0
四季如春八件套砖红	si'ji'ru'chun'ba'jian'tao'zhuan'hong	0
四件套	si'jian'tao	0
四件套大红	si'jian'tao'da'hong	0
四件套粉红	si'jian'tao'fen'hong	0
四件套兰	si'jian'tao'lan	0
四件套血青	si'jian'tao'xue'qing	0
四件套玉	si'jian'tao'yu	0
丝柔亲肤被	si'rou'qin'fu'bei	0
似水流年四件套	si'shui'liu'nian'si'jian'tao	0
似水年华床笠四件套	si'shui'nian'hua'chuang'li'si'jian'tao	0
丝逸柔肤薄被直营	si'yi'rou'fu'bo'bei'zhi'ying	0
丝逸竹纤维薄被直营	si'yi'zhu'xian'wei'bo'bei'zhi'ying	0
思雨九件套	si'yu'jiu'jian'tao	0
素色刺绣四件套花语情丝	su'se'ci'xiu'si'jian'tao'hua'yu'qing'si	0
素色绣花四季被	su'se'xiu'hua'si'ji'bei	0
素雅毛巾被	su'ya'mao'jin'bei	0
岁月如梭床单四件套	sui'yue'ru'suo'chuang'dan'si'jian'tao	0
泰式宽板竹凉席	tai'shi'kuan'ban'zhu'liang'xi	0
泰式宽板竹凉席款	tai'shi'kuan'ban'zhu'liang'xi'kuan	0
泰式宽板竹凉枕套	tai'shi'kuan'ban'zhu'liang'zhen'tao	0
烫钻腰枕	tang'zuan'yao'zhen	0
涛声依旧粉床盖六件套	tao'sheng'yi'jiu'fen'chuang'gai'liu'jian'tao	0
特价抱枕	te'jia'bao'zhen	0
特价冬被外贸	te'jia'dong'bei'wai'mao	0
特价毛巾被外贸	te'jia'mao'jin'bei'wai'mao	0
特价舒适枕送枕套	te'jia'shu'shi'zhen'song'zhen'tao	0
提花涤纶方帐	ti'hua'di'lun'fang'zhang	0
提花桑拿浴衣	ti'hua'sang'na'yu'yi	0
天鹅绒决明子枕	tian'e'rong'jue'ming'zi'zhen	0
天鹅绒舒柔枕	tian'e'rong'shu'rou'zhen	0
恬静七件套红	tian'jing'qi'jian'tao'hong	0
恬静七件套紫	tian'jing'qi'jian'tao'zi	0
天籁之恋六件套	tian'lai'zhi'lian'liu'jian'tao	0
天籁之恋四件套	tian'lai'zhi'lian'si'jian'tao	0
恬美新柔被	tian'mei'xin'rou'bei	0
天然乳胶按摩枕	tian'ran'ru'jiao'an'mo'zhen	0
天然乳胶呼吸枕	tian'ran'ru'jiao'hu'xi'zhen	0
天然羊毛春秋被	tian'ran'yang'mao'chun'qiu'bei	0
天使花园床单三件套直营	tian'shi'hua'yuan'chuang'dan'san'jian'tao'zhi'ying	0
天使花园床单四件套直营	tian'shi'hua'yuan'chuang'dan'si'jian'tao'zhi'ying	0
天丝床单四件套梦的点滴	tian'si'chuang'dan'si'jian'tao'meng'de'dian'di	0
天丝柔肤夏被	tian'si'rou'fu'xia'bei	0
天丝印花薄被直营	tian'si'yin'hua'bo'bei'zhi'ying	0
天丝印花床单四件套	tian'si'yin'hua'chuang'dan'si'jian'tao	0
天丝枕套直营	tian'si'zhen'tao'zhi'ying	0
田园风光纯棉五件套	tian'yuan'feng'guang'chun'mian'wu'jian'tao	0
田园风光纯棉五件套芙蓉	tian'yuan'feng'guang'chun'mian'wu'jian'tao'fu'rong	0
田园风光纯棉五件套红寻梦花园	tian'yuan'feng'guang'chun'mian'wu'jian'tao'hong'xun'meng'hua'yuan	0
田园风光纯棉五件套花香心语	tian'yuan'feng'guang'chun'mian'wu'jian'tao'hua'xiang'xin'yu	0
田园风光纯棉五件套情定巴黎	tian'yuan'feng'guang'chun'mian'wu'jian'tao'qing'ding'ba'li	0
田园风光纯棉五件套情意绵绵	tian'yuan'feng'guang'chun'mian'wu'jian'tao'qing'yi'mian'mian	0
田园风光纯棉五件套绅士情怀	tian'yuan'feng'guang'chun'mian'wu'jian'tao'shen'shi'qing'huai	0
田园风光纯棉五件套幽香心语	tian'yuan'feng'guang'chun'mian'wu'jian'tao'you'xiang'xin'yu	0
田园风光纯棉五件套紫寻梦花园	tian'yuan'feng'guang'chun'mian'wu'jian'tao'zi'xun'meng'hua'yuan	0
贴芯蚕丝二合一被子母被	tie'xin'can'si'er'he'yi'bei'zi'mu'bei	0
贴心蚕丝棉被	tie'xin'can'si'mian'bei	0
贴心长枕套	tie'xin'chang'zhen'tao	0
贴芯休闲毯直营	tie'xin'xiu'xian'tan'zhi'ying	0
童趣卡通毯直营	tong'qu'ka'tong'tan'zhi'ying	0
兔女郎床单三件套直营	tu'nv'lang'chuang'dan'san'jian'tao'zhi'ying	0
外贸抱枕	wai'mao'bao'zhen	0
外贸围裙	wai'mao'wei'qun	0
外贸枕套兰	wai'mao'zhen'tao'lan	0
完美世界纯棉被套	wan'mei'shi'jie'chun'mian'bei'tao	0
完美世界纯棉床单	wan'mei'shi'jie'chun'mian'chuang'dan	0
完美世界纯棉床笠	wan'mei'shi'jie'chun'mian'chuang'li	0
完美世界纯棉床罩	wan'mei'shi'jie'chun'mian'chuang'zhao	0
完美世界纯棉短枕套	wan'mei'shi'jie'chun'mian'duan'zhen'tao	0
万年历笔筒	wan'nian'li'bi'tong	0
万事佳缘十件套红	wan'shi'jia'yuan'shi'jian'tao'hong	0
往昔床盖四件套	wang'xi'chuang'gai'si'jian'tao	0
维多利亚泡泡裙蚊账	wei'duo'li'ya'pao'pao'qun'wen'zhang	0
维多利亚蚊账帐身	wei'duo'li'ya'wen'zhang'zhang'shen	0
维多利亚蚊账支架玉色	wei'duo'li'ya'wen'zhang'zhi'jia'yu'shai	0
唯美床盖四件套	wei'mei'chuang'gai'si'jian'tao	0
维纳斯密语床单四件套热卖	wei'na'si'mi'yu'chuang'dan'si'jian'tao're'mai	0
维尼熊	wei'ni'xiong	0
温馨纯棉被套	wen'xin'chun'mian'bei'tao	0
温馨纯棉长枕套	wen'xin'chun'mian'chang'zhen'tao	0
温馨纯棉床单	wen'xin'chun'mian'chuang'dan	0
温馨纯棉床笠	wen'xin'chun'mian'chuang'li	0
温馨纯棉床罩	wen'xin'chun'mian'chuang'zhao	0
温馨纯棉短枕套	wen'xin'chun'mian'duan'zhen'tao	0
温馨怀贝被	wen'xin'huai'bei'bei	0
温馨家园七件套	wen'xin'jia'yuan'qi'jian'tao	0
温馨家园四件套	wen'xin'jia'yuan'si'jian'tao	0
温馨满屋床盖四件套雪青	wen'xin'man'wu'chuang'gai'si'jian'tao'xue'qing	0
温馨满屋床盖四件套砖红	wen'xin'man'wu'chuang'gai'si'jian'tao'zhuan'hong	0
温馨满屋六件套血青	wen'xin'man'wu'liu'jian'tao'xue'qing	0
温馨满屋六件套砖红	wen'xin'man'wu'liu'jian'tao'zhuan'hong	0
温馨满屋四件套雪青	wen'xin'man'wu'si'jian'tao'xue'qing	0
温馨满屋四件套砖红	wen'xin'man'wu'si'jian'tao'zhuan'hong	0
温馨柔棉毛巾被	wen'xin'rou'mian'mao'jin'bei	0
温馨之家四件套	wen'xin'zhi'jia'si'jian'tao	0
温馨至家四件套	wen'xin'zhi'jia'si'jian'tao	0
蚊帐钩	wen'zhang'gou	0
悟床罩四件套	wu'chuang'zhao'si'jian'tao	0
无纺布陈列枕	wu'fang'bu'chen'lie'zhen	0
无纺布真空短枕陈列专用	wu'fang'bu'zhen'kong'duan'zhen'chen'lie'zhuan'yong	0
妩媚动人八件套砖红	wu'mei'dong'ren'ba'jian'tao'zhuan'hong	0
细旦羽丝绒怀贝被	xi'dan'yu'si'rong'huai'bei'bei	0
希腊风情床盖四件套直营	xi'la'feng'qing'chuang'gai'si'jian'tao'zhi'ying	0
茜茜公主八件套大红	xi'xi'gong'zhu'ba'jian'tao'da'hong	0
茜茜公主八件套粉红	xi'xi'gong'zhu'ba'jian'tao'fen'hong	0
茜茜公主八件套砖红	xi'xi'gong'zhu'ba'jian'tao'zhuan'hong	0
喜洋洋与灰太狼黄床笠三件套	xi'yang'yang'yu'hui'tai'lang'huang'chuang'li'san'jian'tao	0
喜洋洋与灰太狼黄床笠四件套	xi'yang'yang'yu'hui'tai'lang'huang'chuang'li'si'jian'tao	0
细雨柔情天丝床单四件套	xi'yu'rou'qing'tian'si'chuang'dan'si'jian'tao	0
夏花的森林四件套	xia'hua'de'sen'lin'si'jian'tao	0
夏凉被	xia'liang'bei	0
纤羽蚕丝夏凉被	xian'yu'can'si'xia'liang'bei	0
香草枕	xiang'cao'zhen	0
香奈儿四件套黄	xiang'nai'er'si'jian'tao'huang	0
相亲相爱大红床盖八件套直营	xiang'qin'xiang'ai'da'hong'chuang'gai'ba'jian'tao'zhi'ying	0
香水百合八件套粉	xiang'shui'bai'he'ba'jian'tao'fen	0
香水百合六件套	xiang'shui'bai'he'liu'jian'tao	0
香水百合四件套	xiang'shui'bai'he'si'jian'tao	0
香熏甜梦枕	xiang'xun'tian'meng'zhen	0
香薰植物夏凉枕	xiang'xun'zhi'wu'xia'liang'zhen	0
香雨风情床单四件套	xiang'yu'feng'qing'chuang'dan'si'jian'tao	0
相约永恒七件套白	xiang'yue'yong'heng'qi'jian'tao'bai	0
相约永恒七件套粉	xiang'yue'yong'heng'qi'jian'tao'fen	0
香韵蚕丝冬被	xiang'yun'can'si'dong'bei	0
香韵蚕丝冬被人人乐	xiang'yun'can'si'dong'bei'ren'ren'le	0
肖邦夜曲床单四件套	xiao'bang'ye'qu'chuang'dan'si'jian'tao	0
小号无纺布袋	xiao'hao'wu'fang'bu'dai	0
小蜜蜂枕	xiao'mi'feng'zhen	0
小水枕	xiao'shui'zhen	0
校园床品套装	xiao'yuan'chuang'pin'tao'zhuang	0
斜纹独幅三件套	xie'wen'du'fu'san'jian'tao	0
斜纹独幅四件套	xie'wen'du'fu'si'jian'tao	0
斜纹九孔蚕丝春秋被	xie'wen'jiu'kong'can'si'chun'qiu'bei	0
斜纹三件套	xie'wen'san'jian'tao	0
斜纹三件套粉蝴蝶飞飞	xie'wen'san'jian'tao'fen'hu'die'fei'fei	0
斜纹三件套高支棉	xie'wen'san'jian'tao'gao'zhi'mian	0
斜纹三件套红	xie'wen'san'jian'tao'hong	0
斜纹三件套花间小栖粉蓝	xie'wen'san'jian'tao'hua'jian'xiao'qi'fen'lan	0
斜纹三件套欢乐祝福	xie'wen'san'jian'tao'huan'le'zhu'fu	0
斜纹三件套简约都市	xie'wen'san'jian'tao'jian'yue'du'shi	0
斜纹三件套蓝	xie'wen'san'jian'tao'lan	0
斜纹三件套薰衣草	xie'wen'san'jian'tao'xun'yi'cao	0
斜纹三件套一包搞定	xie'wen'san'jian'tao'yi'bao'gao'ding	0
斜纹四件套	xie'wen'si'jian'tao	0
心动花园床盖四件套砖红	xin'dong'hua'yuan'chuang'gai'si'jian'tao'zhuan'hong	0
心动花园六件套粉	xin'dong'hua'yuan'liu'jian'tao'fen	0
心动花园六件套雪青	xin'dong'hua'yuan'liu'jian'tao'xue'qing	0
心动花园六件套砖红	xin'dong'hua'yuan'liu'jian'tao'zhuan'hong	0
心动花园四件套粉	xin'dong'hua'yuan'si'jian'tao'fen	0
心动花园四件套雪青	xin'dong'hua'yuan'si'jian'tao'xue'qing	0
心动花园四件套砖红	xin'dong'hua'yuan'si'jian'tao'zhuan'hong	0
信封活套枕送枕套	xin'feng'huo'tao'zhen'song'zhen'tao	0
新风尚纯棉四件套	xin'feng'shang'chun'mian'si'jian'tao	0
新风尚纯棉四件套芳香满园	xin'feng'shang'chun'mian'si'jian'tao'fang'xiang'man'yuan	0
新风尚纯棉四件套格雅生活	xin'feng'shang'chun'mian'si'jian'tao'ge'ya'sheng'huo	0
新风尚纯棉四件套果绿盈香	xin'feng'shang'chun'mian'si'jian'tao'guo'lv'ying'xiang	0
新风尚纯棉四件套红	xin'feng'shang'chun'mian'si'jian'tao'hong	0
新风尚纯棉四件套蝴蝶飞飞红	xin'feng'shang'chun'mian'si'jian'tao'hu'die'fei'fei'hong	0
新风尚纯棉四件套花情摇曳	xin'feng'shang'chun'mian'si'jian'tao'hua'qing'yao'ye	0
新风尚纯棉四件套镜花缘红	xin'feng'shang'chun'mian'si'jian'tao'jing'hua'yuan'hong	0
新风尚纯棉四件套镜花缘紫	xin'feng'shang'chun'mian'si'jian'tao'jing'hua'yuan'zi	0
新风尚纯棉四件套浪漫格调咖	xin'feng'shang'chun'mian'si'jian'tao'lang'man'ge'diao'ka	0
新风尚纯棉四件套梦里花香	xin'feng'shang'chun'mian'si'jian'tao'meng'li'hua'xiang	0
新风尚纯棉四件套明媚花颜	xin'feng'shang'chun'mian'si'jian'tao'ming'mei'hua'yan	0
新风尚纯棉四件套片片情绿	xin'feng'shang'chun'mian'si'jian'tao'pian'pian'qing'lv	0
新风尚纯棉四件套品味生活	xin'feng'shang'chun'mian'si'jian'tao'pin'wei'sheng'huo	0
新风尚纯棉四件套情定巴黎	xin'feng'shang'chun'mian'si'jian'tao'qing'ding'ba'li	0
新风尚纯棉四件套清风似梦红	xin'feng'shang'chun'mian'si'jian'tao'qing'feng'si'meng'hong	0
新风尚纯棉四件套绅士情怀	xin'feng'shang'chun'mian'si'jian'tao'shen'shi'qing'huai	0
新风尚纯棉四件套诗谛百兰	xin'feng'shang'chun'mian'si'jian'tao'shi'di'bai'lan	0
新风尚纯棉四件套昔日再现蓝	xin'feng'shang'chun'mian'si'jian'tao'xi'ri'zai'xian'lan	0
新风尚纯棉四件套小家碧玉	xin'feng'shang'chun'mian'si'jian'tao'xiao'jia'bi'yu	0
新风尚纯棉四件套寻梦花园	xin'feng'shang'chun'mian'si'jian'tao'xun'meng'hua'yuan	0
新风尚纯棉四件套怡情叶姿	xin'feng'shang'chun'mian'si'jian'tao'yi'qing'ye'zi	0
新风尚纯棉四件套悠闲生活红	xin'feng'shang'chun'mian'si'jian'tao'you'xian'sheng'huo'hong	0
新风尚纯棉四件套悠闲生活蓝	xin'feng'shang'chun'mian'si'jian'tao'you'xian'sheng'huo'lan	0
新风尚纯棉四件套杂花热卖品	xin'feng'shang'chun'mian'si'jian'tao'za'hua're'mai'pin	0
新风尚纯棉四件套紫	xin'feng'shang'chun'mian'si'jian'tao'zi	0
新风尚纯棉四件套字母风情红	xin'feng'shang'chun'mian'si'jian'tao'zi'mu'feng'qing'hong	0
新风尚纯棉四件套字母风情灰	xin'feng'shang'chun'mian'si'jian'tao'zi'mu'feng'qing'hui	0
新概念四件套灰	xin'gai'nian'si'jian'tao'hui	0
新贵蚕丝被	xin'gui'can'si'bei	0
新贵床单四件套	xin'gui'chuang'dan'si'jian'tao	0
新贵软牛皮席直营	xin'gui'ruan'niu'pi'xi'zhi'ying	0
新贵软牛皮枕套直营	xin'gui'ruan'niu'pi'zhen'tao'zhi'ying	0
芯花枕	xin'hua'zhen	0
心情小屋四件套	xin'qing'xiao'wu'si'jian'tao	0
馨香床盖四件套	xin'xiang'chuang'gai'si'jian'tao	0
馨香恋人八件套	xin'xiang'lian'ren'ba'jian'tao	0
心心相印八件套粉	xin'xin'xiang'yin'ba'jian'tao'fen	0
心心相印八件套粉红	xin'xin'xiang'yin'ba'jian'tao'fen'hong	0
心心相印八件套砖红	xin'xin'xiang'yin'ba'jian'tao'zhuan'hong	0
心心相印八件套砖红直营	xin'xin'xiang'yin'ba'jian'tao'zhuan'hong'zhi'ying	0
心心相印床罩八件套砖红	xin'xin'xiang'yin'chuang'zhao'ba'jian'tao'zhuan'hong	0
芯心相印二合一被子母被	xin'xin'xiang'yin'er'he'yi'bei'zi'mu'bei	0
新秀荞麦学生枕送枕套	xin'xiu'qiao'mai'xue'sheng'zhen'song'zhen'tao	0
新炫毛毯	xin'xuan'mao'tan	0
芯雪天使大红床盖十件套直营	xin'xue'tian'shi'da'hong'chuang'gai'shi'jian'tao'zhi'ying	0
馨雨紫床单四件套	xin'yu'zi'chuang'dan'si'jian'tao	0
心悦玫瑰四件套	xin'yue'mei'gui'si'jian'tao	0
幸福恋人床笠四件套	xing'fu'lian'ren'chuang'li'si'jian'tao	0
幸福一生六件套	xing'fu'yi'sheng'liu'jian'tao	0
幸福一生四件套	xing'fu'yi'sheng'si'jian'tao	0
幸福至家四件套	xing'fu'zhi'jia'si'jian'tao	0
秀色添香八件套大红	xiu'se'tian'xiang'ba'jian'tao'da'hong	0
秀色添香八件套粉红	xiu'se'tian'xiang'ba'jian'tao'fen'hong	0
休闲蚊帐	xiu'xian'wen'zhang	0
休闲蚊帐支架	xiu'xian'wen'zhang'zhi'jia	0
绣玉花蕊六件套	xiu'yu'hua'rui'liu'jian'tao	0
旭日咖床单四件套热卖	xu'ri'ka'chuang'dan'si'jian'tao're'mai	0
炫色诱惑床笠四件套	xuan'se'you'huo'chuang'li'si'jian'tao	0
轩辕之旅八件套	xuan'yuan'zhi'lv'ba'jian'tao	0
寻梦花园七件套红	xun'meng'hua'yuan'qi'jian'tao'hong	0
寻梦花园七件套紫	xun'meng'hua'yuan'qi'jian'tao'zi	0
寻梦花园四件套红	xun'meng'hua'yuan'si'jian'tao'hong	0
寻梦花园四件套紫	xun'meng'hua'yuan'si'jian'tao'zi	0
熏衣草六件套紫	xun'yi'cao'liu'jian'tao'zi	0
薰衣草四件套红	xun'yi'cao'si'jian'tao'hong	0
薰衣草四件套紫	xun'yi'cao'si'jian'tao'zi	0
雅草清凉枕	ya'cao'qing'liang'zhen	0
雅草夏凉枕	ya'cao'xia'liang'zhen	0
雅草幼童枕	ya'cao'you'tong'zhen	0
雅草枕	ya'cao'zhen	0
雅草枕套	ya'cao'zhen'tao	0
雅草枕席	ya'cao'zhen'xi	0
雅尼之声床单四件套	ya'ni'zhi'sheng'chuang'dan'si'jian'tao	0
雅尼之声床笠四件套	ya'ni'zhi'sheng'chuang'li'si'jian'tao	0
雅仕金黄床单四件套特	ya'shi'jin'huang'chuang'dan'si'jian'tao'te	0
压缩毛巾赠品	ya'suo'mao'jin'zeng'pin	0
雅致大豆纤维被人人乐	ya'zhi'da'dou'xian'wei'bei'ren'ren'le	0
雅致舒绒被	ya'zhi'shu'rong'bei	0
雅致心语四件套	ya'zhi'xin'yu'si'jian'tao	0
雅致型贡缎被套	ya'zhi'xing'gong'duan'bei'tao	0
雅致型贡缎床单	ya'zhi'xing'gong'duan'chuang'dan	0
嫣然九件套	yan'ran'jiu'jian'tao	0
焉雨花丝八件套大红	yan'yu'hua'si'ba'jian'tao'da'hong	0
焉雨花丝八件套粉	yan'yu'hua'si'ba'jian'tao'fen	0
羊毛被新品	yang'mao'bei'xin'pin	0
羊毛暖冬被大润发	yang'mao'nuan'dong'bei'da'run'fa	0
羊毛休闲垫	yang'mao'xiu'xian'dian	0
养生蚕丝棉被	yang'sheng'can'si'mian'bei	0
窈窕淑女八件套大红	yao'tiao'shu'nv'ba'jian'tao'da'hong	0
窈窕淑女八件套粉红	yao'tiao'shu'nv'ba'jian'tao'fen'hong	0
窈窕淑女八件套米白	yao'tiao'shu'nv'ba'jian'tao'mi'bai	0
叶语幽晗床单四件套	ye'yu'you'han'chuang'dan'si'jian'tao	0
叶语幽晗床笠四件套	ye'yu'you'han'chuang'li'si'jian'tao	0
一包搞定校园装	yi'bao'gao'ding'xiao'yuan'zhuang	0
伊甸花园床盖四件套直营	yi'dian'hua'yuan'chuang'gai'si'jian'tao'zhi'ying	0
依恋六件套雪青	yi'lian'liu'jian'tao'xue'qing	0
依恋六件套砖红	yi'lian'liu'jian'tao'zhuan'hong	0
依恋四件套雪青	yi'lian'si'jian'tao'xue'qing	0
依恋四件套砖红	yi'lian'si'jian'tao'zhuan'hong	0
怡情叶姿四件套	yi'qing'ye'zi'si'jian'tao	0
易趣彩虹床单四件套热卖	yi'qu'cai'hong'chuang'dan'si'jian'tao're'mai	0
伊人香舍大红床盖六件套	yi'ren'xiang'she'da'hong'chuang'gai'liu'jian'tao	0
一生守候七件套	yi'sheng'shou'hou'qi'jian'tao	0
依纹床笠四件套直营	yi'wen'chuang'li'si'jian'tao'zhi'ying	0
逸雅纯棉四件套	yi'ya'chun'mian'si'jian'tao	0
逸雅纯棉四件套时尚先锋	yi'ya'chun'mian'si'jian'tao'shi'shang'xian'feng	0
异域风情八件套	yi'yu'feng'qing'ba'jian'tao	0
异域风情四件套	yi'yu'feng'qing'si'jian'tao	0
意蕴八件套	yi'yun'ba'jian'tao	0
意蕴八件套米黄	yi'yun'ba'jian'tao'mi'huang	0
印花抱枕芯	yin'hua'bao'zhen'xin	0
银线腰枕	yin'xian'yao'zhen	0
婴儿记忆棉枕	ying'er'ji'yi'mian'zhen	0
英伦之恋六件套	ying'lun'zhi'lian'liu'jian'tao	0
英伦之恋四件套	ying'lun'zhi'lian'si'jian'tao	0
拥抱大自然床笠三件套	yong'bao'da'zi'ran'chuang'li'san'jian'tao	0
拥抱大自然床笠四件套	yong'bao'da'zi'ran'chuang'li'si'jian'tao	0
勇敢无敌蓝床笠三件套	yong'gan'wu'di'lan'chuang'li'san'jian'tao	0
勇敢无敌蓝床笠四件套	yong'gan'wu'di'lan'chuang'li'si'jian'tao	0
永恒的爱八件套大红	yong'heng'de'ai'ba'jian'tao'da'hong	0
永恒的爱八件套大红直营	yong'heng'de'ai'ba'jian'tao'da'hong'zhi'ying	0
永恒的爱八件套粉红	yong'heng'de'ai'ba'jian'tao'fen'hong	0
永恒的爱八件套砖红	yong'heng'de'ai'ba'jian'tao'zhuan'hong	0
永恒的爱八件套砖红直营	yong'heng'de'ai'ba'jian'tao'zhuan'hong'zhi'ying	0
永恒的爱四件套	yong'heng'de'ai'si'jian'tao	0
永恒经典四件套	yong'heng'jing'dian'si'jian'tao	0
油柑叶慧聪枕	you'gan'ye'hui'cong'zhen	0
幽谷芬芳床盖六件套驼直营	you'gu'fen'fang'chuang'gai'liu'jian'tao'tuo'zhi'ying	0
优化蚕丝被	you'hua'can'si'bei	0
优化双丝被	you'hua'shuang'si'bei	0
幽澜床盖七件套	you'lan'chuang'gai'qi'jian'tao	0
幽澜七件套蓝	you'lan'qi'jian'tao'lan	0
游龙戏凤八件套	you'long'xi'feng'ba'jian'tao	0
幽香满溢大红床盖十件套	you'xiang'man'yi'da'hong'chuang'gai'shi'jian'tao	0
幽香满溢枚红床盖十件套	you'xiang'man'yi'mei'hong'chuang'gai'shi'jian'tao	0
幽香心语七件套	you'xiang'xin'yu'qi'jian'tao	0
优雅恋歌七件套	you'ya'lian'ge'qi'jian'tao	0
优雅情怀八件套血青	you'ya'qing'huai'ba'jian'tao'xue'qing	0
优雅情怀八件套雪青	you'ya'qing'huai'ba'jian'tao'xue'qing	0
优雅情怀八件套砖红	you'ya'qing'huai'ba'jian'tao'zhuan'hong	0
优雅生活床单三件套直营	you'ya'sheng'huo'chuang'dan'san'jian'tao'zhi'ying	0
优雅生活床单四件套直营	you'ya'sheng'huo'chuang'dan'si'jian'tao'zhi'ying	0
优雅型宫庭蚊帐	you'ya'xing'gong'ting'wen'zhang	0
优雅型宫廷蚊账支架	you'ya'xing'gong'ting'wen'zhang'zhi'jia	0
优雅型时尚蚊账	you'ya'xing'shi'shang'wen'zhang	0
御寒纯羊毛被	yu'han'chun'yang'mao'bei	0
浴巾平织支	yu'jin'ping'zhi'zhi	0
虞美人粉床盖六件套	yu'mei'ren'fen'chuang'gai'liu'jian'tao	0
玉面安逸枕	yu'mian'an'yi'zhen	0
御品硬牛皮席直营	yu'pin'ying'niu'pi'xi'zhi'ying	0
御品硬牛皮枕套直营	yu'pin'ying'niu'pi'zhen'tao'zhi'ying	0
羽丝绒春秋被	yu'si'rong'chun'qiu'bei	0
玉藤浪漫枕	yu'teng'lang'man'zhen	0
玉藤席二件套	yu'teng'xi'er'jian'tao	0
玉藤席三件套	yu'teng'xi'san'jian'tao	0
玉藤席枕套	yu'teng'xi'zhen'tao	0
圆点人生床单四件套	yuan'dian'ren'sheng'chuang'dan'si'jian'tao	0
缘份天空四件套	yuan'fen'tian'kong'si'jian'tao	0
远梦草艺枕	yuan'meng'cao'yi'zhen	0
远梦纯天然木棉枕	yuan'meng'chun'tian'ran'mu'mian'zhen	0
远梦蝶形枕	yuan'meng'die'xing'zhen	0
远梦工艺瓷珠坐垫	yuan'meng'gong'yi'ci'zhu'zuo'dian	0
远梦决明子舒适枕	yuan'meng'jue'ming'zi'shu'shi'zhen	0
远梦决明子甜梦枕	yuan'meng'jue'ming'zi'tian'meng'zhen	0
远梦毛巾被	yuan'meng'mao'jin'bei	0
远梦魔术屋蚊帐	yuan'meng'mo'shu'wu'wen'zhang	0
远梦舒适定型枕	yuan'meng'shu'shi'ding'xing'zhen	0
远梦舒适复合羊毛被人人乐	yuan'meng'shu'shi'fu'he'yang'mao'bei'ren'ren'le	0
远梦舒适枕	yuan'meng'shu'shi'zhen	0
远梦舒适枕送枕套	yuan'meng'shu'shi'zhen'song'zhen'tao	0
远梦香薰温馨枕	yuan'meng'xiang'xun'wen'xin'zhen	0
远梦小学生枕	yuan'meng'xiao'xue'sheng'zhen	0
远梦珍珠被	yuan'meng'zhen'zhu'bei	0
远梦中学生枕	yuan'meng'zhong'xue'sheng'zhen	0
远梦装饰抱枕	yuan'meng'zhuang'shi'bao'zhen	0
远梦尊享九件套金黄	yuan'meng'zun'xiang'jiu'jian'tao'jin'huang	0
远梦尊享九件套玫红	yuan'meng'zun'xiang'jiu'jian'tao'mei'hong	0
原野花絮豆沙床单四件套特	yuan'ye'hua'xu'dou'sha'chuang'dan'si'jian'tao'te	0
月下枫影床盖十件套直营	yue'xia'feng'ying'chuang'gai'shi'jian'tao'zhi'ying	0
月芽型蚊帐	yue'ya'xing'wen'zhang	0
韵律长枕套	yun'lv'chang'zhen'tao	0
韵律床盖四件套	yun'lv'chuang'gai'si'jian'tao	0
韵曲床单四件套	yun'qu'chuang'dan'si'jian'tao	0
韵味粉床盖十件套直营	yun'wei'fen'chuang'gai'shi'jian'tao'zhi'ying	0
云舞床单四件套粉	yun'wu'chuang'dan'si'jian'tao'fen	0
云舞床单四件套蓝	yun'wu'chuang'dan'si'jian'tao'lan	0
在水一方床盖四件套	zai'shui'yi'fang'chuang'gai'si'jian'tao	0
赠品布艺围裙	zeng'pin'bu'yi'wei'qun	0
赠品护垫	zeng'pin'hu'dian	0
赠品舒柔被芯	zeng'pin'shu'rou'bei'xin	0
赠品装枕芯	zeng'pin'zhuang'zhen'xin	0
真爱八件套大红	zhen'ai'ba'jian'tao'da'hong	0
真爱八件套大红直营	zhen'ai'ba'jian'tao'da'hong'zhi'ying	0
真爱八件套粉红	zhen'ai'ba'jian'tao'fen'hong	0
真爱八件套砖红	zhen'ai'ba'jian'tao'zhuan'hong	0
珍爱床单四件套	zhen'ai'chuang'dan'si'jian'tao	0
真爱家园七件套	zhen'ai'jia'yuan'qi'jian'tao	0
真爱六件套	zhen'ai'liu'jian'tao	0
真爱物语六件套粉红	zhen'ai'wu'yu'liu'jian'tao'fen'hong	0
真爱物语六件套米白	zhen'ai'wu'yu'liu'jian'tao'mi'bai	0
真爱物语四件套粉红	zhen'ai'wu'yu'si'jian'tao'fen'hong	0
真爱物语四件套米白	zhen'ai'wu'yu'si'jian'tao'mi'bai	0
真空适用枕	zhen'kong'shi'yong'zhen	0
真空舒适长枕	zhen'kong'shu'shi'chang'zhen	0
真空舒适短枕	zhen'kong'shu'shi'duan'zhen	0
真皮大方垫	zhen'pi'da'fang'dian	0
臻品夏薄被	zhen'pin'xia'bo'bei	0
臻质蚕丝被	zhen'zhi'can'si'bei	0
真挚情感四件套	zhen'zhi'qing'gan'si'jian'tao	0
珍珠枕	zhen'zhu'zhen	0
织锦龙凤活套被	zhi'jin'long'feng'huo'tao'bei	0
智能健康护颈枕	zhi'neng'jian'kang'hu'jing'zhen	0
直营情迷英伦八件套热卖品	zhi'ying'qing'mi'ying'lun'ba'jian'tao're'mai'pin	0
钟爱一生八件套大红	zhong'ai'yi'sheng'ba'jian'tao'da'hong	0
钟爱一生床盖八件套大红	zhong'ai'yi'sheng'chuang'gai'ba'jian'tao'da'hong	0
中床床裙四件套无花号	zhong'chuang'chuang'qun'si'jian'tao'wu'hua'hao	0
祝福四件套	zhu'fu'si'jian'tao	0
竹炭枕	zhu'tan'zhen	0
竹纤维夏被	zhu'xian'wei'xia'bei	0
竹纤维夏薄被直营	zhu'xian'wei'xia'bo'bei'zhi'ying	0
专卖巴黎之恋床单四件套热卖品	zhuan'mai'ba'li'zhi'lian'chuang'dan'si'jian'tao're'mai'pin	0
专卖粉彩床笠四件套热卖品	zhuan'mai'fen'cai'chuang'li'si'jian'tao're'mai'pin	0
专卖馥郁芬芳床笠四件套热卖品	zhuan'mai'fu'yu'fen'fang'chuang'li'si'jian'tao're'mai'pin	0
专卖贡缎印花床单四件套热卖品	zhuan'mai'gong'duan'yin'hua'chuang'dan'si'jian'tao're'mai'pin	0
专卖精致记忆床单四件套热卖品	zhuan'mai'jing'zhi'ji'yi'chuang'dan'si'jian'tao're'mai'pin	0
专卖精致记忆床笠四件套热卖品	zhuan'mai'jing'zhi'ji'yi'chuang'li'si'jian'tao're'mai'pin	0
专卖凯瑞床笠四件套热卖品	zhuan'mai'kai'rui'chuang'li'si'jian'tao're'mai'pin	0
专卖莱普床笠四件套热卖品	zhuan'mai'lai'pu'chuang'li'si'jian'tao're'mai'pin	0
专卖恋曲九件套粉热卖品	zhuan'mai'lian'qu'jiu'jian'tao'fen're'mai'pin	0
专卖玛丽床裙四件套热卖品	zhuan'mai'ma'li'chuang'qun'si'jian'tao're'mai'pin	0
专卖魅力生活床单四件套热卖品	zhuan'mai'mei'li'sheng'huo'chuang'dan'si'jian'tao're'mai'pin	0
专卖神话床单四件套热卖品	zhuan'mai'shen'hua'chuang'dan'si'jian'tao're'mai'pin	0
专卖时尚床单四件套热卖品	zhuan'mai'shi'shang'chuang'dan'si'jian'tao're'mai'pin	0
专卖时尚床笠四件套热卖品	zhuan'mai'shi'shang'chuang'li'si'jian'tao're'mai'pin	0
专卖岁月如梭床单四件套热卖品	zhuan'mai'sui'yue'ru'suo'chuang'dan'si'jian'tao're'mai'pin	0
专卖天丝印花床单四件套热卖品	zhuan'mai'tian'si'yin'hua'chuang'dan'si'jian'tao're'mai'pin	0
专卖肖邦夜曲四件套热卖品	zhuan'mai'xiao'bang'ye'qu'si'jian'tao're'mai'pin	0
专卖炫色诱惑床笠四件套热卖品	zhuan'mai'xuan'se'you'huo'chuang'li'si'jian'tao're'mai'pin	0
专卖雅尼之声床单四件套热卖品	zhuan'mai'ya'ni'zhi'sheng'chuang'dan'si'jian'tao're'mai'pin	0
专卖叶语幽晗床单四件套热卖品	zhuan'mai'ye'yu'you'han'chuang'dan'si'jian'tao're'mai'pin	0
专卖依纹床笠四件套热卖品	zhuan'mai'yi'wen'chuang'li'si'jian'tao're'mai'pin	0
专卖圆点人生床单四件套热卖品	zhuan'mai'yuan'dian'ren'sheng'chuang'dan'si'jian'tao're'mai'pin	0
专卖韵曲床单四件套热卖品	zhuan'mai'yun'qu'chuang'dan'si'jian'tao're'mai'pin	0
追忆繁花床单四件套	zhui'yi'fan'hua'chuang'dan'si'jian'tao	0
自动牙签瓶打火机款	zi'dong'ya'qian'ping'da'huo'ji'kuan	0
自动牙签瓶房子款	zi'dong'ya'qian'ping'fang'zi'kuan	0
紫色浪漫八件套	zi'se'lang'man'ba'jian'tao	0
紫色恋曲床盖四件套	zi'se'lian'qu'chuang'gai'si'jian'tao	0
自由生活床单三件套直营粉	zi'you'sheng'huo'chuang'dan'san'jian'tao'zhi'ying'fen	0
自由元素床笠四件套	zi'you'yuan'su'chuang'li'si'jian'tao	0
尊享桑蚕丝被	zun'xiang'sang'can'si'bei	0
尊享休闲蚊帐	zun'xiang'xiu'xian'wen'zhang	0
