百时快捷酒店南昌孺子路店	bai'shi'kuai'jie'jiu'dian'nan'chang'ru'zi'lu'dian	0
德兴大酒店	de'xing'da'jiu'dian	0
东谷宾馆庐山疗养院第二疗区	dong'gu'bin'guan'lu'shan'liao'yang'yuan'di'er'liao'qu	0
非常客栈抚州青云峰路店	fei'chang'ke'zhan'fu'zhou'qing'yun'feng'lu'dian	0
非常客栈南昌昌北店	fei'chang'ke'zhan'nan'chang'chang'bei'dian	0
非常客栈南昌朝阳中路店	fei'chang'ke'zhan'nan'chang'zhao'yang'zhong'lu'dian	0
非常客栈萍乡步行街店	fei'chang'ke'zhan'ping'xiang'bu'xing'jie'dian	0
丰城和合宾馆	feng'cheng'he'he'bin'guan	0
抚州王府城市酒店	fu'zhou'wang'fu'cheng'shi'jiu'dian	0
赣江新天地怡和假日酒店	gan'jiang'xin'tian'di'yi'he'jia'ri'jiu'dian	0
赣州宾馆	gan'zhou'bin'guan	0
赣州定南县凤凰酒店	gan'zhou'ding'nan'xian'feng'huang'jiu'dian	0
赣州定南县概念现代商务酒店	gan'zhou'ding'nan'xian'gai'nian'xian'dai'shang'wu'jiu'dian	0
赣州赣龙大酒店	gan'zhou'gan'long'da'jiu'dian	0
赣州国会大酒店	gan'zhou'guo'hui'da'jiu'dian	0
赣州海天大酒店	gan'zhou'hai'tian'da'jiu'dian	0
赣州宏远乐橙大酒店	gan'zhou'hong'yuan'le'cheng'da'jiu'dian	0
赣州华宝假日大酒店	gan'zhou'hua'bao'jia'ri'da'jiu'dian	0
赣州华夏商务酒店	gan'zhou'hua'xia'shang'wu'jiu'dian	0
赣州锦江国际酒店	gan'zhou'jin'jiang'guo'ji'jiu'dian	0
赣州君嘉大厦	gan'zhou'jun'jia'da'sha	0
赣州君嘉港湾酒店	gan'zhou'jun'jia'gang'wan'jiu'dian	0
赣州君嘉皇冠酒店	gan'zhou'jun'jia'huang'guan'jiu'dian	0
赣州君嘉快捷酒店文明店	gan'zhou'jun'jia'kuai'jie'jiu'dian'wen'ming'dian	0
赣州君嘉龙吟客栈	gan'zhou'jun'jia'long'yin'ke'zhan	0
赣州君嘉万福大酒店	gan'zhou'jun'jia'wan'fu'da'jiu'dian	0
赣州明珠大酒店	gan'zhou'ming'zhu'da'jiu'dian	0
赣州晴天酒店公寓	gan'zhou'qing'tian'jiu'dian'gong'yu	0
赣州山水大厦宾馆	gan'zhou'shan'shui'da'sha'bin'guan	0
赣州上犹希桥酒店	gan'zhou'shang'you'xi'qiao'jiu'dian	0
赣州铁龙大酒店	gan'zhou'tie'long'da'jiu'dian	0
赣州维佳大酒店	gan'zhou'wei'jia'da'jiu'dian	0
赣州香江湾国际酒店	gan'zhou'xiang'jiang'wan'guo'ji'jiu'dian	0
赣州新赣南饭店	gan'zhou'xin'gan'nan'fan'dian	0
赣州兴国县将军宾馆	gan'zhou'xing'guo'xian'jiang'jun'bin'guan	0
赣州星期八假日酒店	gan'zhou'xing'qi'ba'jia'ri'jiu'dian	0
赣州银海之星商务酒店	gan'zhou'yin'hai'zhi'xing'shang'wu'jiu'dian	0
赣州优巢酒店	gan'zhou'you'chao'jiu'dian	0
格林豪泰景德镇广场北路店	ge'lin'hao'tai'jing'de'zhen'guang'chang'bei'lu'dian	0
格林豪泰九江滨江路店	ge'lin'hao'tai'jiu'jiang'bin'jiang'lu'dian	0
格林豪泰九江火车站店	ge'lin'hao'tai'jiu'jiang'huo'che'zhan'dian	0
格林豪泰南昌八一广场店	ge'lin'hao'tai'nan'chang'ba'yi'guang'chang'dian	0
格林豪泰南昌叠山店	ge'lin'hao'tai'nan'chang'die'shan'dian	0
格林豪泰南昌县南莲路店	ge'lin'hao'tai'nan'chang'xian'nan'lian'lu'dian	0
汉庭海友客栈南昌八一广场店	han'ting'hai'you'ke'zhan'nan'chang'ba'yi'guang'chang'dian	0
汉庭快捷酒店南昌八一广场店	han'ting'kuai'jie'jiu'dian'nan'chang'ba'yi'guang'chang'dian	0
汉庭快捷酒店南昌洪都中大道店	han'ting'kuai'jie'jiu'dian'nan'chang'hong'du'zhong'da'dao'dian	0
汉庭快捷酒店南昌火车站店	han'ting'kuai'jie'jiu'dian'nan'chang'huo'che'zhan'dian	0
吉安白鹭宾馆	ji'an'bai'lu'bin'guan	0
吉安宏泰国际酒店	ji'an'hong'tai'guo'ji'jiu'dian	0
吉安华拓国际大酒店	ji'an'hua'tuo'guo'ji'da'jiu'dian	0
吉安锦洋宾馆	ji'an'jin'yang'bin'guan	0
吉安君嘉商务酒店青原店	ji'an'jun'jia'shang'wu'jiu'dian'qing'yuan'dian	0
吉安君嘉商务酒店韶山店	ji'an'jun'jia'shang'wu'jiu'dian'shao'shan'dian	0
吉安开元洲际大酒店	ji'an'kai'yuan'zhou'ji'da'jiu'dian	0
吉安市泰和县金悦凯廷城市酒店	ji'an'shi'tai'he'xian'jin'yue'kai'ting'cheng'shi'jiu'dian	0
吉安伟业国际大酒店	ji'an'wei'ye'guo'ji'da'jiu'dian	0
吉安文山国际大酒店	ji'an'wen'shan'guo'ji'da'jiu'dian	0
江西泊景悠游酒店三清山店	jiang'xi'bo'jing'you'you'jiu'dian'san'qing'shan'dian	0
江西波仕假日酒店南昌	jiang'xi'bo'shi'jia'ri'jiu'dian'nan'chang	0
江西饭店南昌	jiang'xi'fan'dian'nan'chang	0
江西富庭苑国际酒店南昌	jiang'xi'fu'ting'yuan'guo'ji'jiu'dian'nan'chang	0
江西赣江宾馆南昌	jiang'xi'gan'jiang'bin'guan'nan'chang	0
江西锦昌大酒店南昌	jiang'xi'jin'chang'da'jiu'dian'nan'chang	0
江西锦都皇冠酒店南昌	jiang'xi'jin'du'huang'guan'jiu'dian'nan'chang	0
江西锦怡大酒店南昌	jiang'xi'jin'yi'da'jiu'dian'nan'chang	0
江西庐山经纬宾馆	jiang'xi'lu'shan'jing'wei'bin'guan	0
江西民航花园酒店南昌	jiang'xi'min'hang'hua'yuan'jiu'dian'nan'chang	0
江西前湖迎宾馆南昌	jiang'xi'qian'hu'ying'bin'guan'nan'chang	0
江西泰耐克国际大酒店南昌	jiang'xi'tai'nai'ke'guo'ji'da'jiu'dian'nan'chang	0
江西唯客奥斯卡酒店南昌	jiang'xi'wei'ke'ao'si'ka'jiu'dian'nan'chang	0
江西唯客大酒店南昌火车站店	jiang'xi'wei'ke'da'jiu'dian'nan'chang'huo'che'zhan'dian	0
江西唯客大酒店南昌解放东路店	jiang'xi'wei'ke'da'jiu'dian'nan'chang'jie'fang'dong'lu'dian	0
江西唯客大酒店南昌沿江路店	jiang'xi'wei'ke'da'jiu'dian'nan'chang'yan'jiang'lu'dian	0
江西唯客丽晶国际大酒店	jiang'xi'wei'ke'li'jing'guo'ji'da'jiu'dian	0
江西新文国际大酒店南昌	jiang'xi'xin'wen'guo'ji'da'jiu'dian'nan'chang	0
江西鹰潭宾馆	jiang'xi'ying'tan'bin'guan	0
江西永生现代连锁宾馆抚州店	jiang'xi'yong'sheng'xian'dai'lian'suo'bin'guan'fu'zhou'dian	0
江西永生现代连锁宾馆九江店	jiang'xi'yong'sheng'xian'dai'lian'suo'bin'guan'jiu'jiang'dian	0
江西玉泉岛大酒店南昌	jiang'xi'yu'quan'dao'da'jiu'dian'nan'chang	0
锦江之星吉安吉福路店	jin'jiang'zhi'xing'ji'an'ji'fu'lu'dian	0
锦江之星江西景德镇店	jin'jiang'zhi'xing'jiang'xi'jing'de'zhen'dian	0
锦江之星南昌船山路店	jin'jiang'zhi'xing'nan'chang'chuan'shan'lu'dian	0
锦江之星南昌高新艾溪湖店	jin'jiang'zhi'xing'nan'chang'gao'xin'ai'xi'hu'dian	0
锦江之星南昌麦德龙店	jin'jiang'zhi'xing'nan'chang'mai'de'long'dian	0
锦江之星南昌民德路店	jin'jiang'zhi'xing'nan'chang'min'de'lu'dian	0
锦江之星南昌南京西路店	jin'jiang'zhi'xing'nan'chang'nan'jing'xi'lu'dian	0
景德镇半岛国际酒店	jing'de'zhen'ban'dao'guo'ji'jiu'dian	0
景德镇财政宾馆	jing'de'zhen'cai'zheng'bin'guan	0
景德镇昌南半岛酒店	jing'de'zhen'chang'nan'ban'dao'jiu'dian	0
景德镇昌欣国际大酒店	jing'de'zhen'chang'xin'guo'ji'da'jiu'dian	0
景德镇瓷都宾馆	jing'de'zhen'ci'du'bin'guan	0
景德镇大酒店	jing'de'zhen'da'jiu'dian	0
景德镇豪门大酒店	jing'de'zhen'hao'men'da'jiu'dian	0
景德镇开门子大酒店	jing'de'zhen'kai'men'zi'da'jiu'dian	0
景德镇朗逸酒店	jing'de'zhen'lang'yi'jiu'dian	0
景德镇良友宾馆	jing'de'zhen'liang'you'bin'guan	0
景德镇视界风尚酒店	jing'de'zhen'shi'jie'feng'shang'jiu'dian	0
景德镇天庭商务宾馆	jing'de'zhen'tian'ting'shang'wu'bin'guan	0
景德镇文苑大酒店	jing'de'zhen'wen'yuan'da'jiu'dian	0
景德镇星程青花主题酒店	jing'de'zhen'xing'cheng'qing'hua'zhu'ti'jiu'dian	0
景德镇紫晶宾馆	jing'de'zhen'zi'jing'bin'guan	0
井冈山奥源大酒店	jing'gang'shan'ao'yuan'da'jiu'dian	0
井冈山笔架山大酒店	jing'gang'shan'bi'jia'shan'da'jiu'dian	0
井冈山财苑宾馆	jing'gang'shan'cai'yuan'bin'guan	0
井冈山长青宾馆	jing'gang'shan'chang'qing'bin'guan	0
井冈山晨鑫宾馆	jing'gang'shan'chen'xin'bin'guan	0
井冈山翠湖宾馆	jing'gang'shan'cui'hu'bin'guan	0
井冈山国防教育基地长城宾馆	jing'gang'shan'guo'fang'jiao'yu'ji'di'chang'cheng'bin'guan	0
井冈山红歌大酒店	jing'gang'shan'hong'ge'da'jiu'dian	0
井冈山红杉树假日酒店	jing'gang'shan'hong'shan'shu'jia'ri'jiu'dian	0
井冈山景泰宾馆	jing'gang'shan'jing'tai'bin'guan	0
井冈山警卫基地酒店井武公寓	jing'gang'shan'jing'wei'ji'di'jiu'dian'jing'wu'gong'yu	0
井冈山井秀山庄	jing'gang'shan'jing'xiu'shan'zhuang	0
井冈山景园大酒店	jing'gang'shan'jing'yuan'da'jiu'dian	0
井冈山丽洲休闲山庄	jing'gang'shan'li'zhou'xiu'xian'shan'zhuang	0
井冈山林野大酒店	jing'gang'shan'lin'ye'da'jiu'dian	0
井冈山麓舍精品酒店	jing'gang'shan'lu'she'jing'pin'jiu'dian	0
井冈山天乐府酒店	jing'gang'shan'tian'yue'fu'jiu'dian	0
井冈山星期大酒店	jing'gang'shan'xing'qi'da'jiu'dian	0
井冈山阳光假日公寓	jing'gang'shan'yang'guang'jia'ri'gong'yu	0
井冈山映山红宾馆	jing'gang'shan'ying'shan'hong'bin'guan	0
井冈山由克来酒店	jing'gang'shan'you'ke'lai'jiu'dian	0
井冈山中煤宾馆	jing'gang'shan'zhong'mei'bin'guan	0
井冈山中泰来国际大酒店	jing'gang'shan'zhong'tai'lai'guo'ji'da'jiu'dian	0
酒店名称	jiu'dian'ming'cheng	0
九江邦尼运通商务宾馆	jiu'jiang'bang'ni'yun'tong'shang'wu'bin'guan	0
九江贝妮菲特酒店	jiu'jiang'bei'ni'fei'te'jiu'dian	0
九江柴瑱宾馆	jiu'jiang'chai'zhen'bin'guan	0
九江大酒店	jiu'jiang'da'jiu'dian	0
九江福泰连锁酒店长虹店	jiu'jiang'fu'tai'lian'suo'jiu'dian'chang'hong'dian	0
九江福泰连锁酒店二亩地店	jiu'jiang'fu'tai'lian'suo'jiu'dian'er'mu'di'dian	0
九江福泰连锁酒店烟水亭店	jiu'jiang'fu'tai'lian'suo'jiu'dian'yan'shui'ting'dian	0
九江供电公司庐山培训基地	jiu'jiang'gong'dian'gong'si'lu'shan'pei'xun'ji'di	0
九江共青茶山迎宾馆	jiu'jiang'gong'qing'cha'shan'ying'bin'guan	0
九江共青金航大酒店	jiu'jiang'gong'qing'jin'hang'da'jiu'dian	0
九江海棠商务酒店	jiu'jiang'hai'tang'shang'wu'jiu'dian	0
九江花旗假日大酒店	jiu'jiang'hua'qi'jia'ri'da'jiu'dian	0
九江黄金假日酒店	jiu'jiang'huang'jin'jia'ri'jiu'dian	0
九江金轩益君大酒店	jiu'jiang'jin'xuan'yi'jun'da'jiu'dian	0
九江精品酒店	jiu'jiang'jing'pin'jiu'dian	0
九江米兰花商务酒店	jiu'jiang'mi'lan'hua'shang'wu'jiu'dian	0
九江天海商务酒店德化路店	jiu'jiang'tian'hai'shang'wu'jiu'dian'de'hua'lu'dian	0
九江天隆宾馆	jiu'jiang'tian'long'bin'guan	0
九江天翔商务大酒店	jiu'jiang'tian'xiang'shang'wu'da'jiu'dian	0
九江信华建国酒店	jiu'jiang'xin'hua'jian'guo'jiu'dian	0
九江星河大酒店	jiu'jiang'xing'he'da'jiu'dian	0
九江雅格泰大酒店	jiu'jiang'ya'ge'tai'da'jiu'dian	0
九江永修宾馆	jiu'jiang'yong'xiu'bin'guan	0
九江远洲国际大酒店	jiu'jiang'yuan'zhou'guo'ji'da'jiu'dian	0
九江中景假期酒店	jiu'jiang'zhong'jing'jia'qi'jiu'dian	0
科莱商务连锁酒店南昌叠山路店	ke'lai'shang'wu'lian'suo'jiu'dian'nan'chang'die'shan'lu'dian	0
乐平菜园子商务酒店	le'ping'cai'yuan'zi'shang'wu'jiu'dian	0
乐平东方国际酒店	le'ping'dong'fang'guo'ji'jiu'dian	0
庐琴山庄	lu'qin'shan'zhuang	0
庐山白云宾馆	lu'shan'bai'yun'bin'guan	0
庐山北斗星国际饭店	lu'shan'bei'dou'xing'guo'ji'fan'dian	0
庐山宾馆	lu'shan'bin'guan	0
庐山东方国际酒店	lu'shan'dong'fang'guo'ji'jiu'dian	0
庐山饭店	lu'shan'fan'dian	0
庐山牯岭大酒店	lu'shan'gu'ling'da'jiu'dian	0
庐山国际阳光温泉度假村	lu'shan'guo'ji'yang'guang'wen'quan'du'jia'cun	0
庐山国脉宾馆	lu'shan'guo'mai'bin'guan	0
庐山华夏宾馆	lu'shan'hua'xia'bin'guan	0
庐山金宫山庄	lu'shan'jin'gong'shan'zhuang	0
庐山锦绣假日酒店	lu'shan'jin'xiu'jia'ri'jiu'dian	0
庐山匡城宾馆	lu'shan'kuang'cheng'bin'guan	0
庐山龙湾温泉度假村	lu'shan'long'wan'wen'quan'du'jia'cun	0
庐山庐池宾馆	lu'shan'lu'chi'bin'guan	0
庐山太极宾馆	lu'shan'tai'ji'bin'guan	0
庐山天地温泉假日酒店	lu'shan'tian'di'wen'quan'jia'ri'jiu'dian	0
庐山天福温泉度假村	lu'shan'tian'fu'wen'quan'du'jia'cun	0
庐山西海温泉假日酒店	lu'shan'xi'hai'wen'quan'jia'ri'jiu'dian	0
庐山逍夏宾馆	lu'shan'xiao'xia'bin'guan	0
庐山鑫缔宾馆	lu'shan'xin'di'bin'guan	0
庐山新世纪宾馆	lu'shan'xin'shi'ji'bin'guan	0
庐山颐元别墅度假村	lu'shan'yi'yuan'bie'shu'du'jia'cun	0
庐山云龙宾馆	lu'shan'yun'long'bin'guan	0
庐山云庐山庄	lu'shan'yun'lu'shan'zhuang	0
庐山云天别墅原蒋经国别墅	lu'shan'yun'tian'bie'shu'yuan'jiang'jing'guo'bie'shu	0
庐山云中宾馆	lu'shan'yun'zhong'bin'guan	0
莫泰南昌滕王阁店	mo'tai'nan'chang'teng'wang'ge'dian	0
南昌爱莎公寓	nan'chang'ai'sha'gong'yu	0
南昌白金汇海航酒店	nan'chang'bai'jin'hui'hai'hang'jiu'dian	0
南昌百瑞丽景酒店	nan'chang'bai'rui'li'jing'jiu'dian	0
南昌百瑞四季酒店	nan'chang'bai'rui'si'ji'jiu'dian	0
南昌百胜酒店	nan'chang'bai'sheng'jiu'dian	0
南昌保利高尔夫度假村	nan'chang'bao'li'gao'er'fu'du'jia'cun	0
南昌北京宾馆	nan'chang'bei'jing'bin'guan	0
南昌铂仕商务宾馆	nan'chang'bo'shi'shang'wu'bin'guan	0
南昌城市花园酒店	nan'chang'cheng'shi'hua'yuan'jiu'dian	0
南昌春天故事精品酒店	nan'chang'chun'tian'gu'shi'jing'pin'jiu'dian	0
南昌翠林高尔夫假日酒店	nan'chang'cui'lin'gao'er'fu'jia'ri'jiu'dian	0
南昌第壹街区酒店	nan'chang'di'yi'jie'qu'jiu'dian	0
南昌东方百灵大酒店	nan'chang'dong'fang'bai'ling'da'jiu'dian	0
南昌东方豪景花园酒店	nan'chang'dong'fang'hao'jing'hua'yuan'jiu'dian	0
南昌东申商务酒店	nan'chang'dong'shen'shang'wu'jiu'dian	0
南昌富豪酒店	nan'chang'fu'hao'jiu'dian	0
南昌富瑞大酒店	nan'chang'fu'rui'da'jiu'dian	0
南昌赣江之星商务酒店	nan'chang'gan'jiang'zhi'xing'shang'wu'jiu'dian	0
南昌格兰云天国际酒店	nan'chang'ge'lan'yun'tian'guo'ji'jiu'dian	0
南昌观园楼商务酒店	nan'chang'guan'yuan'lou'shang'wu'jiu'dian	0
南昌桂花村大酒店	nan'chang'gui'hua'cun'da'jiu'dian	0
南昌国贸酒店	nan'chang'guo'mao'jiu'dian	0
南昌海林宾馆	nan'chang'hai'lin'bin'guan	0
南昌核工宾馆	nan'chang'he'gong'bin'guan	0
南昌洪都宾馆	nan'chang'hong'du'bin'guan	0
南昌湖景商务酒店	nan'chang'hu'jing'shang'wu'jiu'dian	0
南昌华宇商务酒店	nan'chang'hua'yu'shang'wu'jiu'dian	0
南昌华宇新天地酒店	nan'chang'hua'yu'xin'tian'di'jiu'dian	0
南昌华悦国际大酒店	nan'chang'hua'yue'guo'ji'da'jiu'dian	0
南昌环湖宾馆	nan'chang'huan'hu'bin'guan	0
南昌皇廷大酒店	nan'chang'huang'ting'da'jiu'dian	0
南昌嘉合生活酒店	nan'chang'jia'he'sheng'huo'jiu'dian	0
南昌嘉莱特和平国际酒店	nan'chang'jia'lai'te'he'ping'guo'ji'jiu'dian	0
南昌江西宾馆	nan'chang'jiang'xi'bin'guan	0
南昌锦和假日酒店	nan'chang'jin'he'jia'ri'jiu'dian	0
南昌锦江国际锦峰大酒店	nan'chang'jin'jiang'guo'ji'jin'feng'da'jiu'dian	0
南昌锦森古德宾馆	nan'chang'jin'sen'gu'de'bin'guan	0
南昌金狮连锁宾馆	nan'chang'jin'shi'lian'suo'bin'guan	0
南昌金悦宾馆	nan'chang'jin'yue'bin'guan	0
南昌金悦凯廷城市酒店	nan'chang'jin'yue'kai'ting'cheng'shi'jiu'dian	0
南昌晶帝商务大酒店	nan'chang'jing'di'shang'wu'da'jiu'dian	0
南昌君嘉商务酒店建设路店	nan'chang'jun'jia'shang'wu'jiu'dian'jian'she'lu'dian	0
南昌君来大酒店	nan'chang'jun'lai'da'jiu'dian	0
南昌君亭红牛酒店	nan'chang'jun'ting'hong'niu'jiu'dian	0
南昌凯莱大饭店	nan'chang'kai'lai'da'fan'dian	0
南昌力高皇冠假日酒店	nan'chang'li'gao'huang'guan'jia'ri'jiu'dian	0
南昌绿洲假日酒店	nan'chang'lv'zhou'jia'ri'jiu'dian	0
南昌米兰风尚酒店	nan'chang'mi'lan'feng'shang'jiu'dian	0
南昌米兰花园酒店	nan'chang'mi'lan'hua'yuan'jiu'dian	0
南昌米兰假日酒店	nan'chang'mi'lan'jia'ri'jiu'dian	0
南昌明园大酒店	nan'chang'ming'yuan'da'jiu'dian	0
南昌明珠酒店公寓	nan'chang'ming'zhu'jiu'dian'gong'yu	0
南昌纳特商务宾馆	nan'chang'na'te'shang'wu'bin'guan	0
南昌欧客快捷酒店	nan'chang'ou'ke'kuai'jie'jiu'dian	0
南昌鄱阳湖大酒店	nan'chang'po'yang'hu'da'jiu'dian	0
南昌七星商务酒店	nan'chang'qi'xing'shang'wu'jiu'dian	0
南昌千爱艺术酒店	nan'chang'qian'ai'yi'shu'jiu'dian	0
南昌前湖宾馆	nan'chang'qian'hu'bin'guan	0
南昌青山湖宾馆	nan'chang'qing'shan'hu'bin'guan	0
南昌瑞都大酒店	nan'chang'rui'dou'da'jiu'dian	0
南昌山水青国际大酒店	nan'chang'shan'shui'qing'guo'ji'da'jiu'dian	0
南昌商旅之家旅馆	nan'chang'shang'lv'zhi'jia'lv'guan	0
南昌胜家快捷酒店	nan'chang'sheng'jia'kuai'jie'jiu'dian	0
南昌舒悦商务酒店	nan'chang'shu'yue'shang'wu'jiu'dian	0
南昌天外天酒店	nan'chang'tian'wai'tian'jiu'dian	0
南昌旺辉酒店	nan'chang'wang'hui'jiu'dian	0
南昌温馨晶晨宾馆	nan'chang'wen'xin'jing'chen'bin'guan	0
南昌温馨如家大酒店	nan'chang'wen'xin'ru'jia'da'jiu'dian	0
南昌温馨商务酒店丁公路店	nan'chang'wen'xin'shang'wu'jiu'dian'ding'gong'lu'dian	0
南昌温馨商务酒店红谷滩店	nan'chang'wen'xin'shang'wu'jiu'dian'hong'gu'tan'dian	0
南昌新地宾馆	nan'chang'xin'di'bin'guan	0
南昌新多伦多宾馆	nan'chang'xin'duo'lun'duo'bin'guan	0
南昌鑫峰假日酒店	nan'chang'xin'feng'jia'ri'jiu'dian	0
南昌新吉花园酒店	nan'chang'xin'ji'hua'yuan'jiu'dian	0
南昌鑫龙大酒店	nan'chang'xin'long'da'jiu'dian	0
南昌星期酒店	nan'chang'xing'qi'jiu'dian	0
南昌阳光假日酒店	nan'chang'yang'guang'jia'ri'jiu'dian	0
南昌阳明宾馆	nan'chang'yang'ming'bin'guan	0
南昌冶金商务酒店	nan'chang'ye'jin'shang'wu'jiu'dian	0
南昌一峰宾馆	nan'chang'yi'feng'bin'guan	0
南昌亿泰速酒店	nan'chang'yi'tai'su'jiu'dian	0
南昌银星大厦	nan'chang'yin'xing'da'sha	0
南昌园中源大酒店	nan'chang'yuan'zhong'yuan'da'jiu'dian	0
南昌月亮河假日公寓	nan'chang'yue'liang'he'jia'ri'gong'yu	0
南昌月亮河酒店恒茂店	nan'chang'yue'liang'he'jiu'dian'heng'mao'dian	0
南昌众城凯跃商务酒店	nan'chang'zhong'cheng'kai'yue'shang'wu'jiu'dian	0
南康君嘉国际大酒店	nan'kang'jun'jia'guo'ji'da'jiu'dian	0
南康市翡翠湾大酒店	nan'kang'shi'fei'cui'wan'da'jiu'dian	0
萍乡安源宾馆	ping'xiang'an'yuan'bin'guan	0
萍乡豪门国际大酒店	ping'xiang'hao'men'guo'ji'da'jiu'dian	0
萍乡君悦豪门大酒店	ping'xiang'jun'yue'hao'men'da'jiu'dian	0
萍乡七星国际商务酒店	ping'xiang'qi'xing'guo'ji'shang'wu'jiu'dian	0
萍乡武功山红岩谷假日酒店	ping'xiang'wu'gong'shan'hong'yan'gu'jia'ri'jiu'dian	0
如家快捷酒店景德镇人民广场店	ru'jia'kuai'jie'jiu'dian'jing'de'zhen'ren'min'guang'chang'dian	0
如家快捷酒店九江浔阳路店	ru'jia'kuai'jie'jiu'dian'jiu'jiang'xun'yang'lu'dian	0
如家快捷酒店南昌八一广场店	ru'jia'kuai'jie'jiu'dian'nan'chang'ba'yi'guang'chang'dian	0
如家快捷酒店南昌丁公路店	ru'jia'kuai'jie'jiu'dian'nan'chang'ding'gong'lu'dian	0
如家快捷酒店南昌高新开发区店	ru'jia'kuai'jie'jiu'dian'nan'chang'gao'xin'kai'fa'qu'dian	0
如家快捷酒店南昌孺子路店	ru'jia'kuai'jie'jiu'dian'nan'chang'ru'zi'lu'dian	0
如家快捷酒店南昌上海北路店	ru'jia'kuai'jie'jiu'dian'nan'chang'shang'hai'bei'lu'dian	0
如家快捷酒店南昌象山北路店	ru'jia'kuai'jie'jiu'dian'nan'chang'xiang'shan'bei'lu'dian	0
三清山东方女神山庄	san'qing'shan'dong'fang'nv'shen'shan'zhuang	0
三清山国际度假酒店	san'qing'shan'guo'ji'du'jia'jiu'dian	0
三清山华克山庄	san'qing'shan'hua'ke'shan'zhuang	0
三清山锦琛山庄	san'qing'shan'jin'chen'shan'zhuang	0
三清山水云山庄	san'qing'shan'shui'yun'shan'zhuang	0
三清山田园牧歌度假村	san'qing'shan'tian'yuan'mu'ge'du'jia'cun	0
三清天堂国际大酒店	san'qing'tian'tang'guo'ji'da'jiu'dian	0
上饶北星大酒店	shang'rao'bei'xing'da'jiu'dian	0
上饶广丰永利国际大酒店	shang'rao'guang'feng'yong'li'guo'ji'da'jiu'dian	0
上饶和平国际大酒店	shang'rao'he'ping'guo'ji'da'jiu'dian	0
上饶和平阳光酒店	shang'rao'he'ping'yang'guang'jiu'dian	0
上饶华都国际大酒店	shang'rao'hua'du'guo'ji'da'jiu'dian	0
上饶黄金海岸大酒店	shang'rao'huang'jin'hai'an'da'jiu'dian	0
上饶吉阳国际大酒店	shang'rao'ji'yang'guo'ji'da'jiu'dian	0
上饶京都国际大酒店	shang'rao'jing'du'guo'ji'da'jiu'dian	0
上饶三清大酒店	shang'rao'san'qing'da'jiu'dian	0
上饶世纪外滩大酒店	shang'rao'shi'ji'wai'tan'da'jiu'dian	0
上饶市三清山南星宾馆	shang'rao'shi'san'qing'shan'nan'xing'bin'guan	0
上饶市唐朝大酒店	shang'rao'shi'tang'chao'da'jiu'dian	0
上饶欣凯皇冠酒店	shang'rao'xin'kai'huang'guan'jiu'dian	0
上饶新龙大酒店	shang'rao'xin'long'da'jiu'dian	0
上饶中茂大酒店	shang'rao'zhong'mao'da'jiu'dian	0
天连锁酒店赣州汽车站店	tian'lian'suo'jiu'dian'gan'zhou'qi'che'zhan'dian	0
天连锁酒店景德镇人民广场店	tian'lian'suo'jiu'dian'jing'de'zhen'ren'min'guang'chang'dian	0
天连锁酒店景德镇新厂店	tian'lian'suo'jiu'dian'jing'de'zhen'xin'chang'dian	0
天连锁酒店九江火车站店	tian'lian'suo'jiu'dian'jiu'jiang'huo'che'zhan'dian	0
天连锁酒店南昌八一广场店	tian'lian'suo'jiu'dian'nan'chang'ba'yi'guang'chang'dian	0
天连锁酒店南昌八一广场二店	tian'lian'suo'jiu'dian'nan'chang'ba'yi'guang'chang'er'dian	0
天连锁酒店南昌北京西路店	tian'lian'suo'jiu'dian'nan'chang'bei'jing'xi'lu'dian	0
天连锁酒店南昌大学店	tian'lian'suo'jiu'dian'nan'chang'da'xue'dian	0
天连锁酒店南昌福州路店	tian'lian'suo'jiu'dian'nan'chang'fu'zhou'lu'dian	0
天连锁酒店南昌洪城大市场店	tian'lian'suo'jiu'dian'nan'chang'hong'cheng'da'shi'chang'dian	0
天连锁酒店南昌洪都北大道店	tian'lian'suo'jiu'dian'nan'chang'hong'du'bei'da'dao'dian	0
天连锁酒店南昌解放西路店	tian'lian'suo'jiu'dian'nan'chang'jie'fang'xi'lu'dian	0
天连锁酒店南昌孺子路店	tian'lian'suo'jiu'dian'nan'chang'ru'zi'lu'dian	0
天连锁酒店南昌上海路店	tian'lian'suo'jiu'dian'nan'chang'shang'hai'lu'dian	0
天连锁酒店南昌万寿宫店	tian'lian'suo'jiu'dian'nan'chang'wan'shou'gong'dian	0
天连锁酒店南昌文化宫店	tian'lian'suo'jiu'dian'nan'chang'wen'hua'gong'dian	0
天连锁酒店南昌中山路店	tian'lian'suo'jiu'dian'nan'chang'zhong'shan'lu'dian	0
天连锁酒店七天南昌系马桩店	tian'lian'suo'jiu'dian'qi'tian'nan'chang'xi'ma'zhuang'dian	0
天龙山大酒店	tian'long'shan'da'jiu'dian	0
天沐江西庐山温泉度假村	tian'mu'jiang'xi'lu'shan'wen'quan'du'jia'cun	0
文山国际吉水酒店	wen'shan'guo'ji'ji'shui'jiu'dian	0
婺源宾馆	wu'yuan'bin'guan	0
婺源彩虹桥度假村	wu'yuan'cai'hong'qiao'du'jia'cun	0
婺源茶博府公馆	wu'yuan'cha'bo'fu'gong'guan	0
婺源长城大酒店	wu'yuan'chang'cheng'da'jiu'dian	0
婺源风景酒店	wu'yuan'feng'jing'jiu'dian	0
婺源国际大酒店	wu'yuan'guo'ji'da'jiu'dian	0
婺源华逸大酒店	wu'yuan'hua'yi'da'jiu'dian	0
婺源花园大酒店	wu'yuan'hua'yuan'da'jiu'dian	0
婺源假日酒店	wu'yuan'jia'ri'jiu'dian	0
婺源江湾大酒店	wu'yuan'jiang'wan'da'jiu'dian	0
婺源锦江大酒店	wu'yuan'jin'jiang'da'jiu'dian	0
婺源君悦大酒店	wu'yuan'jun'yue'da'jiu'dian	0
婺源李坑逸家酒店李坑景区	wu'yuan'li'keng'yi'jia'jiu'dian'li'keng'jing'qu	0
婺源驴友驿站乡村宾馆	wu'yuan'lv'you'yi'zhan'xiang'cun'bin'guan	0
婺源浅水湾速酒店	wu'yuan'qian'shui'wan'su'jiu'dian	0
婺源清华宾馆	wu'yuan'qing'hua'bin'guan	0
婺源清华婺国际酒店	wu'yuan'qing'hua'wu'guo'ji'jiu'dian	0
婺源天佑商务酒店	wu'yuan'tian'you'shang'wu'jiu'dian	0
婺源县星江大酒店	wu'yuan'xian'xing'jiang'da'jiu'dian	0
婺源晓和住宿楼客栈	wu'yuan'xiao'he'zhu'su'lou'ke'zhan	0
婺源镛江商务宾馆	wu'yuan'yong'jiang'shang'wu'bin'guan	0
婺源月亮湾大酒店	wu'yuan'yue'liang'wan'da'jiu'dian	0
婺源云溪大酒店	wu'yuan'yun'xi'da'jiu'dian	0
婺源朱熹故里度假村	wu'yuan'zhu'xi'gu'li'du'jia'cun	0
婺源紫金大酒店	wu'yuan'zi'jin'da'jiu'dian	0
新余春龙国际大酒店	xin'yu'chun'long'guo'ji'da'jiu'dian	0
新余华瑞宾馆	xin'yu'hua'rui'bin'guan	0
新余龙华国际大酒店	xin'yu'long'hua'guo'ji'da'jiu'dian	0
新余望江国际酒店	xin'yu'wang'jiang'guo'ji'jiu'dian	0
新余仙女湖凤凰山庄	xin'yu'xian'nv'hu'feng'huang'shan'zhuang	0
新余袁河宾馆	xin'yu'yuan'he'bin'guan	0
新余悦华商务酒店	xin'yu'yue'hua'shang'wu'jiu'dian	0
宜春博能宾馆	yi'chun'bo'neng'bin'guan	0
宜春大富豪酒店	yi'chun'da'fu'hao'jiu'dian	0
宜春德和大酒店	yi'chun'de'he'da'jiu'dian	0
宜春锦晨商务酒店	yi'chun'jin'chen'shang'wu'jiu'dian	0
宜春锦绣山庄	yi'chun'jin'xiu'shan'zhuang	0
宜春苹果酒店	yi'chun'ping'guo'jiu'dian	0
宜春青龙大酒店	yi'chun'qing'long'da'jiu'dian	0
宜春市万载汇丰大酒店	yi'chun'shi'wan'zai'hui'feng'da'jiu'dian	0
鹰潭观湖轩酒店	ying'tan'guan'hu'xuan'jiu'dian	0
鹰潭洪鹰电力宾馆	ying'tan'hong'ying'dian'li'bin'guan	0
鹰潭华盛大酒店	ying'tan'hua'sheng'da'jiu'dian	0
鹰潭花园国际酒店	ying'tan'hua'yuan'guo'ji'jiu'dian	0
鹰潭皇冠国际大酒店	ying'tan'huang'guan'guo'ji'da'jiu'dian	0
鹰潭家乐居酒店	ying'tan'jia'le'ju'jiu'dian	0
鹰潭江西骏安国际大酒店	ying'tan'jiang'xi'jun'an'guo'ji'da'jiu'dian	0
鹰潭龙虎山泸溪宾馆	ying'tan'long'hu'shan'lu'xi'bin'guan	0
鹰潭龙虎山上清宾馆分部	ying'tan'long'hu'shan'shang'qing'bin'guan'fen'bu	0
鹰潭上清宾馆总部	ying'tan'shang'qing'bin'guan'zong'bu	0
鹰潭天天假日酒店	ying'tan'tian'tian'jia'ri'jiu'dian	0
鹰潭香江国际大酒店	ying'tan'xiang'jiang'guo'ji'da'jiu'dian	0
鹰潭阳光假日酒店	ying'tan'yang'guang'jia'ri'jiu'dian	0
永生璞琚概念酒店南昌洪城店	yong'sheng'pu'ju'gai'nian'jiu'dian'nan'chang'hong'cheng'dian	0
永生璞琚概念酒店宜春市店	yong'sheng'pu'ju'gai'nian'jiu'dian'yi'chun'shi'dian	0
玉山豪泰国际酒店	yu'shan'hao'tai'guo'ji'jiu'dian	0
玉山南洋丽晶酒店	yu'shan'nan'yang'li'jing'jiu'dian	0
玉山县玉虹国际大酒店	yu'shan'xian'yu'hong'guo'ji'da'jiu'dian	0
玉山县玉台国际酒店	yu'shan'xian'yu'tai'guo'ji'jiu'dian	0
樟树易佳客栈宜春	zhang'shu'yi'jia'ke'zhan'yi'chun	0
