安源路矿工人俱乐部旧址	an'yuan'lu'kuang'gong'ren'ju'le'bu'jiu'zhi	0
安远庙	an'yuan'miao	0
八连城遗址	ba'lian'cheng'yi'zhi	0
八七会议旧址	ba'qi'hui'yi'jiu'zhi	0
柏孜克里克千佛洞	bai'zi'ke'li'ke'qian'fo'dong	0
半坡遗址	ban'po'yi'zhi	0
宝山六道沟冶钢遗址	bao'shan'liu'dao'gou'ye'gang'yi'zhi	0
北戴河秦行宫遗址	bei'dai'he'qin'xing'gong'yi'zhi	0
北京大学红楼	bei'jing'da'xue'hong'lou	0
北京宋庆龄故居	bei'jing'song'qing'ling'gu'ju	0
北石窟寺	bei'shi'ku'si	0
北岳庙	bei'yue'miao	0
北庄遗址	bei'zhuang'yi'zhi	0
蔡元培故居	cai'yuan'pei'gu'ju	0
曹氏家族墓群	cao'shi'jia'zu'mu'qun	0
查海遗址	cha'hai'yi'zhi	0
常德铁幢	chang'de'tie'zhuang	0
朝阳北塔	chao'yang'bei'ta	0
城村汉城遗址	cheng'cun'han'cheng'yi'zhi	0
成吉思汗陵	cheng'ji'si'han'ling	0
城头山遗址	cheng'tou'shan'yi'zhi	0
城子山遗址	cheng'zi'shan'yi'zhi	0
城子崖遗址	cheng'zi'ya'yi'zhi	0
崇福寺	chong'fu'si	0
崇觉寺铁塔	chong'jue'si'tie'ta	0
楚纪南故城	chu'ji'nan'gu'cheng	0
初祖庵及少林寺塔林	chu'zu'an'ji'shao'lin'si'ta'lin	0
磁州窑遗址	ci'zhou'yao'yi'zhi	0
大甸子遗址	da'dian'zi'yi'zhi	0
大佛寺石窟	da'fo'si'shi'ku	0
大工山凤凰山铜矿遗址	da'gong'shan'feng'huang'shan'tong'kuang'yi'zhi	0
大沽口炮台	da'gu'kou'pao'tai	0
大河村遗址	da'he'cun'yi'zhi	0
大井古铜矿遗址	da'jing'gu'tong'kuang'yi'zhi	0
大汶口遗址	da'wen'kou'yi'zhi	0
大伊山石棺墓	da'yi'shan'shi'guan'mu	0
岱海遗址群	dai'hai'yi'zhi'qun	0
岱庙	dai'miao	0
代王城遗址	dai'wang'cheng'yi'zhi	0
地藏寺经幢	di'zang'si'jing'chuang	0
雕龙碑遗址	diao'long'bei'yi'zhi	0
丁村遗址	ding'cun'yi'zhi	0
洞沟古墓群	dong'gou'gu'mu'qun	0
东山嘴遗址	dong'shan'zui'yi'zhi	0
东下冯遗址	dong'xia'feng'yi'zhi	0
阿房宫遗址	e'pang'gong'yi'zhi	0
二龙湖古城遗址	er'long'hu'gu'cheng'yi'zhi	0
法海寺	fa'hai'si	0
飞来峰造像	fei'lai'feng'zao'xiang	0
封氏墓群	feng'shi'mu'qun	0
甘泉宫遗址	gan'quan'gong'yi'zhi	0
巩县石窟	gong'xian'shi'ku	0
古城寨城址	gu'cheng'zhai'cheng'zhi	0
广允缅寺	guang'yun'mian'si	0
虢国墓地	guo'guo'mu'di	0
果园新城墓群	guo'yuan'xin'cheng'mu'qun	0
海城仙人洞遗址	hai'cheng'xian'ren'dong'yi'zhi	0
汉长安城遗址	han'chang'an'cheng'yi'zhi	0
汉鲁王墓	han'lu'wang'mu	0
汉书遗址西团山遗址	han'shu'yi'zhi'xi'tuan'shan'yi'zhi	0
和林格尔土城子遗址	he'lin'ge'er'tu'cheng'zi'yi'zhi	0
河姆渡遗址	he'mu'du'yi'zhi	0
黑山头城址	hei'shan'tou'cheng'zhi	0
洪秀全故居	hong'xiu'quan'gu'ju	0
洪州窑遗址	hong'zhou'yao'yi'zhi	0
侯马晋国遗址	hou'ma'jin'guo'yi'zhi	0
湖田古瓷窑址	hu'tian'gu'ci'yao'zhi	0
华林寺大殿	hua'lin'si'da'dian	0
华清宫遗址	hua'qing'gong'yi'zhi	0
花戏楼	hua'xi'lou	0
黄帝陵	huang'di'ling	0
黄花岗七十二烈士墓	huang'hua'gang'qi'shi'er'lie'shi'mu	0
霍去病墓	huo'qu'bing'mu	0
鸡公山遗址	ji'gong'shan'yi'zhi	0
纪山楚墓群	ji'shan'chu'mu'qun	0
姜寨遗址	jiang'zhai'yi'zhi	0
金刚座舍利宝塔	jin'gang'zuo'she'li'bao'ta	0
金界壕遗迹	jin'jie'hao'yi'ji	0
金上京会宁府遗址	jin'shang'jing'hui'ning'fu'yi'zhi	0
晋阳古城遗址	jin'yang'gu'cheng'yi'zhi	0
金中都水关遗址	jin'zhong'dou'shui'guan'yi'zhi	0
净藏禅师塔	jing'cang'chan'shi'ta	0
卡若遗址	ka'ruo'yi'zhi	0
开元寺	kai'yuan'si	0
孔林	kong'lin	0
孔望山摩崖造像	kong'wang'shan'mo'ya'zao'xiang	0
蓝田猿人遗址	lan'tian'yuan'ren'yi'zhi	0
乐山大佛	le'shan'da'fo	0
李时珍墓	li'shi'zhen'mu	0
良渚遗址	liang'zhu'yi'zhi	0
辽阳白塔	liao'yang'bai'ta	0
辽阳壁画墓群	liao'yang'bi'hua'mu'qun	0
林则徐墓	lin'ze'xu'mu	0
林则徐销烟池与虎门炮台旧址	lin'ze'xu'xiao'yan'chi'yu'hu'men'pao'tai'jiu'zhi	0
临淄齐国故城	lin'zi'qi'guo'gu'cheng	0
灵渠	ling'qu	0
灵岩寺	ling'yan'si	0
六顶山古墓	liu'ding'shan'gu'mu	0
罗家坝遗址	luo'jia'ba'yi'zhi	0
罗通山城	luo'tong'shan'cheng	0
茂陵	mao'ling	0
梅庵	mei'an	0
孟庄遗址	meng'zhuang'yi'zhi	0
庙子沟遗址	miao'zi'gou'yi'zhi	0
明孝陵	ming'xiao'ling	0
明中都皇故城及皇陵石刻	ming'zhong'du'huang'gu'cheng'ji'huang'ling'shi'ke	0
莫高窟	mo'gao'ku	0
南石窟寺	nan'shi'ku'si	0
南庄头遗址	nan'zhuang'tou'yi'zhi	0
泥河湾遗址群	ni'he'wan'yi'zhi'qun	0
尼雅遗址	ni'ya'yi'zhi	0
牛街礼拜寺	niu'jie'li'bai'si	0
蒲津渡与蒲州故城遗址	pu'jin'du'yu'pu'zhou'gu'cheng'yi'zhi	0
戚城遗址	qi'cheng'yi'zhi	0
齐家坪遗址	qi'jia'ping'yi'zhi	0
栖霞寺舍利塔	qi'xia'si'she'li'ta	0
千佛崖造像	qian'fo'ya'zao'xiang	0
乾陵	qian'ling	0
秦始皇陵	qin'shi'huang'ling	0
清东陵	qing'dong'ling	0
青莲寺	qing'lian'si	0
青龙洞	qing'long'dong	0
清西陵	qing'xi'ling	0
清昭陵	qing'zhao'ling	0
曲村天马遗址	qu'cun'tian'ma'yi'zhi	0
曲阜鲁国故城	qu'fu'lu'guo'gu'cheng	0
曲回寺石佛冢	qu'hui'si'shi'fo'zhong	0
萨拉乌苏遗址	sa'la'wu'su'yi'zhi	0
三江平原汉魏时期遗址	san'jiang'ping'yuan'han'wei'shi'qi'yi'zhi	0
石家河遗址	shi'jia'he'yi'zhi	0
释迦文佛塔	shi'jia'wen'fo'ta	0
十三陵	shi'san'ling	0
柿子滩遗址	shi'zi'tan'yi'zhi	0
双林寺	shuang'lin'si	0
顺陵	shun'ling	0
司马迁墓和祠	si'ma'qian'mu'he'ci	0
宋陵	song'ling	0
宋庆龄墓	song'qing'ling'mu	0
苏巴什佛寺遗址	su'ba'shen'fo'si'yi'zhi	0
隋大兴	sui'da'xing	0
隋仁寿宫	sui'ren'shou'gong	0
锁阳城遗址	suo'yang'cheng'yi'zhi	0
塔虎城	ta'hu'cheng	0
太平天国侍王府	tai'ping'tian'guo'shi'wang'fu	0
太平天国天王府遗址	tai'ping'tian'guo'tian'wang'fu'yi'zhi	0
唐长安城遗址	tang'chang'an'cheng'yi'zhi	0
唐九成宫遗址	tang'jiu'cheng'gong'yi'zhi	0
堂子街太平天国壁画	tang'zi'jie'tai'ping'tian'guo'bi'hua	0
天宁寺大殿	tian'ning'si'da'dian	0
天台庵	tian'tai'an	0
铜录山古铜矿遗址	tong'lu'shan'gu'tong'kuang'yi'zhi	0
通天岩石窟	tong'tian'yan'shi'ku	0
统万城遗址	tong'wan'cheng'yi'zhi	0
驼山石窟	tuo'shan'shi'ku	0
万部华严经塔	wan'bu'hua'yan'jing'ta	0
丸都山故城	wan'dou'shan'gu'cheng	0
万发拨子遗址	wan'fa'bo'zi'yi'zhi	0
万佛堂石窟	wan'fo'tang'shi'ku	0
万荣东岳庙	wan'rong'dong'yue'miao	0
王城岗及阳城遗址	wang'cheng'gang'ji'yang'cheng'yi'zhi	0
望海楼教堂	wang'hai'lou'jiao'tang	0
王建墓	wang'jian'mu	0
魏长城遗址	wei'chang'cheng'yi'zhi	0
武昌起义军政府旧址	wu'chang'qi'yi'jun'zheng'fu'jiu'zhi	0
吴城遗址	wu'cheng'yi'zhi	0
五女山山城	wu'nv'shan'shan'cheng	0
西安清真寺	xi'an'qing'zhen'si	0
西安事变旧址	xi'an'shi'bian'jiu'zhi	0
西柏坡中共中央旧址	xi'bai'po'zhong'gong'zhong'yang'jiu'zhi	0
息烽集中营旧址	xi'feng'ji'zhong'ying'jiu'zhi	0
西山遗址	xi'shan'yi'zhi	0
西岳庙	xi'yue'miao	0
西寨遗址	xi'zhai'yi'zhi	0
仙水岩崖墓群	xian'shui'yan'ya'mu'qun	0
新乐遗址	xin'yue'yi'zhi	0
兴隆洼遗址	xing'long'wa'yi'zhi	0
邢窑遗址	xing'yao'yi'zhi	0
修定寺塔	xiu'ding'si'ta	0
许家窑侯家窑遗址	xu'jia'yao'hou'jia'yao'yi'zhi	0
须弥山石窟	xu'mi'shan'shi'ku	0
玄妙观三清殿	xuan'miao'guan'san'qing'dian	0
玄贞观	xuan'zhen'guan	0
薛家岗遗址	xue'jia'gang'yi'zhi	0
焉不拉克古墓群	yan'bu'la'ke'gu'mu'qun	0
岩山寺	yan'shan'si	0
燕下都遗址	yan'xia'dou'yi'zhi	0
杨粲墓	yang'can'mu	0
仰韶村遗址	yang'shao'cun'yi'zhi	0
扬州城遗址	yang'zhou'cheng'yi'zhi	0
一百零八塔	yi'bai'ling'ba'ta	0
义和团吕祖堂坛口遗址	yi'he'tuan'lv'zu'tang'tan'kou'yi'zhi	0
殷墟	yin'xu	0
应昌路故城遗址	ying'chang'lu'gu'cheng'yi'zhi	0
玉皇庙	yu'huang'miao	0
榆林窟	yu'lin'ku	0
玉泉寺及铁塔	yu'quan'si'ji'tie'ta	0
元谋猿人遗址	yuan'mou'yuan'ren'yi'zhi	0
元中都遗址	yuan'zhong'du'yi'zhi	0
岳飞墓	yue'fei'mu	0
云冈石窟	yun'gang'shi'ku	0
藏王墓	zang'wang'mu	0
赵邯郸故城	zhao'han'dan'gu'cheng	0
昭陵	zhao'ling	0
郑成功墓	zheng'cheng'gong'mu	0
郑国渠首遗址	zheng'guo'qu'shou'yi'zhi	0
郑韩故城	zheng'han'gu'cheng	0
郑州商代遗址	zheng'zhou'shang'dai'yi'zhi	0
中国社会主义青年团中央机关旧址	zhong'guo'she'hui'zhu'yi'qing'nian'tuan'zhong'yang'ji'guan'jiu'zhi	0
钟山石窟	zhong'shan'shi'ku	0
周口店遗址	zhou'kou'dian'yi'zhi	0
周原遗址	zhou'yuan'yi'zhi	0
