保健茶	bao'jian'cha	0
保健酒	bao'jian'jiu	0
保健品	bao'jian'pin	0
保健品代理	bao'jian'pin'dai'li	0
保健食品	bao'jian'shi'pin	0
保健项目合作	bao'jian'xiang'mu'he'zuo	0
保健用品	bao'jian'yong'pin	0
保健用品加工	bao'jian'yong'pin'jia'gong	0
补钙	bu'gai	0
补血	bu'xue	0
畜用药	chu'yong'yao	0
促进生长发育	cu'jin'sheng'zhang'fa'yu	0
导管	dao'guan	0
电子脉冲治疗仪	dian'zi'mai'chong'zhi'liao'yi	0
动物原药材	dong'wu'yuan'yao'cai	0
儿科用药	er'ke'yong'yao	0
二手医疗设备	er'shou'yi'liao'she'bei	0
二手制药设备	er'shou'zhi'yao'she'bei	0
妇科用药	fu'ke'yong'yao	0
敷料	fu'liao	0
改善记忆	gai'shan'ji'yi	0
改善视力	gai'shan'shi'li	0
改善胃肠	gai'shan'wei'chang	0
功能饮料	gong'neng'yin'liao	0
骨及关节康复用品	gu'ji'guan'jie'kang'fu'yong'pin	0
骨伤科用药	gu'shang'ke'yong'yao	0
护创材料	hu'chuang'cai'liao	0
护肝	hu'gan	0
急救包	ji'jiu'bao	0
急救箱	ji'jiu'xiang	0
家用血糖仪	jia'yong'xue'tang'yi	0
家用血压计	jia'yong'xue'ya'ji	0
减肥	jian'fei	0
减肥用品	jian'fei'yong'pin	0
监护设备	jian'hu'she'bei	0
检验分析设备	jian'yan'fen'xi'she'bei	0
矫正设备	jiao'zheng'she'bei	0
介入性材料	jie'ru'xing'cai'liao	0
菌苗	jun'miao	0
康复理疗设备	kang'fu'li'liao'she'bei	0
抗体	kang'ti	0
抗原	kang'yuan	0
库存医药用品	ku'cun'yi'yao'yong'pin	0
矿物原药材	kuang'wu'yuan'yao'cai	0
酶酵素制剂	mei'jiao'su'zhi'ji	0
美容	mei'rong	0
免疫抗疲劳	mian'yi'kang'pi'lao	0
内科用药	nei'ke'yong'yao	0
皮肤科用药	pi'fu'ke'yong'yao	0
其他保健食品	qi'ta'bao'jian'shi'pin	0
其他保健用品	qi'ta'bao'jian'yong'pin	0
其他生物制品	qi'ta'sheng'wu'zhi'pin	0
其他未分类	qi'ta'wei'fen'lei	0
其它未分类	qi'ta'wei'fen'lei	0
其他医疗器具	qi'ta'yi'liao'qi'ju	0
其他医用材料	qi'ta'yi'yong'cai'liao	0
其他制药设备	qi'ta'zhi'yao'she'bei	0
其他中成药	qi'ta'zhong'cheng'yao	0
气血循环机	qi'xue'xun'huan'ji	0
牵引	qian'yin	0
人造器官及植入体	ren'zao'qi'guan'ji'zhi'ru'ti	0
生物诊断试剂	sheng'wu'zhen'duan'shi'ji	0
生物制品	sheng'wu'zhi'pin	0
视力保健用品	shi'li'bao'jian'yong'pin	0
手术器械	shou'shu'qi'xie	0
手术卫生用品	shou'shu'wei'sheng'yong'pin	0
手术专用设备	shou'shu'zhuan'yong'she'bei	0
睡眠	shui'mian	0
睡眠保健用品	shui'mian'bao'jian'yong'pin	0
调节血脂	tiao'jie'xue'zhi	0
通用医疗器具	tong'yong'yi'liao'qi'ju	0
外科用药	wai'ke'yong'yao	0
五官科用药	wu'guan'ke'yong'yao	0
西药	xi'yao	0
消毒防腐药剂	xiao'du'fang'fu'yao'ji	0
消毒灭菌设备	xiao'du'mie'jun'she'bei	0
性保健品	xing'bao'jian'pin	0
血糖	xue'tang	0
血压	xue'ya	0
血压调节用品	xue'ya'tiao'jie'yong'pin	0
血液制品	xue'ye'zhi'pin	0
延缓衰老	yan'huan'shuai'lao	0
养肾	yang'shen	0
药酒	yao'jiu	0
药品包装机械	yao'pin'bao'zhuang'ji'xie	0
药品加工	yao'pin'jia'gong	0
药用包装材料	yao'yong'bao'zhuang'cai'liao	0
药用粉碎机械	yao'yong'fen'sui'ji'xie	0
一次性医用耗材	yi'ci'xing'yi'yong'hao'cai	0
医护辅助设备	yi'hu'fu'zhu'she'bei	0
医疗保健服务	yi'liao'bao'jian'fu'wu	0
医疗器具	yi'liao'qi'ju	0
医疗器械	yi'liao'qi'xie	0
医疗器械代理	yi'liao'qi'xie'dai'li	0
医疗器械加工	yi'liao'qi'xie'jia'gong	0
医疗器械制造设备	yi'liao'qi'xie'zhi'zao'she'bei	0
医疗设备	yi'liao'she'bei	0
疫苗	yi'miao	0
医药代理	yi'yao'dai'li	0
医药项目合作	yi'yao'xiang'mu'he'zuo	0
医药中间体	yi'yao'zhong'jian'ti	0
医用材料	yi'yong'cai'liao	0
医用车	yi'yong'che	0
医用器皿	yi'yong'qi'min	0
医用橡胶制品	yi'yong'xiang'jiao'zhi'pin	0
饮片机械	yin'pian'ji'xie	0
原料药	yuan'liao'yao	0
原料药设备及机械	yuan'liao'yao'she'bei'ji'ji'xie	0
诊察设备	zhen'cha'she'bei	0
制剂机械	zhi'ji'ji'xie	0
治疗设备	zhi'liao'she'bei	0
植物提取物	zhi'wu'ti'qu'wu	0
植物原药材	zhi'wu'yuan'yao'cai	0
制药辅料	zhi'yao'fu'liao	0
制药设备	zhi'yao'she'bei	0
中成药	zhong'cheng'yao	0
中药	zhong'yao	0
中药饮片	zhong'yao'yin'pian	0
中医器械	zhong'yi'qi'xie	0
注射穿刺器械	zhu'she'chuan'ci'qi'xie	0
