白果冻	bai'guo'dong	0
白虎纹瓦当	bai'hu'wen'wa'dang	0
白瑞	bai'rui	0
白水兴隆寺石雕像	bai'shui'xing'long'si'shi'diao'xiang	0
白田石	bai'tian'shi	0
保圣寺罗汉像	bao'sheng'si'luo'han'xiang	0
碑版	bei'ban	0
贝雕	bei'diao	0
碑额	bei'e	0
北海琉璃九龙壁	bei'hai'liu'li'jiu'long'bi	0
碑碣	bei'jie	0
北京西陵隆恩殿楠木雕刻	bei'jing'xi'ling'long'en'dian'nan'mu'diao'ke	0
北京砖雕	bei'jing'zhuan'diao	0
碑刻工艺	bei'ke'gong'yi	0
北宋涤器画像砖	bei'song'di'qi'hua'xiang'zhuan	0
北宋结发画像砖	bei'song'jie'fa'hua'xiang'zhuan	0
北宋烹茶画像砖	bei'song'peng'cha'hua'xiang'zhuan	0
北宋泼塑鱼形水丞	bei'song'po'su'yu'xing'shui'cheng	0
北宋石雕函	bei'song'shi'diao'han	0
北宋斫鲙画像砖	bei'song'zhuo'kuai'hua'xiang'zhuan	0
北魏洛阳时期瓦当	bei'wei'luo'yang'shi'qi'wa'dang	0
北魏平城时期瓦当	bei'wei'ping'cheng'shi'qi'wa'dang	0
北魏石雕柱础	bei'wei'shi'diao'zhu'chu	0
北魏石窟寺	bei'wei'shi'ku'si	0
薄地阳文	bo'di'yang'wen	0
薄意	bo'yi	0
不锈钢雕塑	bu'xiu'gang'diao'su	0
彩雕	cai'diao	0
彩花石	cai'hua'shi	0
彩塑	cai'su	0
彩塑拨金彩锥	cai'su'bo'jin'cai'zhui	0
彩塑倒杂月	cai'su'dao'za'yue	0
彩塑上中五彩	cai'su'shang'zhong'wu'cai	0
彩塑下五彩	cai'su'xia'wu'cai	0
彩塑下中五彩	cai'su'xia'zhong'wu'cai	0
彩塑中五彩	cai'su'zhong'wu'cai	0
苍山白玉	cang'shan'bai'yu	0
沧州铁狮	cang'zhou'tie'shi	0
昌化冻	chang'hua'dong	0
昌化石	chang'hua'shi	0
长乐未央瓦当	chang'le'wei'yang'wa'dang	0
陈蒨永宁陵石刻	chen'qian'yong'ning'ling'shi'ke	0
成都万佛寺石造像	cheng'du'wan'fo'si'shi'zao'xiang	0
锤鍱	chui'ye	0
纯白石	chun'bai'shi	0
春秋战国俑	chun'qiu'zhan'guo'yong	0
瓷刻	ci'ke	0
大阿福	da'a'fu	0
大理石	da'li'shi	0
大同琉璃九龙壁	da'tong'liu'li'jiu'long'bi	0
大汶口文化骨雕筒	da'wen'kou'wen'hua'gu'diao'tong	0
大足石刻	da'zu'shi'ke	0
灯担木雕	deng'dan'mu'diao	0
灯光石	deng'guang'shi	0
灯明石	deng'ming'shi	0
邓县画像砖	deng'xian'hua'xiang'zhuan	0
雕佛	diao'fo	0
雕卵	diao'luan	0
雕人	diao'ren	0
雕塑刀法	diao'su'dao'fa	0
定窑瓷塑法螺	ding'yao'ci'su'fa'luo	0
东山雕花楼	dong'shan'diao'hua'lou	0
冻石	dong'shi	0
东阳木雕	dong'yang'mu'diao	0
锻铜雕塑	duan'tong'diao'su	0
对兽纹透雕石板	dui'shou'wen'tou'diao'shi'ban	0
敦煌彩塑	dun'huang'cai'su	0
敦煌石窟北朝塑像	dun'huang'shi'ku'bei'chao'su'xiang	0
敦煌石窟隋唐塑像	dun'huang'shi'ku'sui'tang'su'xiang	0
反簧	fan'huang	0
翻簧竹刻	fan'huang'zhu'ke	0
饭石	fan'shi	0
飞鸿延年瓦当	fei'hong'yan'nian'wa'dang	0
飞来峰造像	fei'lai'feng'zao'xiang	0
粉塑	fen'su	0
凤翔泥偶	feng'xiang'ni'ou	0
缚彬像	fu'bin'xiang	0
妇好墓骨器	fu'hao'mu'gu'qi	0
福建天然疤树根雕	fu'jian'tian'ran'ba'shu'gen'diao	0
芙蓉石	fu'rong'shi	0
高山石	gao'shan'shi	0
巩县北宋陵墓石刻	gong'xian'bei'song'ling'mu'shi'ke	0
巩县石窟	gong'xian'shi'ku	0
古砖	gu'zhuan	0
关字瓦当	guan'zi'wa'dang	0
广东金漆木雕	guang'dong'jin'qi'mu'diao	0
广东砖雕	guang'dong'zhuan'diao	0
龟趺	gui'fu	0
鬼功毬	gui'gong'qiu	0
滚龙柱	gun'long'zhu	0
郭公砖	guo'gong'zhuan	0
果核雕刻	guo'he'diao'ke	0
汉代斧车画像砖	han'dai'fu'che'hua'xiang'zhuan	0
汉代俳优陶俩	han'dai'pai'you'tao'lia	0
汉代骑吹画像砖	han'dai'qi'chui'hua'xiang'zhuan	0
汉代丸剑宴舞画像砖	han'dai'wan'jian'yan'wu'hua'xiang'zhuan	0
汉代小车画像砖	han'dai'xiao'che'hua'xiang'zhuan	0
汉代俑	han'dai'yong	0
汉代乐舞杂技陶俑	han'dai'yue'wu'za'ji'tao'yong	0
汉画像石雕刻技法	han'hua'xiang'shi'diao'ke'ji'fa	0
汉画像砖墓	han'hua'xiang'zhuan'mu	0
汉市井画像砖	han'shi'jing'hua'xiang'zhuan	0
河姆渡文化骨匕	he'mu'du'wen'hua'gu'bi	0
河姆渡文化骨牙器	he'mu'du'wen'hua'gu'ya'qi	0
河姆渡文化木雕鱼	he'mu'du'wen'hua'mu'diao'yu	0
河姆渡文化鸟形牙雕	he'mu'du'wen'hua'niao'xing'ya'diao	0
河姆渡文化双鸟朝阳纹牙雕	he'mu'du'wen'hua'shuang'niao'zhao'yang'wen'ya'diao	0
核桃面人	he'tao'mian'ren	0
河州砖雕	he'zhou'zhuan'diao	0
红山文化女神彩塑头像	hong'shan'wen'hua'nv'shen'cai'su'tou'xiang	0
红田石	hong'tian'shi	0
猴柴磹	hou'chai'tan	0
侯马董玘坚傃金墓砖雕	hou'ma'dong'qi'jian'su'jin'mu'zhuan'diao	0
护桩泥	hu'zhuang'ni	0
画像砖	hua'xiang'zhuan	0
画像砖制作工艺	hua'xiang'zhuan'zhi'zuo'gong'yi	0
华严寺辽代彩塑	hua'yan'si'liao'dai'cai'su	0
花砖	hua'zhuan	0
黄冻	huang'dong	0
黄杨木雕	huang'yang'mu'diao	0
惠山彩塑配色	hui'shan'cai'su'pei'se	0
惠山彩塑上彩技法	hui'shan'cai'su'shang'cai'ji'fa	0
惠山彩塑纹样运用	hui'shan'cai'su'wen'yang'yun'yong	0
惠山儿童耍货生产工艺	hui'shan'er'tong'shua'huo'sheng'chan'gong'yi	0
惠山泥人	hui'shan'ni'ren	0
惠山手捏戏文生产工艺	hui'shan'shou'nie'xi'wen'sheng'chan'gong'yi	0
徽州砖雕	hui'zhou'zhuan'diao	0
霍去病墓石雕	huo'qu'bing'mu'shi'diao	0
鸡血石	ji'xue'shi	0
剑川石钟山石窟	jian'chuan'shi'zhong'shan'shi'ku	0
江南留青竹刻	jiang'nan'liu'qing'zhu'ke	0
晋祠宋塑	jin'ci'song'su	0
金木雕	jin'mu'diao	0
金铜佛造像	jin'tong'fo'zao'xiang	0
经幢	jing'chuang	0
菊花石雕	ju'hua'shi'diao	0
空腹砖	kong'fu'zhuan	0
空青	kong'qing	0
空心砖	kong'xin'zhuan	0
空砖	kong'zhuan	0
圹砖	kuang'zhuan	0
蜡像	la'xiang	0
蓝花冻	lan'hua'dong	0
蓝田水陆庵壁塑佛像故事	lan'tian'shui'lu'an'bi'su'fo'xiang'gu'shi	0
兰州刻绘葫芦	lan'zhou'ke'hui'hu'lu	0
老岭石	lao'ling'shi	0
勒线	le'xian	0
辽代牡丹纹花砖	liao'dai'mu'dan'wen'hua'zhuan	0
辽代十一面观音泥塑	liao'dai'shi'yi'mian'guan'yin'ni'su	0
料器雕刻	liao'qi'diao'ke	0
柳坪石	liu'ping'shi	0
留青竹刻	liu'qing'zhu'ke	0
龙门奉先寺	long'men'feng'xian'si	0
龙门看经寺	long'men'kan'jing'si	0
龙门万佛洞	long'men'wan'fo'dong	0
龙门药方洞	long'men'yao'fang'dong	0
龙眼木雕	long'yan'mu'diao	0
芦沟桥石狮	lu'gou'qiao'shi'shi	0
鹿目格	lu'mu'ge	0
鹿纹瓦当	lu'wen'wa'dang	0
芦荫	lu'yin	0
螺杯	luo'bei	0
螺钿雕	luo'dian'diao	0
玛瑙冻	ma'nao'dong	0
麦积山泥塑菩萨	mai'ji'shan'ni'su'pu'sa	0
梅花碑	mei'hua'bei	0
煤精	mei'jing	0
煤精雕刻	mei'jing'diao'ke	0
迷翠寮	mi'cui'liao	0
面人	mian'ren	0
面塑	mian'su	0
明代彩塑二十四乐女像	ming'dai'cai'su'er'shi'si'le'nv'xiang	0
明代瓷塑达摩渡海像	ming'dai'ci'su'da'mo'du'hai'xiang	0
明代瓷塑观音像	ming'dai'ci'su'guan'yin'xiang	0
明代大型犀角杯	ming'dai'da'xing'xi'jiao'bei	0
明代俑	ming'dai'yong	0
明十八学士木雕	ming'shi'ba'xue'shi'mu'diao	0
明孝陵石雕	ming'xiao'ling'shi'diao	0
模印拼嵌画像砖	mo'yin'pin'qian'hua'xiang'zhuan	0
墓碑	mu'bei	0
墓表	mu'biao	0
木雕	mu'diao	0
墓碣	mu'jie	0
南朝梁代陵墓石刻	nan'chao'liang'dai'ling'mu'shi'ke	0
南朝陵墓石刻	nan'chao'ling'mu'shi'ke	0
南朝齐代陵墓石刻	nan'chao'qi'dai'ling'mu'shi'ke	0
南朝宋代陵墓石刻	nan'chao'song'dai'ling'mu'shi'ke	0
尼姑楼	ni'gu'lou	0
泥人张	ni'ren'zhang	0
泥塑	ni'su	0
捏段镶手	nie'duan'xiang'shou	0
捏相	nie'xiang	0
牛角冻	niu'jiao'dong	0
瓯塑	ou'su	0
皮雕	pi'diao	0
旗降石	qi'jiang'shi	0
栖霞山石刻	qi'xia'shan'shi'ke	0
乾陵石雕	qian'ling'shi'diao	0
秦代兵马俑	qin'dai'bing'ma'yong	0
秦代兵马俑塑造工艺	qin'dai'bing'ma'yong'su'zao'gong'yi	0
秦代动物纹瓦当	qin'dai'dong'wu'wen'wa'dang	0
秦代凤纹砖	qin'dai'feng'wen'zhuan	0
秦代跽坐陶俑	qin'dai'ji'zuo'tao'yong	0
秦代龙纹砖	qin'dai'long'wen'zhuan	0
秦代陶俑	qin'dai'tao'yong	0
秦代植物纹瓦当	qin'dai'zhi'wu'wen'wa'dang	0
秦汉瓦当图案	qin'han'wa'dang'tu'an	0
秦汉瓦当文字	qin'han'wa'dang'wen'zi	0
秦云纹瓦当	qin'yun'wen'wa'dang	0
琴砖	qin'zhuan	0
秦砖	qin'zhuan	0
清代瓷塑钟馗醉酒像	qing'dai'ci'su'zhong'kui'zui'jiu'xiang	0
清代牧牛图竹刻笔筒	qing'dai'mu'niu'tu'zhu'ke'bi'tong	0
清代陶塑济公像	qing'dai'tao'su'ji'gong'xiang	0
青龙纹瓦当	qing'long'wen'wa'dang	0
青田冻	qing'tian'dong	0
青田石	qing'tian'shi	0
青田石雕	qing'tian'shi'diao	0
人首鱼身瓷俑	ren'shou'yu'shen'ci'yong	0
软木雕画	ruan'mu'diao'hua	0
山陕甘会馆砖	shan'shan'gan'hui'guan'zhuan	0
商代骨制品制作	shang'dai'gu'zhi'pin'zhi'zuo	0
商代虎纹大石磬	shang'dai'hu'wen'da'shi'qing	0
商代泥塑人像	shang'dai'ni'su'ren'xiang	0
商代石雕虎首人身像	shang'dai'shi'diao'hu'shou'ren'shen'xiang	0
商代石雕人像残件	shang'dai'shi'diao'ren'xiang'can'jian	0
商代石雕坐食人像	shang'dai'shi'diao'zuo'shi'ren'xiang	0
商代象牙杯	shang'dai'xiang'ya'bei	0
商周骨器	shang'zhou'gu'qi	0
少林寺明达摩面壁图石刻	shao'lin'si'ming'da'mo'mian'bi'tu'shi'ke	0
少林寺明达摩一苇渡江图石刻	shao'lin'si'ming'da'mo'yi'wei'du'jiang'tu'shi'ke	0
蛇匏	she'pao	0
生肖瓷俑	sheng'xiao'ci'yong	0
石碑	shi'bei	0
石刻线画	shi'ke'xian'hua	0
石人石兽	shi'ren'shi'shou	0
石狮	shi'shi	0
石狮子	shi'shi'zi	0
寿山石	shou'shan'shi	0
寿山石雕	shou'shan'shi'diao	0
树根雕	shu'gen'diao	0
双林寺彩塑	shuang'lin'si'cai'su	0
水花石	shui'hua'shi	0
水晶冻	shui'jing'dong	0
水墨石	shui'mo'shi	0
水泉石窟	shui'quan'shi'ku	0
顺陵石雕	shun'ling'shi'diao	0
寺坪石	si'ping'shi	0
宋代丁都赛砖雕	song'dai'ding'dou'sai'zhuan'diao	0
宋代泥人	song'dai'ni'ren	0
宋代陶捏塑像	song'dai'tao'nie'su'xiang	0
宋元明清瓦当	song'yuan'ming'qing'wa'dang	0
塑像	su'xiang	0
塑真	su'zhen	0
苏州泥塑	su'zhou'ni'su	0
苏州捏像	su'zhou'nie'xiang	0
苏州砖雕	su'zhou'zhuan'diao	0
隋唐瓦当	sui'tang'wa'dang	0
台座	tai'zuo	0
唐代彩绘釉陶女骑俑	tang'dai'cai'hui'you'tao'nv'qi'yong	0
唐代雕竹人物花鸟纺尺八	tang'dai'diao'zhu'ren'wu'hua'niao'fang'chi'ba	0
唐代载物骆驼画像砖	tang'dai'zai'wu'luo'tuo'hua'xiang'zhuan	0
唐十一面观音石像	tang'shi'yi'mian'guan'yin'shi'xiang	0
唐塑	tang'su	0
桃花冻	tao'hua'dong	0
桃花石	tao'hua'shi	0
陶刻	tao'ke	0
剔地	ti'di	0
题额	ti'e	0
田黄石	tian'huang'shi	0
天津砖雕	tian'jin'zhuan'diao	0
天蓝冻	tian'lan'dong	0
贴簧	tie'huang	0
铁影壁	tie'ying'bi	0
亭长砖	ting'zhang'zhuan	0
铜接引佛	tong'jie'yin'fo	0
吐蕃石刻像	tu'fan'shi'ke'xiang	0
土牛	tu'niu	0
土偶	tu'ou	0
土稚	tu'zhi	0
驼山石窟	tuo'shan'shi'ku	0
瓦当	wa'dang	0
瓦挡	wa'dang	0
瓦当文	wa'dang'wen	0
瓦头	wa'tou	0
望天犼	wang'tian'hou	0
微雕	wei'diao	0
魏晋南北朝瓦当	wei'jin'nan'bei'chao'wa'dang	0
魏太和造像	wei'tai'he'zao'xiang	0
卫字瓦当	wei'zi'wa'dang	0
文竹	wen'zhu	0
翁仲	weng'zhong	0
西安碑林	xi'an'bei'lin	0
西晋南北朝俑	xi'jin'nan'bei'chao'yong	0
西藏佛教模制小泥像	xi'zang'fo'jiao'mo'zhi'xiao'ni'xiang	0
西周骨器制作工艺	xi'zhou'gu'qi'zhi'zuo'gong'yi	0
西周至战国瓦当	xi'zhou'zhi'zhan'guo'wa'dang	0
陷地深刻	xian'di'shen'ke	0
线刻	xian'ke	0
相石	xiang'shi	0
响堂山石窟	xiang'tang'shan'shi'ku	0
象牙	xiang'ya	0
象牙雕刻	xiang'ya'diao'ke	0
萧绩墓石刻	xiao'ji'mu'shi'ke	0
萧景墓石刻	xiao'jing'mu'shi'ke	0
萧秀墓石刻	xiao'xiu'mu'shi'ke	0
醒酒石	xing'jiu'shi	0
雄精雕刻	xiong'jing'diao'ke	0
修砖	xiu'zhuan	0
须弥山石窟	xu'mi'shan'shi'ku	0
玄武纹瓦当	xuan'wu'wen'wa'dang	0
牙雕大观园	ya'diao'da'guan'yuan	0
杨家湾汉墓骑兵俑	yang'jia'wan'han'mu'qi'bing'yong	0
阳纹砂地	yang'wen'sha'di	0
椰杯	ye'bei	0
椰雕	ye'diao	0
椰雕杯	ye'diao'bei	0
叶蜡石	ye'la'shi	0
椰瓢	ye'piao	0
椰珠	ye'zhu	0
颐和园铜牛	yi'he'yuan'tong'niu	0
弋射收获画砖像	yi'she'shou'huo'hua'zhuan'xiang	0
印段镶手	yin'duan'xiang'shou	0
瘿杯	ying'bei	0
瘿柟杯	ying'ran'bei	0
永陵石刻	yong'ling'shi'ke	0
永受嘉福瓦当	yong'shou'jia'fu'wa'dang	0
油泥彩塑	you'ni'cai'su	0
油泥塑	you'ni'su	0
鱼脑冻	yu'nao'dong	0
玉眼	yu'yan	0
羽阳千秋瓦当	yu'yang'qian'qiu'wa'dang	0
元代影青瓷塑观音	yuan'dai'ying'qing'ci'su'guan'yin	0
元代杂剧陶俩	yuan'dai'za'ju'tao'lia	0
元双凤麒麟石雕	yuan'shuang'feng'qi'lin'shi'diao	0
云灰石	yun'hui'shi	0
云南昭通出土汉画像砖	yun'nan'zhao'tong'chu'tu'han'hua'xiang'zhuan	0
造像	zao'xiang	0
造像碑	zao'xiang'bei	0
战国浮雕石板	zhan'guo'fu'diao'shi'ban	0
战国刻花石板	zhan'guo'ke'hua'shi'ban	0
旃檀木雕弥勒大佛	zhan'tan'mu'diao'mi'le'da'fo	0
昭陵六骏	zhao'ling'liu'jun	0
赵州桥蟠龙栏板浮雕	zhao'zhou'qiao'pan'long'lan'ban'fu'diao	0
郑于鹤彩塑	zheng'yu'he'cai'su	0
冢字瓦当	zhong'zi'wa'dang	0
竹根雕	zhu'gen'diao	0
竹簧	zhu'huang	0
竹刻	zhu'ke	0
竹刻地纹	zhu'ke'di'wen	0
竹林七贤画像砖	zhu'lin'qi'xian'hua'xiang'zhuan	0
朱雀纹瓦当	zhu'que'wen'wa'dang	0
铸铜雕塑	zhu'tong'diao'su	0
砖雕	zhuan'diao	0
砖雕雕凿	zhuan'diao'diao'zao	0
砖雕刊光	zhuan'diao'kan'guang	0
砖雕描刻样稿	zhuan'diao'miao'ke'yang'gao	0
砖雕磨光	zhuan'diao'mo'guang	0
砖雕上浆贴样	zhuan'diao'shang'jiang'tie'yang	0
砖雕贴金	zhuan'diao'tie'jin	0
砖雕修补	zhuan'diao'xiu'bu	0
砖雕装置刷浆	zhuan'diao'zhuang'zhi'shua'jiang	0
篆额	zhuan'e	0
装藏	zhuang'cang	0
紫金庵彩塑	zi'jin'an'cai'su	0
资中炭精雕刻	zi'zhong'tan'jing'diao'ke	0
