八负责假劣药品的报告	ba'fu'ze'jia'lie'yao'pin'de'bao'gao	0
八计算机系统的操作和管理	ba'ji'suan'ji'xi'tong'de'cao'zuo'he'guan'li	0
八验收发货退货的专用场所	ba'yan'shou'fa'huo'tui'huo'de'zhuan'yong'chang'suo	0
八药品有效期的管理	ba'yao'pin'you'xiao'qi'de'guan'li	0
八质量事故质量投诉的管理	ba'zhi'liang'shi'gu'zhi'liang'tou'su'de'guan'li	0
第八节采购	di'ba'jie'cai'gou	0
第八节售后管理	di'ba'jie'shou'hou'guan'li	0
第二节人员管理	di'er'jie'ren'yuan'guan'li	0
第二节组织机构与质量管理职责	di'er'jie'zu'zhi'ji'gou'yu'zhi'liang'guan'li'zhi'ze	0
第二章药品批发的质量管理	di'er'zhang'yao'pin'pi'fa'de'zhi'liang'guan'li	0
第九节收货与验收	di'jiu'jie'shou'huo'yu'yan'shou	0
第六节陈列与储存	di'liu'jie'chen'lie'yu'chu'cun	0
第六节校准与验证	di'liu'jie'jiao'zhun'yu'yan'zheng	0
第七节计算机系统	di'qi'jie'ji'suan'ji'xi'tong	0
第七节销售管理	di'qi'jie'xiao'shou'guan'li	0
第三节人员与培训	di'san'jie'ren'yuan'yu'pei'xun	0
第三节文件	di'san'jie'wen'jian	0
第三章药品零售的质量管理	di'san'zhang'yao'pin'ling'shou'de'zhi'liang'guan'li	0
第十二节出库	di'shi'er'jie'chu'ku	0
第十节储存与养护	di'shi'jie'chu'cun'yu'yang'hu	0
第十三节运输与配送	di'shi'san'jie'yun'shu'yu'pei'song	0
第十四节售后管理	di'shi'si'jie'shou'hou'guan'li	0
第十一节销售	di'shi'yi'jie'xiao'shou	0
第四节设施与设备	di'si'jie'she'shi'yu'she'bei	0
第四节质量管理体系文件	di'si'jie'zhi'liang'guan'li'ti'xi'wen'jian	0
第四章附则	di'si'zhang'fu'ze	0
第五节采购与验收	di'wu'jie'cai'gou'yu'yan'shou	0
第五节设施与设备	di'wu'jie'she'shi'yu'she'bei	0
第一节质量管理体系	di'yi'jie'zhi'liang'guan'li'ti'xi	0
第一节质量管理与职责	di'yi'jie'zhi'liang'guan'li'yu'zhi'ze	0
第一章总则	di'yi'zhang'zong'ze	0
二避光通风防潮防虫防鼠等设备	er'bi'guang'tong'feng'fang'chao'fang'chong'fang'shu'deng'she'bei	0
二储存药品相对湿度为	er'chu'cun'yao'pin'xiang'dui'shi'du'wei	0
二处方审核调配核对	er'chu'fang'shen'he'tiao'pei'he'dui	0
二供货单位和采购品种的审核	er'gong'huo'dan'wei'he'cai'gou'pin'zhong'de'shen'he	0
二监测调控温度的设备	er'jian'ce'tiao'kong'wen'du'de'she'bei	0
二确定所购入药品的合法性	er'que'ding'suo'gou'ru'yao'pin'de'he'fa'xing	0
二十二其他应当规定的内容	er'shi'er'qi'ta'ying'dang'gui'ding'de'nei'rong	0
二十计算机系统的管理	er'shi'ji'suan'ji'xi'tong'de'guan'li	0
二十一执行药品电子监管的规定	er'shi'yi'zhi'xing'yao'pin'dian'zi'jian'guan'de'gui'ding	0
二质量否决权的规定	er'zhi'liang'fou'jue'quan'de'gui'ding	0
九不合格药品药品销毁的管理	jiu'bu'he'ge'yao'pin'yao'pin'xiao'hui'de'guan'li	0
九不合格药品专用存放场所	jiu'bu'he'ge'yao'pin'zhuan'yong'cun'fang'chang'suo	0
九负责假劣药品的报告	jiu'fu'ze'jia'lie'yao'pin'de'bao'gao	0
九负责药品质量查询	jiu'fu'ze'yao'pin'zhi'liang'cha'xun	0
六不合格药品专用存放场所	liu'bu'he'ge'yao'pin'zhuan'yong'cun'fang'chang'suo	0
六记录和凭证的管理	liu'ji'lu'he'ping'zheng'de'guan'li	0
六药品运输的质量保证及责任	liu'yao'pin'yun'shu'de'zhi'liang'bao'zheng'ji'ze'ren	0
六营业场所药品陈列及检查	liu'ying'ye'chang'suo'yao'pin'chen'lie'ji'jian'cha	0
七包装物料的存放场所	qi'bao'zhuang'wu'liao'de'cun'fang'chang'suo	0
七定期汇总分析养护信息	qi'ding'qi'hui'zong'fen'xi'yang'hu'xin'xi	0
七收集和查询质量信息的管理	qi'shou'ji'he'cha'xun'zhi'liang'xin'xi'de'guan'li	0
七特殊管理的药品的规定	qi'te'shu'guan'li'de'yao'pin'de'gui'ding	0
七营业场所冷藏药品的存放	qi'ying'ye'chang'suo'leng'cang'yao'pin'de'cun'fang	0
七质量保证协议的有效期限	qi'zhi'liang'bao'zheng'xie'yi'de'you'xiao'qi'xian	0
三处方药销售的管理	san'chu'fang'yao'xiao'shou'de'guan'li	0
三供货单位及供货品种相关资料	san'gong'huo'dan'wei'ji'gong'huo'pin'zhong'xiang'guan'zi'liao	0
三有效监测和调控温湿度的设备	san'you'xiao'jian'ce'he'tiao'kong'wen'shi'du'de'she'bei	0
三质量管理文件的管理	san'zhi'liang'guan'li'wen'jian'de'guan'li	0
三中药饮片处方审核调配核对	san'zhong'yao'yin'pian'chu'fang'shen'he'tiao'pei'he'dui	0
十八其他应当规定的内容	shi'ba'qi'ta'ying'dang'gui'ding'de'nei'rong	0
十八设施设备验证和校准的管理	shi'ba'she'shi'she'bei'yan'zheng'he'jiao'zhun'de'guan'li	0
十二环境卫生人员健康的规定	shi'er'huan'jing'wei'sheng'ren'yuan'jian'kang'de'gui'ding	0
十二质量查询的管理	shi'er'zhi'liang'cha'xun'de'guan'li	0
十二组织验证校准相关设施设备	shi'er'zu'zhi'yan'zheng'jiao'zhun'xiang'guan'she'shi'she'bei	0
十负责药品不良反应的报告	shi'fu'ze'yao'pin'bu'liang'fan'ying'de'bao'gao	0
十九记录和凭证的管理	shi'jiu'ji'lu'he'ping'zheng'de'guan'li	0
十六计算机系统的管理	shi'liu'ji'suan'ji'xi'tong'de'guan'li	0
十七设施设备保管和维护的管理	shi'qi'she'shi'she'bei'bao'guan'he'wei'hu'de'guan'li	0
十七执行药品电子监管的规定	shi'qi'zhi'xing'yao'pin'dian'zi'jian'guan'de'gui'ding	0
十三负责药品召回的管理	shi'san'fu'ze'yao'pin'zhao'hui'de'guan'li	0
十三质量事故质量投诉的管理	shi'san'zhi'liang'shi'gu'zhi'liang'tou'su'de'guan'li	0
十四负责药品不良反应的报告	shi'si'fu'ze'yao'pin'bu'liang'fan'ying'de'bao'gao	0
十四人员培训及考核的规定	shi'si'ren'yuan'pei'xun'ji'kao'he'de'gui'ding	0
十四药品不良反应报告的规定	shi'si'yao'pin'bu'liang'fan'ying'bao'gao'de'gui'ding	0
十四指导并监督药学服务工作	shi'si'zhi'dao'bing'jian'du'yao'xue'fu'wu'gong'zuo	0
十五环境卫生人员健康的规定	shi'wu'huan'jing'wei'sheng'ren'yuan'jian'kang'de'gui'ding	0
十五药品不良反应报告的规定	shi'wu'yao'pin'bu'liang'fan'ying'bao'gao'de'gui'ding	0
十药品退货的管理	shi'yao'pin'tui'huo'de'guan'li	0
十药品有效期的管理	shi'yao'pin'you'xiao'qi'de'guan'li	0
十一不合格药品药品销毁的管理	shi'yi'bu'he'ge'yao'pin'yao'pin'xiao'hui'de'guan'li	0
十一药品召回的管理	shi'yi'yao'pin'zhao'hui'de'guan'li	0
售记录	shou'ji'lu	0
四符合储存作业要求的照明设备	si'fu'he'chu'cun'zuo'ye'yao'qiu'de'zhao'ming'she'bei	0
四相关印章随货同行单票样式	si'xiang'guan'yin'zhang'sui'huo'tong'hang'dan'piao'yang'shi	0
四药品拆零的管理	si'yao'pin'chai'ling'de'guan'li	0
四药品拆零销售	si'yao'pin'chai'ling'xiao'shou	0
四药品已超过有效期	si'yao'pin'yi'chao'guo'you'xiao'qi	0
四与供货单位签订质量保证协议	si'yu'gong'huo'dan'wei'qian'ding'zhi'liang'bao'zheng'xie'yi	0
四质量信息的管理	si'zhi'liang'xin'xi'de'guan'li	0
文件应当分类存放便于查阅	wen'jian'ying'dang'fen'lei'cun'fang'bian'yu'cha'yue	0
五符合储存作业要求的照明设备	wu'fu'he'chu'cun'zuo'ye'yao'qiu'de'zhao'ming'she'bei	0
五开户户名开户银行及账号	wu'kai'hu'hu'ming'kai'hu'yin'hang'ji'zhang'hao	0
五其他异常情况的药品	wu'qi'ta'yi'chang'qing'kuang'de'yao'pin	0
五外用药与其他药品分开摆放	wu'wai'yong'yao'yu'qi'ta'yao'pin'fen'kai'bai'fang	0
五验收专用场所	wu'yan'shou'zhuan'yong'chang'suo	0
验收抽取的样品应当具有代表性	yan'shou'chou'qu'de'yang'pin'ying'dang'ju'you'dai'biao'xing	0
药品经营质量管理规范	yao'pin'jing'ying'zhi'liang'guan'li'gui'fan	0
一货架和柜台	yi'huo'jia'he'gui'tai	0
一明确双方质量责任	yi'ming'que'shuang'fang'zhi'liang'ze'ren	0
一确定供货单位的合法资格	yi'que'ding'gong'huo'dan'wei'de'he'fa'zi'ge	0
以上资料应当归入药品质量档案	yi'shang'zi'liao'ying'dang'gui'ru'yao'pin'zhi'liang'dang'an	0
一药品采购验收销售	yi'yao'pin'cai'gou'yan'shou'xiao'shou	0
一质量管理体系内审的规定	yi'zhi'liang'guan'li'ti'xi'nei'shen'de'gui'ding	0
