阿卡波糖	a'ka'bo'tang	0
阿克林霉素	a'ke'lin'mei'su	0
阿莫西林	a'mo'xi'lin	0
阿莫西林克拉维酸钾分散	a'mo'xi'lin'ke'la'wei'suan'jia'fen'san	0
阿莫西林克拉维酸钾颗	a'mo'xi'lin'ke'la'wei'suan'jia'ke	0
阿司匹林肠溶	a'si'pi'lin'chang'rong	0
阿糖胞苷	a'tang'bao'gan	0
阿托伐他丁钙	a'tuo'fa'ta'ding'gai	0
阿托伐他汀	a'tuo'fa'ta'ting	0
阿托伐他汀钙	a'tuo'fa'ta'ting'gai	0
阿托品	a'tuo'pin	0
阿托品静推	a'tuo'pin'jing'tui	0
阿托品试验	a'tuo'pin'shi'yan	0
阿昔洛韦乳膏	a'xi'luo'wei'ru'gao	0
阿昔莫司	a'xi'mo'si	0
阿扎司琼	a'zha'si'qiong	0
艾迪	ai'di	0
艾迪注射液	ai'di'zhu'she'ye	0
艾司唑仑	ai'si'zuo'lun	0
埃索拉唑肠溶	ai'suo'la'zuo'chang'rong	0
氨茶碱	an'cha'jian	0
胺碘酮	an'dian'tong	0
氨酚双氢可待因	an'fen'shuang'qing'ke'dai'yin	0
氨酚双氢可待因路盖克	an'fen'shuang'qing'ke'dai'yin'lu'gai'ke	0
氨基酸相当于氮	an'ji'suan'xiang'dang'yu'dan	0
氨基酸相当于气氮	an'ji'suan'xiang'dang'yu'qi'dan	0
氨基乙酸	an'ji'yi'suan	0
氨基已酸	an'ji'yi'suan	0
安络血	an'luo'xue	0
安络血肾上腺色腙	an'luo'xue'shen'shang'xian'se'zong	0
氨氯地平	an'lv'di'ping	0
按内科常规护理	an'nei'ke'chang'gui'hu'li	0
氨曲南	an'qu'nan	0
安溴索	an'xiu'suo	0
氨溴索	an'xiu'suo	0
奥美拉唑	ao'mei'la'zuo	0
奥美拉唑肠溶	ao'mei'la'zuo'chang'rong	0
奥美拉唑专用溶媒	ao'mei'la'zuo'zhuan'yong'rong'mei	0
奥曲肽	ao'qu'tai	0
白醋	bai'cu	0
白介素	bai'jie'su	0
百令胶囊	bai'ling'jiao'nang	0
百灵胶囊	bai'ling'jiao'nang	0
白色念珠菌	bai'se'nian'zhu'jun	0
拜新同	bai'xin'tong	0
半小时内滴完	ban'xiao'shi'nei'di'wan	0
保持呼吸道通畅	bao'chi'hu'xi'dao'tong'chang	0
保留灌肠	bao'liu'guan'chang	0
保留尿管	bao'liu'niao'guan	0
保留胃管	bao'liu'wei'guan	0
贝纳普利	bei'na'pu'li	0
贝特类	bei'te'lei	0
苯海拉明	ben'hai'la'ming	0
苯磺酸氨氯地平	ben'huang'suan'an'lv'di'ping	0
苯磺酸氨氯地平洛活喜	ben'huang'suan'an'lv'di'ping'luo'huo'xi	0
苯磺酸氨氯地平络活喜	ben'huang'suan'an'lv'di'ping'luo'huo'xi	0
泵入	beng'ru	0
泵入另一通道	beng'ru'ling'yi'tong'dao	0
泵入浓度	beng'ru'nong'du	0
吡诺克辛滴眼液	bi'nuo'ke'xin'di'yan'ye	0
吡嗪酰胺	bi'qin'xian'an	0
吡柔比星	bi'rou'bi'xing	0
必要时	bi'yao'shi	0
憋肝醇	bie'gan'chun	0
别嘌醇	bie'piao'chun	0
丙氨酸谷氨酰胺	bing'an'suan'gu'an'xian'an	0
丙氨酸钠	bing'an'suan'na	0
丙氨酰谷氨酰胺	bing'an'xian'gu'an'xian'an	0
丙泊酚注射液	bing'bo'fen'zhu'she'ye	0
丙硫氧嘧啶	bing'liu'yang'mi'ding	0
病危	bing'wei	0
丙戊酸钠	bing'wu'suan'na	0
丙戊酸钠剂	bing'wu'suan'na'ji	0
波利维	bo'li'wei	0
播散性用两性霉素联合氟康唑	bo'san'xing'yong'liang'xing'mei'su'lian'he'fu'kang'zuo	0
波依定	bo'yi'ding	0
不应再给	bu'ying'zai'gei	0
补正常值量值内先给二分之一	bu'zheng'chang'zhi'liang'zhi'nei'xian'gei'er'fen'zhi'yi	0
搽浴	cha'yu	0
长春新碱	chang'chun'xin'jian	0
常规重组人胰岛素	chang'gui'chong'zu'ren'yi'dao'su	0
场内营养乳	chang'nei'ying'yang'ru	0
常用营养袋配置	chang'yong'ying'yang'dai'pei'zhi	0
常用止血药物	chang'yong'zhi'xue'yao'wu	0
冲管	chong'guan	0
重组人白细胞介素	chong'zu'ren'bai'xi'bao'jie'su	0
重组人促红细胞生成素	chong'zu'ren'cu'hong'xi'bao'sheng'cheng'su	0
重组人细胞击落刺激因子注射液	chong'zu'ren'xi'bao'ji'luo'ci'ji'yin'zi'zhu'she'ye	0
重组人血小板生成素注射液	chong'zu'ren'xue'xiao'ban'sheng'cheng'su'zhu'she'ye	0
床岁男	chuang'sui'nan	0
垂体叶素	chui'ti'ye'su	0
次次	ci'ci	0
次月	ci'yue	0
促进白细胞增高增强免疫力	cu'jin'bai'xi'bao'zeng'gao'zeng'qiang'mian'yi'li	0
醋酸奥曲肽	cu'suan'ao'qu'tai	0
醋酸泼尼松	cu'suan'po'ni'song	0
促醒	cu'xing	0
大扶康	da'fu'kang	0
大氟康	da'fu'kang	0
大于	da'yu	0
大于三小时	da'yu'san'xiao'shi	0
贷款发放撒	dai'kuan'fa'fang'sa	0
代酸无需补碱	dai'suan'wu'xu'bu'jian	0
代酸治疗	dai'suan'zhi'liao	0
蛋白质含氮	dan'bai'zhi'han'dan	0
胆红素	dan'hong'su	0
单开处方	dan'kai'chu'fang	0
丹参酮	dan'shen'tong	0
单硝酸异山梨酯	dan'xiao'suan'yi'shan'li'zhi	0
单硝酸异山梨酯缓释胶囊	dan'xiao'suan'yi'shan'li'zhi'huan'shi'jiao'nang	0
氮转换成蛋白质消耗	dan'zhuan'huan'cheng'dan'bai'zhi'xiao'hao	0
的能量	de'neng'liang	0
的脂肪乳相当于的能量	de'zhi'fang'ru'xiang'dang'yu'de'neng'liang	0
滴分	di'fen	0
地高辛	di'gao'xin	0
低坡卧位	di'po'wo'wei	0
地塞米松	di'sai'mi'song	0
地塞米松磷酸钠注射液	di'sai'mi'song'lin'suan'na'zhu'she'ye	0
低渗性脱水补钠	di'shen'xing'tuo'shui'bu'na	0
低渗性脱水补钠公式	di'shen'xing'tuo'shui'bu'na'gong'shi	0
地西泮安定	di'xi'pan'an'ding	0
滴眼用	di'yan'yong	0
第一小时内补	di'yi'xiao'shi'nei'bu	0
地榆升白	di'yu'sheng'bai	0
颠茄合剂	dian'qie'he'ji	0
对乳酸酸中毒的改善可有作用	dui'ru'suan'suan'zhong'du'de'gai'shan'ke'you'zuo'yong	0
兑水口	dui'shui'kou	0
对乙酰氨基酚缓释	dui'yi'xian'an'ji'fen'huan'shi	0
多巴胺	duo'ba'an	0
多巴酚丁胺	duo'ba'fen'ding'an	0
多粘菌素	duo'nian'jun'su	0
多潘立酮	duo'pan'li'tong	0
哆嗦茶碱	duo'suo'cha'jian	0
多索茶碱	duo'suo'cha'jian	0
多维素	duo'wei'su	0
多维素复方	duo'wei'su'fu'fang	0
多稀磷脂酰胆碱	duo'xi'lin'zhi'xian'dan'jian	0
多种微量素号	duo'zhong'wei'liang'su'hao	0
厄贝沙坦	e'bei'sha'tan	0
翻身防褥疮护理	fan'shen'fang'ru'chuang'hu'li	0
方案	fang'an	0
方案床	fang'an'chuang	0
方案疗程	fang'an'liao'cheng	0
非白色念珠菌	fei'bai'se'nian'zhu'jun	0
肺孢子菌感染	fei'bao'zi'jun'gan'ran	0
肺功能	fei'gong'neng	0
非患者	fei'huan'zhe	0
肺力咳合剂	fei'li'ke'he'ji	0
肺力咳胶囊合剂	fei'li'ke'jiao'nang'he'ji	0
非洛贝特	fei'luo'bei'te	0
非洛地平	fei'luo'di'ping	0
非洛地平波异丁	fei'luo'di'ping'bo'yi'ding	0
肺脑合剂	fei'nao'he'ji	0
肺泡灌洗液葡聚糖定	fei'pao'guan'xi'ye'pu'ju'tang'ding	0
肺泡灌洗液细菌培养	fei'pao'guan'xi'ye'xi'jun'pei'yang	0
肺泡灌洗液液真菌培养	fei'pao'guan'xi'ye'ye'zhen'jun'pei'yang	0
肺隐球菌	fei'yin'qiu'jun	0
酚磺乙胺	fen'huang'yi'an	0
芬太尼	fen'tai'ni	0
酚妥拉明	fen'tuo'la'ming	0
分钟打心电图	fen'zhong'da'xin'dian'tu	0
分钟打心电图了解心率	fen'zhong'da'xin'dian'tu'liao'jie'xin'lv	0
氟达拉宾	fu'da'la'bin	0
复发氨淋巴比托	fu'fa'an'lin'ba'bi'tuo	0
复方	fu'fang	0
复方氨基酸	fu'fang'an'ji'suan	0
复方氨林巴比妥	fu'fang'an'lin'ba'bi'tuo	0
复方丹参滴丸	fu'fang'dan'shen'di'wan	0
复方可待因口药	fu'fang'ke'dai'yin'kou'yao	0
复方可待因口液	fu'fang'ke'dai'yin'kou'ye	0
复方氯唑沙腙	fu'fang'lv'zuo'sha'zong	0
复方酮酸	fu'fang'tong'suan	0
复方维生素	fu'fang'wei'sheng'su	0
复方异丙托溴胺	fu'fang'yi'bing'tuo'xiu'an	0
复方异丙托溴铵	fu'fang'yi'bing'tuo'xiu'an	0
负荷	fu'he	0
复合辅酶	fu'he'fu'mei	0
氟康唑	fu'kang'zuo	0
氟康唑疗程为	fu'kang'zuo'liao'cheng'wei	0
氟康唑注射液	fu'kang'zuo'zhu'she'ye	0
氟康唑注射液大扶康	fu'kang'zuo'zhu'she'ye'da'fu'kang	0
伏立康唑	fu'li'kang'zuo	0
辅酶	fu'mei	0
呋噻米	fu'sai'mi	0
扶他林	fu'ta'lin	0
福辛普利	fu'xin'pu'li	0
改为	gai'wei	0
甘露醇	gan'lu'chun	0
甘露聚糖肽	gan'lu'ju'tang'tai	0
肝肾单位	gan'shen'dan'wei	0
肝素	gan'su	0
甘酰胺类	gan'xian'an'lei	0
肝性脑病	gan'xing'nao'bing	0
甘油果糖	gan'you'guo'tang	0
高三尖杉酯碱	gao'san'jian'shan'zhi'jian	0
高渗性脱水补水量	gao'shen'xing'tuo'shui'bu'shui'liang	0
高用他汀类	gao'yong'ta'ting'lei	0
格列本脲	ge'lie'ben'niao	0
格列齐脲	ge'lie'qi'niao	0
格列齐特缓释	ge'lie'qi'te'huan'shi	0
格列奇特缓释	ge'lie'qi'te'huan'shi	0
更昔洛韦	geng'xi'luo'wei	0
枸盐酸莫沙比利胶囊	gou'yan'suan'mo'sha'bi'li'jiao'nang	0
骨穿费	gu'chuan'fei	0
骨穿费用编码	gu'chuan'fei'yong'bian'ma	0
骨化三醇	gu'hua'san'chun	0
骨肽	gu'tai	0
冠脉	guan'mai	0
灌洗用	guan'xi'yong	0
海坤肾喜	hai'kun'shen'xi	0
海崑肾喜胶囊	hai'kun'shen'xi'jiao'nang	0
号气管插管一根	hao'qi'guan'cha'guan'yi'gen	0
红处方	hong'chu'fang	0
琥珀酸美托洛尔	hu'po'suan'mei'tuo'luo'er	0
环丙沙星	huan'bing'sha'xing	0
环磷酰胺	huan'lin'xian'an	0
还原性谷胱甘肽	huan'yuan'xing'gu'guang'gan'tai	0
黄葵胶囊	huang'kui'jiao'nang	0
会阴部冲洗	hui'yin'bu'chong'xi	0
肌酐	ji'gan	0
急救车备药	ji'jiu'che'bei'yao	0
即可补碱	ji'ke'bu'jian	0
极量	ji'liang	0
记录出入量	ji'lu'chu'ru'liang	0
激素换用表	ji'su'huan'yong'biao	0
急用可以滴完	ji'yong'ke'yi'di'wan	0
急用可予以静滴	ji'yong'ke'yu'yi'jing'di	0
甲氨蝶呤	jia'an'die'ling	0
甲泊尼酸琥珀松龙	jia'bo'ni'suan'hu'po'song'long	0
甲钴胺	jia'gu'an	0
甲钴胺冻干粉注射液	jia'gu'an'dong'gan'fen'zhu'she'ye	0
甲硫咪唑	jia'liu'mi'zuo	0
钾镁合剂	jia'mei'he'ji	0
甲泼尼龙	jia'po'ni'long	0
甲泼尼龙甲强龙	jia'po'ni'long'jia'qiang'long	0
加强龙	jia'qiang'long	0
甲强龙甲泼尼龙琥珀酸钠	jia'qiang'long'jia'po'ni'long'hu'po'suan'na	0
加入营养袋	jia'ru'ying'yang'dai	0
甲硝唑	jia'xiao'zuo	0
甲氧氯普胺	jia'yang'lv'pu'an	0
减半	jian'ban	0
减半即	jian'ban'ji	0
间断夹闭尿管	jian'duan'jia'bi'niao'guan	0
间断胃肠减压	jian'duan'wei'chang'jian'ya	0
降低胆固醇用普利类	jiang'di'dan'gu'chun'yong'pu'li'lei	0
降低甘油三酯	jiang'di'gan'you'san'zhi	0
将预警信息报本机构医务人员	jiang'yu'jing'xin'xi'bao'ben'ji'gou'yi'wu'ren'yuan	0
结核常用药物医嘱	jie'he'chang'yong'yao'wu'yi'zhu	0
金双歧活菌	jin'shuang'qi'huo'jun	0
金水宝	jin'shui'bao	0
精蛋白生物合成人胰岛素	jing'dan'bai'sheng'wu'he'cheng'ren'yi'dao'su	0
静滴	jing'di	0
静脉泵入	jing'mai'beng'ru	0
静脉泵入药物配伍	jing'mai'beng'ru'yao'wu'pei'wu	0
经气管插管处接呼吸机辅助通气	jing'qi'guan'cha'guan'chu'jie'hu'xi'ji'fu'zhu'tong'qi	0
经气切处接呼吸机辅助呼吸	jing'qi'qie'chu'jie'hu'xi'ji'fu'zhu'hu'xi	0
精一类处方常用药	jing'yi'lei'chu'fang'chang'yong'yao	0
酒石酸美托洛尔	jiu'shi'suan'mei'tuo'luo'er	0
局麻下床旁纤镜检查	ju'ma'xia'chuang'pang'xian'jing'jian'cha	0
据神志调速	ju'shen'zhi'tiao'su	0
据神智调速	ju'shen'zhi'tiao'su	0
据药敏结果	ju'yao'min'jie'guo	0
聚乙二胺粉	ju'yi'er'an'fen	0
聚乙二醇粉	ju'yi'er'chun'fen	0
卡泊芬净	ka'bo'fen'jing	0
卡马西平	ka'ma'xi'ping	0
卡托普利	ka'tuo'pu'li	0
咯血	ka'xie	0
开塞露山梨醇	kai'sai'lu'shan'li'chun	0
抗真菌药	kang'zhen'jun'yao	0
可产生热量	ke'chan'sheng're'liang	0
克咳胶囊	ke'ke'jiao'nang	0
可调最高	ke'tiao'zui'gao	0
苦参素	ku'shen'su	0
雷尼替丁	lei'ni'ti'ding	0
利多卡因	li'duo'ka'yin	0
利多卡因局部粘膜麻醉用	li'duo'ka'yin'ju'bu'nian'mo'ma'zui'yong	0
利福平	li'fu'ping	0
立即	li'ji	0
立普妥	li'pu'tuo	0
立止血	li'zhi'xue	0
立止血血凝酶	li'zhi'xue'xue'ning'mei	0
链氨基酸	lian'an'ji'suan	0
量钠正常钠男女小孩	liang'na'zheng'chang'na'nan'nv'xiao'hai	0
两性霉素	liang'xing'mei'su	0
量值女男	liang'zhi'nv'nan	0
疗程	liao'cheng	0
列地尔	lie'di'er	0
列地尔注射液	lie'di'er'zhu'she'ye	0
临时	lin'shi	0
另一通道	ling'yi'tong'dao	0
柳氮磺胺吡啶	liu'dan'huang'an'bi'ding	0
柳氮磺吡啶	liu'dan'huang'bi'ding	0
硫普罗宁	liu'pu'luo'ning	0
硫普罗宁针	liu'pu'luo'ning'zhen	0
流速容量曲线	liu'su'rong'liang'qu'xian	0
硫酸氯吡格雷	liu'suan'lv'bi'ge'lei	0
硫酸镁	liu'suan'mei	0
硫酸亚铁叶酸	liu'suan'ya'tie'ye'suan	0
硫酸鱼精蛋白	liu'suan'yu'jing'dan'bai	0
硫糖铝混悬液	liu'tang'lv'hun'xuan'ye	0
六味安消胶囊	liu'wei'an'xiao'jiao'nang	0
流质饮食	liu'zhi'yin'shi	0
路盖克	lu'gai'ke	0
洛丁新	luo'ding'xin	0
络活喜	luo'huo'xi	0
洛哌丁胺易蒙停	luo'pai'ding'an'yi'meng'ting	0
氯化钾缓释	lv'hua'jia'huan'shi	0
铝碳酸镁	lv'tan'suan'mei	0
吗丁啉	ma'ding'lin	0
吗替麦考酚酯	ma'ti'mai'kao'fen'zhi	0
慢淋方案	man'lin'fang'an	0
每公斤体重	mei'gong'jin'ti'zhong	0
美罗华	mei'luo'hua	0
美罗培南	mei'luo'pei'nan	0
每日最大剂量小于	mei'ri'zui'da'ji'liang'xiao'yu	0
美司钠	mei'si'na	0
美司钠针	mei'si'na'zhen	0
每月用一次	mei'yue'yong'yi'ci	0
门冬酰胺	men'dong'xian'an	0
孟鲁斯特	meng'lu'si'te	0
蒙脱石散	meng'tuo'shi'san	0
灭菌注射器一付	mie'jun'zhu'she'qi'yi'fu	0
莫沙比利	mo'sha'bi'li	0
莫西沙星	mo'xi'sha'xing	0
莫西沙星拜复乐	mo'xi'sha'xing'bai'fu'le	0
莫西沙星多不用于癫痫患者	mo'xi'sha'xing'duo'bu'yong'yu'dian'xian'huan'zhe	0
纳洛酮	na'luo'tong	0
纳洛酮对循环中有升压作用	na'luo'tong'dui'xun'huan'zhong'you'sheng'ya'zuo'yong	0
脑蛋白水解物	nao'dan'bai'shui'jie'wu	0
脑脊液常规	nao'ji'ye'chang'gui	0
内科常用长期医嘱	nei'ke'chang'yong'chang'qi'yi'zhu	0
能力合剂	neng'li'he'ji	0
能量	neng'liang	0
能量合剂	neng'liang'he'ji	0
尼可刹米	ni'ke'sha'mi	0
尼可刹米注射液	ni'ke'sha'mi'zhu'she'ye	0
尼莫地平注射液	ni'mo'di'ping'zhu'she'ye	0
年龄	nian'ling	0
尿酸高低肾衰	niao'suan'gao'di'shen'shuai	0
尿酮尿糖试验	niao'tong'niao'tang'shi'yan	0
凝血酶	ning'xue'mei	0
浓红含配血型	nong'hong'han'pei'xue'xing	0
泮托拉唑	pan'tuo'la'zuo	0
潘托拉唑	pan'tuo'la'zuo	0
培哚普利	pei'duo'pu'li	0
硼替佐米	peng'ti'zuo'mi	0
硼替佐米万珂	peng'ti'zuo'mi'wan'ke	0
皮质醇	pi'zhi'chun	0
泼尼龙	po'ni'long	0
泼尼松	po'ni'song	0
普伐他汀	pu'fa'ta'ting	0
葡萄糖酸钙	pu'tao'tang'suan'gai	0
普通胰岛素	pu'tong'yi'dao'su	0
起泵	qi'beng	0
起泵据血压调速	qi'beng'ju'xue'ya'tiao'su	0
气氮	qi'dan	0
气氮可产热能	qi'dan'ke'chan're'neng	0
气垫床	qi'dian'chuang	0
气管插管医嘱	qi'guan'cha'guan'yi'zhu	0
气管切开护理	qi'guan'qie'kai'hu'li	0
气管舒张试验	qi'guan'shu'zhang'shi'yan	0
强苯磺酸钙胶囊	qiang'ben'huang'suan'gai'jiao'nang	0
强的松	qiang'di'song	0
桥内注射	qiao'nei'zhu'she	0
侵袭性肺曲霉菌	qin'xi'xing'fei'qu'mei'jun	0
轻度用氟康唑	qing'du'yong'fu'kang'zuo	0
氢化可的松不经过肝脏代谢	qing'hua'ke'di'song'bu'jing'guo'gan'zang'dai'xie	0
氢化可的松可的	qing'hua'ke'di'song'ke'de	0
氢化皮质酮	qing'hua'pi'zhi'tong	0
氢可的松	qing'ke'di'song	0
去甲肾上腺素	qu'jia'shen'shang'xian'su	0
去甲万古霉素	qu'jia'wan'gu'mei'su	0
曲马多	qu'ma'duo	0
曲美他嗪	qu'mei'ta'qin	0
去乙酰毛花苷注射液	qu'yi'xian'mao'hua'gan'zhu'she'ye	0
去乙酰毛花苷注射液西地兰	qu'yi'xian'mao'hua'gan'zhu'she'ye'xi'di'lan	0
热氮比	re'dan'bi	0
热林清	re'lin'qing	0
热脂比	re'zhi'bi	0
人血白蛋白	ren'xue'bai'dan'bai	0
仍不能维持予以	reng'bu'neng'wei'chi'yu'yi	0
如肝肾用需用鱼精蛋白中和	ru'gan'shen'yong'xu'yong'yu'jing'dan'bai'zhong'he	0
瑞格列奈	rui'ge'lie'nai	0
瑞舒伐他汀	rui'shu'fa'ta'ting	0
若回升至	ruo'hui'sheng'zhi	0
赛托溴铵粉吸入剂	sai'tuo'xiu'an'fen'xi'ru'ji	0
噻托溴铵粉吸入剂	sai'tuo'xiu'an'fen'xi'ru'ji	0
三叉神经痛	san'cha'shen'jing'tong	0
三高一低一衰	san'gao'yi'di'yi'shuai	0
沙丁胺醇	sha'ding'an'chun	0
沙利度胺	sha'li'du'an	0
沙利度胺反应停	sha'li'du'an'fan'ying'ting	0
沙美特罗替卡松粉吸入剂	sha'mei'te'luo'ti'ka'song'fen'xi'ru'ji	0
善宁	shan'ning	0
肾病综合症	shen'bing'zong'he'zheng	0
肾功能不全时酸中毒	shen'gong'neng'bu'quan'shi'suan'zhong'du	0
神经科用药	shen'jing'ke'yong'yao	0
神经内科内线	shen'jing'nei'ke'nei'xian	0
肾康	shen'kang	0
参麦注射液	shen'mai'zhu'she'ye	0
肾内科常用医嘱	shen'nei'ke'chang'yong'yi'zhu	0
肾上腺色棕	shen'shang'xian'se'zong	0
肾上腺腙安络血	shen'shang'xian'zong'an'luo'xue	0
肾衰宁	shen'shuai'ning	0
肾衰宁胶囊	shen'shuai'ning'jiao'nang	0
肾炎舒	shen'yan'shu	0
慎重用药	shen'zhong'yong'yao	0
升白细胞药物	sheng'bai'xi'bao'yao'wu	0
升白细胞增强免疫	sheng'bai'xi'bao'zeng'qiang'mian'yi	0
圣通平	sheng'tong'ping	0
生长抑素	sheng'zhang'yi'su	0
试验	shi'yan	0
试验葡聚糖试验	shi'yan'pu'ju'tang'shi'yan	0
实值体重	shi'zhi'ti'zhong	0
首次	shou'ci	0
首剂	shou'ji	0
首剂加	shou'ji'jia	0
首剂加倍	shou'ji'jia'bei	0
首剂以	shou'ji'yi	0
收缩压	shou'suo'ya	0
收缩压的为舒张压	shou'suo'ya'de'wei'shu'zhang'ya	0
首选复方新诺明	shou'xuan'fu'fang'xin'nuo'ming	0
首选两性霉素	shou'xuan'liang'xing'mei'su	0
漱口用	shu'kou'yong	0
舒眠胶囊	shu'mian'jiao'nang	0
鼠神经生长因子	shu'shen'jing'sheng'zhang'yin'zi	0
输液大于	shu'ye'da'yu	0
双氯芬酸二乙胺乳胶	shuang'lv'fen'suan'er'yi'an'ru'jiao	0
双氯酚酸二乙胺乳胶扶他林软膏	shuang'lv'fen'suan'er'yi'an'ru'jiao'fu'ta'lin'ruan'gao	0
双氯芬酸利多卡因	shuang'lv'fen'suan'li'duo'ka'yin	0
双氯芬酸钠盐酸利多卡因注射液	shuang'lv'fen'suan'na'yan'suan'li'duo'ka'yin'zhu'she'ye	0
双歧杆菌活菌	shuang'qi'gan'jun'huo'jun	0
水溶性维生素	shui'rong'xing'wei'sheng'su	0
顺铂注射液	shun'bo'zhu'she'ye	0
四代头孢	si'dai'tou'bao	0
四分之一	si'fen'zhi'yi	0
随时吸痰	sui'shi'xi'tan	0
泰能	tai'neng	0
痰革氏染色	tan'ge'shi'ran'se	0
痰抗酸	tan'kang'suan	0
碳青霉稀类	tan'qing'mei'xi'lei	0
碳酸氢钠含各	tan'suan'qing'na'han'ge	0
碳酸氢钠小苏打	tan'suan'qing'na'xiao'su'da	0
痰胸水找脱落细胞	tan'xiong'shui'zhao'tuo'luo'xi'bao	0
痰血药敏	tan'xue'yao'min	0
痰真菌	tan'zhen'jun	0
糖肽类	tang'tai'lei	0
特比澳	te'bi'ao	0
提高免疫力	ti'gao'mian'yi'li	0
替加环素	ti'jia'huan'su	0
替考拉林	ti'kao'la'lin	0
替考拉宁	ti'kao'la'ning	0
提需深静脉置管	ti'xu'shen'jing'mai'zhi'guan	0
调速	tiao'su	0
通常开两种计量	tong'chang'kai'liang'zhong'ji'liang	0
通气功能	tong'qi'gong'neng	0
头孢呋辛酯	tou'bao'fu'xin'zhi	0
头孢克肟	tou'bao'ke'wo	0
头孢克肟世福素	tou'bao'ke'wo'shi'fu'su	0
头孢哌酮舒巴坦	tou'bao'pai'tong'shu'ba'tan	0
头孢哌酮舒巴坦钠	tou'bao'pai'tong'shu'ba'tan'na	0
头孢哌酮舒巴坦舒普森	tou'bao'pai'tong'shu'ba'tan'shu'pu'sen	0
头孢哌酮他唑巴坦	tou'bao'pai'tong'ta'zuo'ba'tan	0
头孢哌酮他唑巴坦钠	tou'bao'pai'tong'ta'zuo'ba'tan'na	0
头孢匹罗	tou'bao'pi'luo	0
头孢他啶	tou'bao'ta'ding	0
头孢头孢吡肟	tou'bao'tou'bao'bi'wo	0
退热	tui're	0
托烷司烷	tuo'wan'si'wan	0
外敷用	wai'fu'yong	0
万古霉素	wan'gu'mei'su	0
万古霉素胃注	wan'gu'mei'su'wei'zhu	0
维持小时以上	wei'chi'xiao'shi'yi'shang	0
维咀嚼	wei'ju'jue	0
维拉帕米	wei'la'pa'mi	0
伪膜性肠炎治疗	wei'mo'xing'chang'yan'zhi'liao	0
维生素	wei'sheng'su	0
维铁缓释	wei'tie'huan'shi	0
危重病人	wei'zhong'bing'ren	0
危重病人肠外营养时供给量为	wei'zhong'bing'ren'chang'wai'ying'yang'shi'gong'ji'liang'wei	0
胃注	wei'zhu	0
温开水溶解口	wen'kai'shui'rong'jie'kou	0
温水溶解口	wen'shui'rong'jie'kou	0
无创心排监	wu'chuang'xin'pai'jian	0
雾化吸入	wu'hua'xi'ru	0
无菌注射器一副	wu'jun'zhu'she'qi'yi'fu	0
无菌注射器一幅	wu'jun'zhu'she'qi'yi'fu	0
无菌注射用水	wu'jun'zhu'she'yong'shui	0
无菌注射用水呼吸机湿化用	wu'jun'zhu'she'yong'shui'hu'xi'ji'shi'hua'yong	0
无菌注射用水湿化气道	wu'jun'zhu'she'yong'shui'shi'hua'qi'dao	0
无菌注射用水稀释	wu'jun'zhu'she'yong'shui'xi'shi	0
无菌注射用水吸痰用	wu'jun'zhu'she'yong'shui'xi'tan'yong	0
乌司他丁	wu'si'ta'ding	0
乌司他丁万	wu'si'ta'ding'wan	0
细胞集落刺激生长因子	xi'bao'ji'luo'ci'ji'sheng'zhang'yin'zi	0
洗必泰口腔护理	xi'bi'tai'kou'qiang'hu'li	0
西地兰	xi'di'lan	0
稀释口	xi'shi'kou	0
稀释至取	xi'shi'zhi'qu	0
纤镜常用医嘱	xian'jing'chang'yong'yi'zhu	0
纤镜肺泡灌洗	xian'jing'fei'pao'guan'xi	0
纤镜双肺检查	xian'jing'shuang'fei'jian'cha	0
纤镜双肺吸痰	xian'jing'shuang'fei'xi'tan	0
先推滴	xian'tui'di	0
相当于	xiang'dang'yu	0
相当于据	xiang'dang'yu'ju	0
相当于气氮	xiang'dang'yu'qi'dan	0
硝苯地平	xiao'ben'di'ping	0
硝苯地平缓释	xiao'ben'di'ping'huan'shi	0
硝苯地平控释	xiao'ben'di'ping'kong'shi	0
哮喘患者慎用	xiao'chuan'huan'zhe'shen'yong	0
小儿血压	xiao'er'xue'ya	0
消化道出血	xiao'hua'dao'chu'xie	0
硝普钠	xiao'pu'na	0
硝酸甘油	xiao'suan'gan'you	0
硝酸异山梨酯	xiao'suan'yi'shan'li'zhi	0
缬沙坦胶囊	xie'sha'tan'jiao'nang	0
心电监护	xin'dian'jian'hu	0
辛伐他丁	xin'fa'ta'ding	0
辛伐他汀	xin'fa'ta'ting	0
心急收缩力	xin'ji'shou'suo'li	0
心排量指数	xin'pai'liang'zhi'shu	0
心室率下降予以	xin'shi'shuai'xia'jiang'yu'yi	0
心痛定	xin'tong'ding	0
心血管常用药物	xin'xue'guan'chang'yong'yao'wu	0
醒脑合剂	xing'nao'he'ji	0
醒脑合剂肺脑合剂	xing'nao'he'ji'fei'nao'he'ji	0
醒脑静	xing'nao'jing	0
醒脑静注射液	xing'nao'jing'zhu'she'ye	0
胸水常规	xiong'shui'chang'gui	0
休克首选去甲肾上腺素	xiu'ke'shou'xuan'qu'jia'shen'shang'xian'su	0
序贯治疗	xu'guan'zhi'liao	0
需立即补碱	xu'li'ji'bu'jian	0
需深静脉置管	xu'shen'jing'mai'zhi'guan	0
血必净	xue'bi'jing	0
血管收缩	xue'guan'shou'suo	0
血尿安胶囊	xue'niao'an'jiao'nang	0
血凝酶	xue'ning'mei	0
血栓通	xue'shuan'tong	0
血糖与的换算	xue'tang'yu'de'huan'suan	0
血压高无尿	xue'ya'gao'wu'niao	0
血液科常用药物	xue'ye'ke'chang'yong'yao'wu	0
循环衰竭首选去甲肾上腺素	xun'huan'shuai'jie'shou'xuan'qu'jia'shen'shang'xian'su	0
亚胺培南	ya'an'pei'nan	0
亚叶酸钙	ya'ye'suan'gai	0
眼科内线	yan'ke'nei'xian	0
盐酸阿托品注射用	yan'suan'a'tuo'pin'zhu'she'yong	0
盐酸胺碘酮	yan'suan'an'dian'tong	0
盐酸胺碘酮注射液	yan'suan'an'dian'tong'zhu'she'ye	0
盐酸安溴索	yan'suan'an'xiu'suo	0
盐酸氨溴索	yan'suan'an'xiu'suo	0
盐酸氨溴索分散	yan'suan'an'xiu'suo'fen'san	0
盐酸贝纳普利	yan'suan'bei'na'pu'li	0
盐酸贝纳普利洛丁新	yan'suan'bei'na'pu'li'luo'ding'xin	0
盐酸多巴胺注射液	yan'suan'duo'ba'an'zhu'she'ye	0
盐酸多巴酚丁胺注射液	yan'suan'duo'ba'fen'ding'an'zhu'she'ye	0
盐酸二甲双胍	yan'suan'er'jia'shuang'gua	0
盐酸利多卡因注射液	yan'suan'li'duo'ka'yin'zhu'she'ye	0
盐酸洛贝林注射液	yan'suan'luo'bei'lin'zhu'she'ye	0
盐酸莫西沙星拜复乐	yan'suan'mo'xi'sha'xing'bai'fu'le	0
盐酸哌替啶	yan'suan'pai'ti'ding	0
盐酸普萘洛尔	yan'suan'pu'nai'luo'er	0
盐酸曲马多	yan'suan'qu'ma'duo	0
盐酸曲马多缓释胶囊	yan'suan'qu'ma'duo'huan'shi'jiao'nang	0
盐酸曲马多注射液	yan'suan'qu'ma'duo'zhu'she'ye	0
盐酸曲美他嗪	yan'suan'qu'mei'ta'qin	0
盐酸肾上腺素注射液	yan'suan'shen'shang'xian'su'zhu'she'ye	0
盐酸特拉唑嗪	yan'suan'te'la'zuo'qin	0
盐酸溴乙新	yan'suan'xiu'yi'xin	0
盐酸溴已新	yan'suan'xiu'yi'xin	0
盐酸异丙肾上腺素注射液	yan'suan'yi'bing'shen'shang'xian'su'zhu'she'ye	0
野木瓜颗	ye'mu'gua'ke	0
野木瓜颗三叉神经痛	ye'mu'gua'ke'san'cha'shen'jing'tong	0
叶酸	ye'suan	0
乙胺丁醇	yi'an'ding'chun	0
一般减量原则每周见	yi'ban'jian'liang'yuan'ze'mei'zhou'jian	0
一般先予以一半用量	yi'ban'xian'yu'yi'yi'ban'yong'liang	0
伊贝沙坦	yi'bei'sha'tan	0
异丙肾上腺素	yi'bing'shen'shang'xian'su	0
一次性吸痰负压吸引器一个	yi'ci'xing'xi'tan'fu'ya'xi'yin'qi'yi'ge	0
一疗程	yi'liao'cheng	0
易蒙停洛哌丁胺	yi'meng'ting'luo'pai'ding'an	0
依那普利	yi'na'pu'li	0
依帕司他	yi'pa'si'ta	0
伊曲康唑	yi'qu'kang'zuo	0
伊曲康唑疗程为周	yi'qu'kang'zuo'liao'cheng'wei'zhou	0
抑酸用	yi'suan'yong	0
依托泊苷	yi'tuo'bo'gan	0
一线半胱氨酸泡腾	yi'xian'ban'guang'an'suan'pao'teng	0
乙酰半胱氨酸泡腾	yi'xian'ban'guang'an'suan'pao'teng	0
异烟肼	yi'yan'jing	0
抑制骨髓破坏	yi'zhi'gu'sui'po'huai	0
抑制全身炎症反应	yi'zhi'quan'shen'yan'zheng'fan'ying	0
抑制全是炎症反应	yi'zhi'quan'shi'yan'zheng'fan'ying	0
银黄含化	yin'huang'han'hua	0
蚓激酶肠溶	yin'ji'mei'chang'rong	0
银杏达莫	yin'xing'da'mo	0
用六次	yong'liu'ci	0
用六月	yong'liu'yue	0
用于	yong'yu	0
又名强的松	you'ming'qiang'di'song	0
鱼精蛋白中和肝肾	yu'jing'dan'bai'zhong'he'gan'shen	0
予以补碱	yu'yi'bu'jian	0
原液泵入	yuan'ye'beng'ru	0
暂停该类抗生素	zan'ting'gai'lei'kang'sheng'su	0
真菌培养门诊楼楼微生物室	zhen'jun'pei'yang'men'zhen'lou'lou'wei'sheng'wu'shi	0
真菌涂门诊楼楼特检室	zhen'jun'tu'men'zhen'lou'lou'te'jian'shi	0
正常钠量钠	zheng'chang'na'liang'na	0
至滴	zhi'di	0
脂肪乳	zhi'fang'ru	0
脂溶性维生素	zhi'rong'xing'wei'sheng'su	0
止痛	zhi'tong	0
指细胞外液占体重	zhi'xi'bao'wai'ye'zhan'ti'zhong	0
止血敏	zhi'xue'min	0
止血敏酚磺乙胺	zhi'xue'min'fen'huang'yi'an	0
直至减完	zhi'zhi'jian'wan	0
重度两性	zhong'du'liang'xing	0
重酒石酸去甲肾上腺素	zhong'jiu'shi'suan'qu'jia'shen'shang'xian'su	0
肿瘤溶解综合症	zhong'liu'rong'jie'zong'he'zheng	0
重症监护	zhong'zheng'jian'hu	0
重症监护镇静	zhong'zheng'jian'hu'zhen'jing	0
注射液硝普钠	zhu'she'ye'xiao'pu'na	0
注射液盐酸氨溴索	zhu'she'ye'yan'suan'an'xiu'suo	0
注射用奥美拉唑	zhu'she'yong'ao'mei'la'zuo	0
注射用环磷酰胺	zhu'she'yong'huan'lin'xian'an	0
注射用胸腺肽	zhu'she'yong'xiong'xian'tai	0
注射用盐酸氨溴索	zhu'she'yong'yan'suan'an'xiu'suo	0
注意神志瞳孔变化	zhu'yi'shen'zhi'tong'kong'bian'hua	0
专用溶媒	zhuan'yong'rong'mei	0
总量小于	zong'liang'xiao'yu	0
最大到	zui'da'dao	0
最大量	zui'da'liang	0
最大量可用至	zui'da'liang'ke'yong'zhi	0
最高相当于	zui'gao'xiang'dang'yu	0
最值	zui'zhi	0
左甲状腺素钠	zuo'jia'zhuang'xian'su'na	0
唑来膦酸	zuo'lai'lin'suan	0
唑来膦酸注射液	zuo'lai'lin'suan'zhu'she'ye	0
左旋氨氯地平	zuo'xuan'an'lv'di'ping	0
左旋门冬酰胺酶	zuo'xuan'men'dong'xian'an'mei	0
左氧氟沙星	zuo'yang'fu'sha'xing	0
