阿城市会宁棉麻织布厂	a'cheng'shi'hui'ning'mian'ma'zhi'bu'chang	0
阿克苏地区棉麻公司	a'ke'su'di'qu'mian'ma'gong'si	0
阿克苏库车县棉麻公司	a'ke'su'ku'che'xian'mian'ma'gong'si	0
阿克陶县棉麻公司	a'ke'tao'xian'mian'ma'gong'si	0
阿勒泰市生产资料棉麻公司	a'le'tai'shi'sheng'chan'zi'liao'mian'ma'gong'si	0
阿荣旗查巴齐亚麻加工厂	a'rong'qi'cha'ba'qi'ya'ma'jia'gong'chang	0
阿图什市棉麻公司轧花厂	a'tu'shi'shi'mian'ma'gong'si'ya'hua'chang	0
阿瓦提县棉麻公司伯什艾日克乡棉花加工厂	a'wa'ti'xian'mian'ma'gong'si'bo'shen'ai'ri'ke'xiang'mian'hua'jia'gong'chang	0
阿瓦提县棉麻公司乌鲁却勒乡棉花加工厂	a'wa'ti'xian'mian'ma'gong'si'wu'lu'que'le'xiang'mian'hua'jia'gong'chang	0
阿瓦提县棉麻公司县城加工厂	a'wa'ti'xian'mian'ma'gong'si'xian'cheng'jia'gong'chang	0
安达市大石山亚麻原料加工厂	an'da'shi'da'shi'shan'ya'ma'yuan'liao'jia'gong'chang	0
安达市火石山亚麻原料加工厂	an'da'shi'huo'shi'shan'ya'ma'yuan'liao'jia'gong'chang	0
安徽定远棉麻集团公司	an'hui'ding'yuan'mian'ma'ji'tuan'gong'si	0
安徽省昌达棉麻制品有限公司	an'hui'sheng'chang'da'mian'ma'zhi'pin'you'xian'gong'si	0
安徽省定远县棉麻公司	an'hui'sheng'ding'yuan'xian'mian'ma'gong'si	0
安徽省东至县棉麻公司	an'hui'sheng'dong'zhi'xian'mian'ma'gong'si	0
安徽省东至县棉麻织布厂	an'hui'sheng'dong'zhi'xian'mian'ma'zhi'bu'chang	0
安徽省阜南县棉麻公司	an'hui'sheng'fu'nan'xian'mian'ma'gong'si	0
安徽省怀宁县棉麻公司	an'hui'sheng'huai'ning'xian'mian'ma'gong'si	0
安徽省棉麻公司	an'hui'sheng'mian'ma'gong'si	0
安徽省全椒县棉麻公司	an'hui'sheng'quan'jiao'xian'mian'ma'gong'si	0
安徽省泗县棉麻公司	an'hui'sheng'si'xian'mian'ma'gong'si	0
安徽省宿县地区棉麻公司	an'hui'sheng'su'xian'di'qu'mian'ma'gong'si	0
安徽省太和县棉麻公司	an'hui'sheng'tai'he'xian'mian'ma'gong'si	0
安徽省铜陵县棉麻公司织布厂	an'hui'sheng'tong'ling'xian'mian'ma'gong'si'zhi'bu'chang	0
安陆市德安棉麻纺织厂	an'lu'shi'de'an'mian'ma'fang'zhi'chang	0
安庆棉麻集团有限责任公司	an'qing'mian'ma'ji'tuan'you'xian'ze'ren'gong'si	0
安丘市棉麻公司	an'qiu'shi'mian'ma'gong'si	0
安阳市棉麻公司	an'yang'shi'mian'ma'gong'si	0
巴楚县棉麻公司毛拉轧花厂	ba'chu'xian'mian'ma'gong'si'mao'la'ya'hua'chang	0
巴楚县棉麻公司恰瓦克轧花厂	ba'chu'xian'mian'ma'gong'si'qia'wa'ke'ya'hua'chang	0
巴楚县棉麻公司群库恰克轧花厂	ba'chu'xian'mian'ma'gong'si'qun'ku'qia'ke'ya'hua'chang	0
巴楚县棉麻公司色力布亚轧花厂	ba'chu'xian'mian'ma'gong'si'se'li'bu'ya'ya'hua'chang	0
巴楚县棉麻公司唐巴扎轧花厂	ba'chu'xian'mian'ma'gong'si'tang'ba'zha'ya'hua'chang	0
巴楚县棉麻公司县城轧花厂	ba'chu'xian'mian'ma'gong'si'xian'cheng'ya'hua'chang	0
巴楚县棉麻公司英吾斯坦轧花厂	ba'chu'xian'mian'ma'gong'si'ying'wu'si'tan'ya'hua'chang	0
拜泉县新建乡亚麻厂	bai'quan'xian'xin'jian'xiang'ya'ma'chang	0
拜泉县亚麻有限公司	bai'quan'xian'ya'ma'you'xian'gong'si	0
拜泉县亚麻原料厂	bai'quan'xian'ya'ma'yuan'liao'chang	0
保山市民族棉麻纺织厂	bao'shan'shi'min'zu'mian'ma'fang'zhi'chang	0
包市苏蒙特亚麻纺织合营有限公司	bao'shi'su'meng'te'ya'ma'fang'zhi'he'ying'you'xian'gong'si	0
包头市苏蒙特亚麻纺织合营有限公司	bao'tou'shi'su'meng'te'ya'ma'fang'zhi'he'ying'you'xian'gong'si	0
包头苏蒙特亚麻纺织合营有限公司	bao'tou'su'meng'te'ya'ma'fang'zhi'he'ying'you'xian'gong'si	0
宝应县棉麻总公司	bao'ying'xian'mian'ma'zong'gong'si	0
北安市棉麻厂	bei'an'shi'mian'ma'chang	0
北安市赵光亚麻原料扶贫福利厂	bei'an'shi'zhao'guang'ya'ma'yuan'liao'fu'pin'fu'li'chang	0
本溪市棉麻公司棉麻加工厂	ben'xi'shi'mian'ma'gong'si'mian'ma'jia'gong'chang	0
泌阳县棉麻公司	bi'yang'xian'mian'ma'gong'si	0
泌阳县棉麻公司加工厂	bi'yang'xian'mian'ma'gong'si'jia'gong'chang	0
滨海县棉麻公司	bin'hai'xian'mian'ma'gong'si	0
博爱县棉麻公司	bo'ai'xian'mian'ma'gong'si	0
博乐市棉麻公司贝林哈日莫墩乡轧花厂	bo'le'shi'mian'ma'gong'si'bei'lin'ha'ri'mo'dun'xiang'ya'hua'chang	0
博乐市棉麻公司青达拉轧花厂	bo'le'shi'mian'ma'gong'si'qing'da'la'ya'hua'chang	0
博乐市棉麻公司套特轧花厂	bo'le'shi'mian'ma'gong'si'tao'te'ya'hua'chang	0
博乐市棉麻公司星火轧花厂	bo'le'shi'mian'ma'gong'si'xing'huo'ya'hua'chang	0
勃利县恒太乡亚麻原料厂	bo'li'xian'heng'tai'xiang'ya'ma'yuan'liao'chang	0
勃利县双河镇亚麻原料厂	bo'li'xian'shuang'he'zhen'ya'ma'yuan'liao'chang	0
勃利县亚麻厂	bo'li'xian'ya'ma'chang	0
勃利县亚麻厂综合厂	bo'li'xian'ya'ma'chang'zong'he'chang	0
勃利县亚麻原料厂	bo'li'xian'ya'ma'yuan'liao'chang	0
勃利县亚麻原料综合厂	bo'li'xian'ya'ma'yuan'liao'zong'he'chang	0
波阳县棉麻公司	bo'yang'xian'mian'ma'gong'si	0
博州棉麻公司	bo'zhou'mian'ma'gong'si	0
亳州市棉麻公司	bo'zhou'shi'mian'ma'gong'si	0
策勒县棉麻公司轧花厂	ce'le'xian'mian'ma'gong'si'ya'hua'chang	0
常德市棉麻蚕茧总公司	chang'de'shi'mian'ma'can'jian'zong'gong'si	0
长葛市朝阳棉麻纺织厂	chang'ge'shi'chao'yang'mian'ma'fang'zhi'chang	0
长葛市石固镇朝阳棉麻纺织厂	chang'ge'shi'shi'gu'zhen'chao'yang'mian'ma'fang'zhi'chang	0
昌乐县棉麻公司	chang'le'xian'mian'ma'gong'si	0
昌乐县棉麻织布厂	chang'le'xian'mian'ma'zhi'bu'chang	0
长岭县新丰乡棉麻纺织厂	chang'ling'xian'xin'feng'xiang'mian'ma'fang'zhi'chang	0
长沙县棉麻土产日杂公司	chang'sha'xian'mian'ma'tu'chan'ri'za'gong'si	0
常熟市棉麻总公司方塔商场	chang'shu'shi'mian'ma'zong'gong'si'fang'ta'shang'chang	0
常州东青亚麻加工厂	chang'zhou'dong'qing'ya'ma'jia'gong'chang	0
常州市众和棉麻织造厂	chang'zhou'shi'zhong'he'mian'ma'zhi'zao'chang	0
巢湖地区棉麻总公司	chao'hu'di'qu'mian'ma'zong'gong'si	0
朝龙亚麻实业公司	chao'long'ya'ma'shi'ye'gong'si	0
朝阳棉麻公司	chao'yang'mian'ma'gong'si	0
沈丘县棉麻公司	chen'qiu'xian'mian'ma'gong'si	0
沈丘县棉麻巾被厂	chen'qiu'xian'mian'ma'jin'bei'chang	0
郴州市棉麻总公司	chen'zhou'shi'mian'ma'zong'gong'si	0
承德市供销社第一土产日杂棉麻总公司	cheng'de'shi'gong'xiao'she'di'yi'tu'chan'ri'za'mian'ma'zong'gong'si	0
城东棉麻制品厂	cheng'dong'mian'ma'zhi'pin'chang	0
成都市棉麻公司	cheng'du'shi'mian'ma'gong'si	0
崇仁县棉麻公司巴山轧花厂	chong'ren'xian'mian'ma'gong'si'ba'shan'ya'hua'chang	0
崇仁县棉麻公司航埠轧花厂	chong'ren'xian'mian'ma'gong'si'hang'bu'ya'hua'chang	0
崇仁县棉麻公司六家桥轧花厂	chong'ren'xian'mian'ma'gong'si'liu'jia'qiao'ya'hua'chang	0
滁州市第一棉麻公司轧花厂	chu'zhou'shi'di'yi'mian'ma'gong'si'ya'hua'chang	0
磁县供销社棉麻公司	ci'xian'gong'xiao'she'mian'ma'gong'si	0
大连市棉麻公司	da'lian'shi'mian'ma'gong'si	0
大名县棉麻公司	da'ming'xian'mian'ma'gong'si	0
大通湖农场棉麻油脂厂	da'tong'hu'nong'chang'mian'ma'you'zhi'chang	0
郸城县棉麻公司	dan'cheng'xian'mian'ma'gong'si	0
丹东市前阳棉麻纺织厂	dan'dong'shi'qian'yang'mian'ma'fang'zhi'chang	0
丹东市前阳亚麻纺织厂	dan'dong'shi'qian'yang'ya'ma'fang'zhi'chang	0
丹东市祥泰亚麻色织布厂	dan'dong'shi'xiang'tai'ya'ma'se'zhi'bu'chang	0
丹东市亚麻布厂	dan'dong'shi'ya'ma'bu'chang	0
丹东市振安区亚麻布厂	dan'dong'shi'zhen'an'qu'ya'ma'bu'chang	0
丹阳市棉麻纺织厂	dan'yang'shi'mian'ma'fang'zhi'chang	0
当涂县棉麻公司	dang'tu'xian'mian'ma'gong'si	0
德安县棉麻公司	de'an'xian'mian'ma'gong'si	0
德阳市棉麻总公司	de'yang'shi'mian'ma'zong'gong'si	0
德州市棉麻公司	de'zhou'shi'mian'ma'gong'si	0
灯塔县棉麻制品有限公司	deng'ta'xian'mian'ma'zhi'pin'you'xian'gong'si	0
定州市棉麻企业集团公司	ding'zhou'shi'mian'ma'qi'ye'ji'tuan'gong'si	0
东明县棉麻储贸公司	dong'ming'xian'mian'ma'chu'mao'gong'si	0
东明县棉麻加工二厂	dong'ming'xian'mian'ma'jia'gong'er'chang	0
东明县棉麻加工六厂	dong'ming'xian'mian'ma'jia'gong'liu'chang	0
东明县棉麻加工三厂	dong'ming'xian'mian'ma'jia'gong'san'chang	0
东明县棉麻加工四厂	dong'ming'xian'mian'ma'jia'gong'si'chang	0
东平县棉麻集团公司第三棉厂	dong'ping'xian'mian'ma'ji'tuan'gong'si'di'san'mian'chang	0
东平县棉麻集团总公司	dong'ping'xian'mian'ma'ji'tuan'zong'gong'si	0
东台市棉麻公司	dong'tai'shi'mian'ma'gong'si	0
东营市东营区棉麻公司良种加工厂	dong'ying'shi'dong'ying'qu'mian'ma'gong'si'liang'zhong'jia'gong'chang	0
范县棉麻公司	fan'xian'mian'ma'gong'si	0
方城棉麻公司	fang'cheng'mian'ma'gong'si	0
方正县亚麻厂	fang'zheng'xian'ya'ma'chang	0
方正县亚麻原料厂	fang'zheng'xian'ya'ma'yuan'liao'chang	0
肥城市棉麻纺织总公司	fei'cheng'shi'mian'ma'fang'zhi'zong'gong'si	0
肥西县棉麻公司高刘轧花厂	fei'xi'xian'mian'ma'gong'si'gao'liu'ya'hua'chang	0
肥西县棉麻公司山南轧花厂	fei'xi'xian'mian'ma'gong'si'shan'nan'ya'hua'chang	0
肥西县棉麻公司小庙轧花厂	fei'xi'xian'mian'ma'gong'si'xiao'miao'ya'hua'chang	0
凤城市棉麻公司	feng'cheng'shi'mian'ma'gong'si	0
丰县棉麻针织厂	feng'xian'mian'ma'zhen'zhi'chang	0
凤阳棉麻公司再生棉绒厂	feng'yang'mian'ma'gong'si'zai'sheng'mian'rong'chang	0
阜康市棉麻公司轧花厂	fu'kang'shi'mian'ma'gong'si'ya'hua'chang	0
阜宁县棉麻加工厂	fu'ning'xian'mian'ma'jia'gong'chang	0
浮山县棉麻公司	fu'shan'xian'mian'ma'gong'si	0
抚顺市顺城区榆林棉麻厂	fu'shun'shi'shun'cheng'qu'yu'lin'mian'ma'chang	0
阜阳地区棉麻公司	fu'yang'di'qu'mian'ma'gong'si	0
阜阳市颍东区棉麻公司轧花厂	fu'yang'shi'ying'dong'qu'mian'ma'gong'si'ya'hua'chang	0
伽师县棉麻公司轧花厂	ga'shi'xian'mian'ma'gong'si'ya'hua'chang	0
甘南县亚麻原料厂	gan'nan'xian'ya'ma'yuan'liao'chang	0
甘肃省棉麻总公司	gan'su'sheng'mian'ma'zong'gong'si	0
赣县棉麻土产公司	gan'xian'mian'ma'tu'chan'gong'si	0
高安棉麻纺织厂	gao'an'mian'ma'fang'zhi'chang	0
高安市棉麻公司	gao'an'shi'mian'ma'gong'si	0
高安市棉麻轧花厂	gao'an'shi'mian'ma'ya'hua'chang	0
高碑店市供销合作社联合社棉麻公司	gao'bei'dian'shi'gong'xiao'he'zuo'she'lian'he'she'mian'ma'gong'si	0
藁城市棉麻公司	gao'cheng'shi'mian'ma'gong'si	0
高阳县棉麻公司毛呢厂	gao'yang'xian'mian'ma'gong'si'mao'ni'chang	0
高阳县棉麻公司棉油加工厂	gao'yang'xian'mian'ma'gong'si'mian'you'jia'gong'chang	0
高邑棉麻公司棉纺织厂	gao'yi'mian'ma'gong'si'mian'fang'zhi'chang	0
高邑县棉麻纺织厂	gao'yi'xian'mian'ma'fang'zhi'chang	0
高邮市棉麻公司	gao'you'shi'mian'ma'gong'si	0
固安县棉麻公司	gu'an'xian'mian'ma'gong'si	0
固安县棉麻公司织布轧花厂	gu'an'xian'mian'ma'gong'si'zhi'bu'ya'hua'chang	0
古浪县胡家边乡亚麻厂	gu'lang'xian'hu'jia'bian'xiang'ya'ma'chang	0
沽源县国营亚麻厂	gu'yuan'xian'guo'ying'ya'ma'chang	0
沽源县闪电河乡亚麻二厂	gu'yuan'xian'shan'dian'he'xiang'ya'ma'er'chang	0
固原县什字路乡亚麻厂	gu'yuan'xian'shen'zi'lu'xiang'ya'ma'chang	0
固原县试验区西北亚麻开发公司	gu'yuan'xian'shi'yan'qu'xi'bei'ya'ma'kai'fa'gong'si	0
固原县头营乡亚麻厂	gu'yuan'xian'tou'ying'xiang'ya'ma'chang	0
固原县头营亚麻厂	gu'yuan'xian'tou'ying'ya'ma'chang	0
沽源县亚麻厂	gu'yuan'xian'ya'ma'chang	0
固镇县棉麻公司轧花厂	gu'zhen'xian'mian'ma'gong'si'ya'hua'chang	0
灌南县棉麻总公司	guan'nan'xian'mian'ma'zong'gong'si	0
灌云县棉麻公司板浦轧花厂	guan'yun'xian'mian'ma'gong'si'ban'pu'ya'hua'chang	0
灌云县棉麻集团有限司	guan'yun'xian'mian'ma'ji'tuan'you'xian'si	0
广州锐业亚麻布厂	guang'zhou'rui'ye'ya'ma'bu'chang	0
贵池市棉麻公司乌沙轧花厂	gui'chi'shi'mian'ma'gong'si'wu'sha'ya'hua'chang	0
涡阳县棉麻公司棉花加工二厂	guo'yang'xian'mian'ma'gong'si'mian'hua'jia'gong'er'chang	0
涡阳县棉麻公司棉花加工三厂	guo'yang'xian'mian'ma'gong'si'mian'hua'jia'gong'san'chang	0
涡阳县棉麻公司棉花加工一厂	guo'yang'xian'mian'ma'gong'si'mian'hua'jia'gong'yi'chang	0
哈尔滨北光亚麻制品公司	ha'er'bin'bei'guang'ya'ma'zhi'pin'gong'si	0
哈尔滨第二亚麻厂	ha'er'bin'di'er'ya'ma'chang	0
哈尔滨第二亚麻纺织厂	ha'er'bin'di'er'ya'ma'fang'zhi'chang	0
哈尔滨富达亚麻纺织品经销处	ha'er'bin'fu'da'ya'ma'fang'zhi'pin'jing'xiao'chu	0
哈尔滨呼兰亚麻原料厂	ha'er'bin'hu'lan'ya'ma'yuan'liao'chang	0
哈尔滨华锦亚麻纺织有限公司	ha'er'bin'hua'jin'ya'ma'fang'zhi'you'xian'gong'si	0
哈尔滨华隆亚麻制品有限责任公司	ha'er'bin'hua'long'ya'ma'zhi'pin'you'xian'ze'ren'gong'si	0
哈尔滨金华亚麻纺织厂驻上海办事处	ha'er'bin'jin'hua'ya'ma'fang'zhi'chang'zhu'shang'hai'ban'shi'chu	0
哈尔滨龙锦亚麻纺织贸易公司	ha'er'bin'long'jin'ya'ma'fang'zhi'mao'yi'gong'si	0
哈尔滨龙锦亚麻纺织贸易有限公司	ha'er'bin'long'jin'ya'ma'fang'zhi'mao'yi'you'xian'gong'si	0
哈尔滨龙锦亚麻公司	ha'er'bin'long'jin'ya'ma'gong'si	0
哈尔滨龙星亚麻纤维有限公司	ha'er'bin'long'xing'ya'ma'xian'wei'you'xian'gong'si	0
哈尔滨升利亚麻纺织工贸公司	ha'er'bin'sheng'li'ya'ma'fang'zhi'gong'mao'gong'si	0
哈尔滨市富达亚麻漂染厂	ha'er'bin'shi'fu'da'ya'ma'piao'ran'chang	0
哈尔滨市呼兰县莲花合丰亚麻制品厂	ha'er'bin'shi'hu'lan'xian'lian'hua'he'feng'ya'ma'zhi'pin'chang	0
哈尔滨市呼兰亚麻纺纱厂	ha'er'bin'shi'hu'lan'ya'ma'fang'sha'chang	0
哈尔滨市兴亚亚麻制品厂	ha'er'bin'shi'xing'ya'ya'ma'zhi'pin'chang	0
哈尔滨市亚东棉麻帆布厂	ha'er'bin'shi'ya'dong'mian'ma'fan'bu'chang	0
哈尔滨市亚麻纺织专用器材厂	ha'er'bin'shi'ya'ma'fang'zhi'zhuan'yong'qi'cai'chang	0
哈尔滨市亚麻纺专器材厂	ha'er'bin'shi'ya'ma'fang'zhuan'qi'cai'chang	0
哈尔滨市依兰县亚麻原料厂	ha'er'bin'shi'yi'lan'xian'ya'ma'yuan'liao'chang	0
哈尔滨市亿裕亚麻有限公司	ha'er'bin'shi'yi'yu'ya'ma'you'xian'gong'si	0
哈尔滨鑫华亚麻纺织厂	ha'er'bin'xin'hua'ya'ma'fang'zhi'chang	0
哈尔滨亚麻纺织厂	ha'er'bin'ya'ma'fang'zhi'chang	0
哈尔滨亚麻纺织技术开发中心	ha'er'bin'ya'ma'fang'zhi'ji'shu'kai'fa'zhong'xin	0
哈尔滨亚麻集团有限公司	ha'er'bin'ya'ma'ji'tuan'you'xian'gong'si	0
哈尔滨亚麻漂染有限公司	ha'er'bin'ya'ma'piao'ran'you'xian'gong'si	0
哈尔滨亚麻实业公司	ha'er'bin'ya'ma'shi'ye'gong'si	0
哈尔滨亚麻有限公司	ha'er'bin'ya'ma'you'xian'gong'si	0
哈尔滨永泰亚麻股份有限公司	ha'er'bin'yong'tai'ya'ma'gu'fen'you'xian'gong'si	0
哈密地区棉麻公司	ha'mi'di'qu'mian'ma'gong'si	0
哈市联通公司延寿亚麻分公司	ha'shi'lian'tong'gong'si'yan'shou'ya'ma'fen'gong'si	0
哈亚麻纺织厂劳动服务公司亚麻原料加工厂	ha'ya'ma'fang'zhi'chang'lao'dong'fu'wu'gong'si'ya'ma'yuan'liao'jia'gong'chang	0
海化市东风镇亚麻厂	hai'hua'shi'dong'feng'zhen'ya'ma'chang	0
海伦市爱国乡亚麻厂	hai'lun'shi'ai'guo'xiang'ya'ma'chang	0
海伦市百祥亚麻原料加工厂	hai'lun'shi'bai'xiang'ya'ma'yuan'liao'jia'gong'chang	0
海伦市共合亚麻原料厂	hai'lun'shi'gong'he'ya'ma'yuan'liao'chang	0
海伦市共合镇亚麻原料厂	hai'lun'shi'gong'he'zhen'ya'ma'yuan'liao'chang	0
海伦市共荣乡亚麻厂	hai'lun'shi'gong'rong'xiang'ya'ma'chang	0
海伦市共荣亚麻厂	hai'lun'shi'gong'rong'ya'ma'chang	0
海伦市海北亚麻厂	hai'lun'shi'hai'bei'ya'ma'chang	0
海伦市海北亚麻原料厂	hai'lun'shi'hai'bei'ya'ma'yuan'liao'chang	0
海伦市海北镇亚麻原料厂	hai'lun'shi'hai'bei'zhen'ya'ma'yuan'liao'chang	0
海伦市伦河亚麻厂	hai'lun'shi'lun'he'ya'ma'chang	0
海伦市松北亚麻厂	hai'lun'shi'song'bei'ya'ma'chang	0
海伦市祥富镇亚麻厂	hai'lun'shi'xiang'fu'zhen'ya'ma'chang	0
海伦市亚麻原料厂	hai'lun'shi'ya'ma'yuan'liao'chang	0
海伦市扎音河乡亚麻纤维厂	hai'lun'shi'zha'yin'he'xiang'ya'ma'xian'wei'chang	0
海门市棉麻总公司	hai'men'shi'mian'ma'zong'gong'si	0
含山县棉麻公司含城轧花总厂黄墩分厂	han'shan'xian'mian'ma'gong'si'han'cheng'ya'hua'zong'chang'huang'dun'fen'chang	0
含山县棉麻公司含山帆布厂	han'shan'xian'mian'ma'gong'si'han'shan'fan'bu'chang	0
含山县棉麻公司仙踪轧花厂	han'shan'xian'mian'ma'gong'si'xian'zong'ya'hua'chang	0
含山县棉麻公司仙踪扎花厂	han'shan'xian'mian'ma'gong'si'xian'zong'zha'hua'chang	0
河北磁县棉企集团棉麻纺织厂	he'bei'ci'xian'mian'qi'ji'tuan'mian'ma'fang'zhi'chang	0
河北东光棉麻公司	he'bei'dong'guang'mian'ma'gong'si	0
河北邯郸市大名县供销社棉麻公司北峰油棉厂	he'bei'han'dan'shi'da'ming'xian'gong'xiao'she'mian'ma'gong'si'bei'feng'you'mian'chang	0
河北省定州市棉麻棉纱厂	he'bei'sheng'ding'zhou'shi'mian'ma'mian'sha'chang	0
河北省定州市棉麻企业集团公司棉织厂	he'bei'sheng'ding'zhou'shi'mian'ma'qi'ye'ji'tuan'gong'si'mian'zhi'chang	0
河北省高阳县棉麻公司	he'bei'sheng'gao'yang'xian'mian'ma'gong'si	0
河北省高阳县棉麻公司毛呢厂	he'bei'sheng'gao'yang'xian'mian'ma'gong'si'mao'ni'chang	0
河北省供销合作联合社棉麻公司	he'bei'sheng'gong'xiao'he'zuo'lian'he'she'mian'ma'gong'si	0
河北省馆陶县供销社棉麻公司	he'bei'sheng'guan'tao'xian'gong'xiao'she'mian'ma'gong'si	0
河北省广宗县棉麻公司塘町分公司	he'bei'sheng'guang'zong'xian'mian'ma'gong'si'tang'ding'fen'gong'si	0
河北省海兴县棉麻公司油棉加工厂	he'bei'sheng'hai'xing'xian'mian'ma'gong'si'you'mian'jia'gong'chang	0
河北省邯郸市大名县棉麻公司埝头棉厂	he'bei'sheng'han'dan'shi'da'ming'xian'mian'ma'gong'si'nian'tou'mian'chang	0
河北省邯郸市峰峰矿区棉麻公司油棉加工厂	he'bei'sheng'han'dan'shi'feng'feng'kuang'qu'mian'ma'gong'si'you'mian'jia'gong'chang	0
河北省邯郸市邱县棉麻公司优种棉花加工厂	he'bei'sheng'han'dan'shi'qiu'xian'mian'ma'gong'si'you'zhong'mian'hua'jia'gong'chang	0
河北省邯郸市魏县供销联合社棉麻公司	he'bei'sheng'han'dan'shi'wei'xian'gong'xiao'lian'he'she'mian'ma'gong'si	0
河北省邯郸市武安市棉麻公司纺织厂	he'bei'sheng'han'dan'shi'wu'an'shi'mian'ma'gong'si'fang'zhi'chang	0
河北省冀州市棉麻公司油棉厂	he'bei'sheng'ji'zhou'shi'mian'ma'gong'si'you'mian'chang	0
河北省康保县土城子镇亚麻厂	he'bei'sheng'kang'bao'xian'tu'cheng'zi'zhen'ya'ma'chang	0
河北省唐山市遵化市棉麻公司	he'bei'sheng'tang'shan'shi'zun'hua'shi'mian'ma'gong'si	0
河北省辛集市棉麻公司	he'bei'sheng'xin'ji'shi'mian'ma'gong'si	0
鹤壁市棉麻公司	he'bi'shi'mian'ma'gong'si	0
河南宏润亚麻纺织有限公司	he'nan'hong'run'ya'ma'fang'zhi'you'xian'gong'si	0
河南省长葛市棉麻公司棉花加工厂	he'nan'sheng'chang'ge'shi'mian'ma'gong'si'mian'hua'jia'gong'chang	0
河南省黄泛区农场棉麻公司棉纺织厂	he'nan'sheng'huang'fan'qu'nong'chang'mian'ma'gong'si'mian'fang'zhi'chang	0
河南省林州市棉麻公司	he'nan'sheng'lin'zhou'shi'mian'ma'gong'si	0
河南省孟津县棉麻公司	he'nan'sheng'meng'jin'xian'mian'ma'gong'si	0
河南省棉麻公司	he'nan'sheng'mian'ma'gong'si	0
河南省三门峡市棉麻公司	he'nan'sheng'san'men'xia'shi'mian'ma'gong'si	0
河南省遂平棉麻公司	he'nan'sheng'sui'ping'mian'ma'gong'si	0
河南省尉氏县棉麻公司	he'nan'sheng'wei'shi'xian'mian'ma'gong'si	0
河南省舞阳县棉麻公司加工厂	he'nan'sheng'wu'yang'xian'mian'ma'gong'si'jia'gong'chang	0
河南省新蔡县棉麻公司	he'nan'sheng'xin'cai'xian'mian'ma'gong'si	0
河南省新乡市棉麻公司	he'nan'sheng'xin'xiang'shi'mian'ma'gong'si	0
河南省新乡县棉麻公司	he'nan'sheng'xin'xiang'xian'mian'ma'gong'si	0
河南省伊川县棉麻公司	he'nan'sheng'yi'chuan'xian'mian'ma'gong'si	0
河南省虞城县棉麻公司	he'nan'sheng'yu'cheng'xian'mian'ma'gong'si	0
河南省禹州市棉麻公司帆布厂	he'nan'sheng'yu'zhou'shi'mian'ma'gong'si'fan'bu'chang	0
和田地区策勒县供销合作联社棉麻分公司	he'tian'di'qu'ce'le'xian'gong'xiao'he'zuo'lian'she'mian'ma'fen'gong'si	0
菏泽地区棉麻公司	he'ze'di'qu'mian'ma'gong'si	0
黑龙江拜泉县亚麻原料厂	hei'long'jiang'bai'quan'xian'ya'ma'yuan'liao'chang	0
黑龙江海伦海南亚麻厂	hei'long'jiang'hai'lun'hai'nan'ya'ma'chang	0
黑龙江兰西亚麻纺织工业联合公司	hei'long'jiang'lan'xi'ya'ma'fang'zhi'gong'ye'lian'he'gong'si	0
黑龙江兰西亚麻纺织工业联合总公司	hei'long'jiang'lan'xi'ya'ma'fang'zhi'gong'ye'lian'he'zong'gong'si	0
黑龙江三和亚麻纺织有限公司	hei'long'jiang'san'he'ya'ma'fang'zhi'you'xian'gong'si	0
黑龙江省阿城市会宁棉麻织布厂	hei'long'jiang'sheng'a'cheng'shi'hui'ning'mian'ma'zhi'bu'chang	0
黑龙江省巴彦亚麻有限公司	hei'long'jiang'sheng'ba'yan'ya'ma'you'xian'gong'si	0
黑龙江省宝清亚麻原料厂	hei'long'jiang'sheng'bao'qing'ya'ma'yuan'liao'chang	0
黑龙江省海伦市景岩亚麻厂	hei'long'jiang'sheng'hai'lun'shi'jing'yan'ya'ma'chang	0
黑龙江省华锦亚麻纺织有限公司	hei'long'jiang'sheng'hua'jin'ya'ma'fang'zhi'you'xian'gong'si	0
黑龙江省桦南县亚麻原料厂	hei'long'jiang'sheng'hua'nan'xian'ya'ma'yuan'liao'chang	0
黑龙江省佳木斯亚麻有限公司	hei'long'jiang'sheng'jia'mu'si'ya'ma'you'xian'gong'si	0
黑龙江省克山亚麻纺织厂	hei'long'jiang'sheng'ke'shan'ya'ma'fang'zhi'chang	0
黑龙江省克山亚麻纺织厂原料分厂	hei'long'jiang'sheng'ke'shan'ya'ma'fang'zhi'chang'yuan'liao'fen'chang	0
黑龙江省兰西茂新亚麻纺织厂	hei'long'jiang'sheng'lan'xi'mao'xin'ya'ma'fang'zhi'chang	0
黑龙江省兰西县亚麻纺织股份有限公司	hei'long'jiang'sheng'lan'xi'xian'ya'ma'fang'zhi'gu'fen'you'xian'gong'si	0
黑龙江省兰西亚麻干纺总公司	hei'long'jiang'sheng'lan'xi'ya'ma'gan'fang'zong'gong'si	0
黑龙江省兰西亚麻原料总公司	hei'long'jiang'sheng'lan'xi'ya'ma'yuan'liao'zong'gong'si	0
黑龙江省明水县亚麻制品有限责任公司	hei'long'jiang'sheng'ming'shui'xian'ya'ma'zhi'pin'you'xian'ze'ren'gong'si	0
黑龙江省双城市亚麻纺织厂	hei'long'jiang'sheng'shuang'cheng'shi'ya'ma'fang'zhi'chang	0
黑龙江省绥化地区兰西县亚麻原料总公司	hei'long'jiang'sheng'sui'hua'di'qu'lan'xi'xian'ya'ma'yuan'liao'zong'gong'si	0
黑龙江省孙吴县亚麻原料厂	hei'long'jiang'sheng'sun'wu'xian'ya'ma'yuan'liao'chang	0
黑龙江省望奎县亚麻纺织厂	hei'long'jiang'sheng'wang'kui'xian'ya'ma'fang'zhi'chang	0
黑龙江省亚麻纺织股份有限公司	hei'long'jiang'sheng'ya'ma'fang'zhi'gu'fen'you'xian'gong'si	0
黑龙江省延寿县亚麻纺纱有限公司	hei'long'jiang'sheng'yan'shou'xian'ya'ma'fang'sha'you'xian'gong'si	0
黑龙江省延寿县亚麻棉有限公司	hei'long'jiang'sheng'yan'shou'xian'ya'ma'mian'you'xian'gong'si	0
黑龙江省延寿县亚麻原料厂	hei'long'jiang'sheng'yan'shou'xian'ya'ma'yuan'liao'chang	0
黑龙江远通亚麻纱布有限公司	hei'long'jiang'yuan'tong'ya'ma'sha'bu'you'xian'gong'si	0
黑山县棉麻总公司	hei'shan'xian'mian'ma'zong'gong'si	0
衡南县棉麻土产总公司	heng'nan'xian'mian'ma'tu'chan'zong'gong'si	0
衡阳市棉麻土产公司	heng'yang'shi'mian'ma'tu'chan'gong'si	0
宏星棉麻塑料综合厂	hong'xing'mian'ma'su'liao'zong'he'chang	0
沪建棉麻纺织厂	hu'jian'mian'ma'fang'zhi'chang	0
沪建棉麻纺织总厂	hu'jian'mian'ma'fang'zhi'zong'chang	0
湖口县棉麻纺厂	hu'kou'xian'mian'ma'fang'chang	0
湖口县棉麻公司棉纺厂	hu'kou'xian'mian'ma'gong'si'mian'fang'chang	0
呼兰县莲花亚麻原料厂	hu'lan'xian'lian'hua'ya'ma'yuan'liao'chang	0
呼兰县莲花亚麻制品厂	hu'lan'xian'lian'hua'ya'ma'zhi'pin'chang	0
呼兰县孟家福利亚麻加工厂	hu'lan'xian'meng'jia'fu'li'ya'ma'jia'gong'chang	0
呼兰县许卜乡亚麻制品厂	hu'lan'xian'xu'bo'xiang'ya'ma'zhi'pin'chang	0
呼兰县亚麻原料厂	hu'lan'xian'ya'ma'yuan'liao'chang	0
呼兰县亚麻制品厂	hu'lan'xian'ya'ma'zhi'pin'chang	0
呼盟棉麻公司扎兰屯棉织厂	hu'meng'mian'ma'gong'si'zha'lan'tun'mian'zhi'chang	0
湖南常德汉寿县西湖农场棉麻土产公司轧花厂	hu'nan'chang'de'han'shou'xian'xi'hu'nong'chang'mian'ma'tu'chan'gong'si'ya'hua'chang	0
湖南常德市汉寿县国营西湖农场棉麻土产公司	hu'nan'chang'de'shi'han'shou'xian'guo'ying'xi'hu'nong'chang'mian'ma'tu'chan'gong'si	0
湖南常德市汉寿县棉麻蚕茧总公司苎麻加工厂	hu'nan'chang'de'shi'han'shou'xian'mian'ma'can'jian'zong'gong'si'zhu'ma'jia'gong'chang	0
湖南棉麻	hu'nan'mian'ma	0
湖南省茶陵县棉麻土产公司轧花厂	hu'nan'sheng'cha'ling'xian'mian'ma'tu'chan'gong'si'ya'hua'chang	0
湖南省常德市安乡县棉麻公司中码头仓库	hu'nan'sheng'chang'de'shi'an'xiang'xian'mian'ma'gong'si'zhong'ma'tou'cang'ku	0
湖南省常德市安乡县棉麻公司中优质棉轧花厂	hu'nan'sheng'chang'de'shi'an'xiang'xian'mian'ma'gong'si'zhong'you'zhi'mian'ya'hua'chang	0
湖南省常德市安乡县棉麻总公司	hu'nan'sheng'chang'de'shi'an'xiang'xian'mian'ma'zong'gong'si	0
湖南省国营大通湖农场棉麻油脂厂	hu'nan'sheng'guo'ying'da'tong'hu'nong'chang'mian'ma'you'zhi'chang	0
湖南省棉麻企业股份有限公司	hu'nan'sheng'mian'ma'qi'ye'gu'fen'you'xian'gong'si	0
湖南省棉麻总公司	hu'nan'sheng'mian'ma'zong'gong'si	0
湖南省邵阳市棉麻茶土产总公司	hu'nan'sheng'shao'yang'shi'mian'ma'cha'tu'chan'zong'gong'si	0
湖南省桃源县棉麻蚕茧总公司	hu'nan'sheng'tao'yuan'xian'mian'ma'can'jian'zong'gong'si	0
湖南省益阳市赫山区棉麻土产公司	hu'nan'sheng'yi'yang'shi'he'shan'qu'mian'ma'tu'chan'gong'si	0
湖南省益阳市棉麻蚕茧公司	hu'nan'sheng'yi'yang'shi'mian'ma'can'jian'gong'si	0
呼图壁县棉麻公司大桥轧花厂	hu'tu'bi'xian'mian'ma'gong'si'da'qiao'ya'hua'chang	0
华锦亚麻纺织有限公司经销部	hua'jin'ya'ma'fang'zhi'you'xian'gong'si'jing'xiao'bu	0
华锦亚麻纺织有限公司青岛分公司	hua'jin'ya'ma'fang'zhi'you'xian'gong'si'qing'dao'fen'gong'si	0
桦南县亚麻厂	hua'nan'xian'ya'ma'chang	0
华妮亚麻纺织有限公司	hua'ni'ya'ma'fang'zhi'you'xian'gong'si	0
华容县棉麻纺织厂	hua'rong'xian'mian'ma'fang'zhi'chang	0
华容县棉麻土产公司	hua'rong'xian'mian'ma'tu'chan'gong'si	0
淮滨县棉麻公司	huai'bin'xian'mian'ma'gong'si	0
淮阳县棉麻企业集团	huai'yang'xian'mian'ma'qi'ye'ji'tuan	0
淮阳县棉麻总公司	huai'yang'xian'mian'ma'zong'gong'si	0
淮阴县棉麻公司缫丝厂	huai'yin'xian'mian'ma'gong'si'sao'si'chang	0
黄羊亚麻厂	huang'yang'ya'ma'chang	0
辉县市棉麻公司棉织厂	hui'xian'shi'mian'ma'gong'si'mian'zhi'chang	0
获嘉县棉麻公司城关棉油厂	huo'jia'xian'mian'ma'gong'si'cheng'guan'mian'you'chang	0
获嘉县棉麻公司亢村棉油厂	huo'jia'xian'mian'ma'gong'si'kang'cun'mian'you'chang	0
获嘉县棉麻公司中和轧花厂	huo'jia'xian'mian'ma'gong'si'zhong'he'ya'hua'chang	0
吉林省龙井市亚麻纺织厂	ji'lin'sheng'long'jing'shi'ya'ma'fang'zhi'chang	0
吉林省棉麻畜产品公司	ji'lin'sheng'mian'ma'xu'chan'pin'gong'si	0
吉林省乾安亚麻纺织厂	ji'lin'sheng'qian'an'ya'ma'fang'zhi'chang	0
济南市棉麻总公司	ji'nan'shi'mian'ma'zong'gong'si	0
济宁市棉麻总公司	ji'ning'shi'mian'ma'zong'gong'si	0
济宁市任城区棉麻公司	ji'ning'shi'ren'cheng'qu'mian'ma'gong'si	0
集贤县永安乡亚麻原料厂	ji'xian'xian'yong'an'xiang'ya'ma'yuan'liao'chang	0
佳木斯市亚麻纺织印染公司兴长经济贸易公司	jia'mu'si'shi'ya'ma'fang'zhi'yin'ran'gong'si'xing'chang'jing'ji'mao'yi'gong'si	0
佳木斯市亚麻原料回收加工厂	jia'mu'si'shi'ya'ma'yuan'liao'hui'shou'jia'gong'chang	0
佳木斯亚麻纺织印染联合公司劳动服务公司	jia'mu'si'ya'ma'fang'zhi'yin'ran'lian'he'gong'si'lao'dong'fu'wu'gong'si	0
佳木斯亚麻纺织印染联合公司劳服公司	jia'mu'si'ya'ma'fang'zhi'yin'ran'lian'he'gong'si'lao'fu'gong'si	0
佳木斯亚麻有限公司	jia'mu'si'ya'ma'you'xian'gong'si	0
嘉祥县棉麻公司	jia'xiang'xian'mian'ma'gong'si	0
建昌县棉麻公司加工厂	jian'chang'xian'mian'ma'gong'si'jia'gong'chang	0
建德市沪建棉麻纺织总厂	jian'de'shi'hu'jian'mian'ma'fang'zhi'zong'chang	0
剑阁县棉麻公司	jian'ge'xian'mian'ma'gong'si	0
剑阁县新桥棉麻加工厂	jian'ge'xian'xin'qiao'mian'ma'jia'gong'chang	0
建湖县棉麻总公司	jian'hu'xian'mian'ma'zong'gong'si	0
简阳市棉麻总公司	jian'yang'shi'mian'ma'zong'gong'si	0
江都市棉麻有限公司	jiang'du'shi'mian'ma'you'xian'gong'si	0
江苏泛佳亚麻纺织厂有限公司	jiang'su'fan'jia'ya'ma'fang'zhi'chang'you'xian'gong'si	0
江苏省丹阳市棉麻公司	jiang'su'sheng'dan'yang'shi'mian'ma'gong'si	0
江苏省阜宁县棉麻总公司	jiang'su'sheng'fu'ning'xian'mian'ma'zong'gong'si	0
江苏省海安县棉麻总公司	jiang'su'sheng'hai'an'xian'mian'ma'zong'gong'si	0
江苏省江阴市棉麻土产总公司	jiang'su'sheng'jiang'yin'shi'mian'ma'tu'chan'zong'gong'si	0
江苏省金坛市棉麻茶总公司	jiang'su'sheng'jin'tan'shi'mian'ma'cha'zong'gong'si	0
江苏省溧水县棉麻土产总公司	jiang'su'sheng'li'shui'xian'mian'ma'tu'chan'zong'gong'si	0
江苏省六合县棉麻公司	jiang'su'sheng'lu'he'xian'mian'ma'gong'si	0
江苏省棉麻公司淮阴总公司	jiang'su'sheng'mian'ma'gong'si'huai'yin'zong'gong'si	0
江苏省棉麻公司南通公司	jiang'su'sheng'mian'ma'gong'si'nan'tong'gong'si	0
江苏省棉麻集团公司	jiang'su'sheng'mian'ma'ji'tuan'gong'si	0
江苏省棉麻集团公司无锡总公司	jiang'su'sheng'mian'ma'ji'tuan'gong'si'wu'xi'zong'gong'si	0
江苏省沛县棉麻公司	jiang'su'sheng'pei'xian'mian'ma'gong'si	0
江苏银都棉麻股份有限公司	jiang'su'yin'du'mian'ma'gu'fen'you'xian'gong'si	0
江西省湖口县供销合作社棉麻公司	jiang'xi'sheng'hu'kou'xian'gong'xiao'he'zuo'she'mian'ma'gong'si	0
江西省九江县棉麻公司	jiang'xi'sheng'jiu'jiang'xian'mian'ma'gong'si	0
江西省乐平市棉麻公司轧花厂	jiang'xi'sheng'le'ping'shi'mian'ma'gong'si'ya'hua'chang	0
江西省乐平市棉麻公司扎花厂	jiang'xi'sheng'le'ping'shi'mian'ma'gong'si'zha'hua'chang	0
江西省棉麻公司崇仁县公司	jiang'xi'sheng'mian'ma'gong'si'chong'ren'xian'gong'si	0
江西省棉麻公司余干县瑞洪轧花厂	jiang'xi'sheng'mian'ma'gong'si'yu'gan'xian'rui'hong'ya'hua'chang	0
江西省棉麻集团公司江西省棉麻公司	jiang'xi'sheng'mian'ma'ji'tuan'gong'si'jiang'xi'sheng'mian'ma'gong'si	0
江西省上高县棉麻公司	jiang'xi'sheng'shang'gao'xian'mian'ma'gong'si	0
江西省万年县棉麻公司梓埠轧花厂	jiang'xi'sheng'wan'nian'xian'mian'ma'gong'si'zi'bu'ya'hua'chang	0
姜堰市棉麻总公司	jiang'yan'shi'mian'ma'zong'gong'si	0
焦作市棉麻公司综合加工厂	jiao'zuo'shi'mian'ma'gong'si'zong'he'jia'gong'chang	0
界首市棉麻轧花二厂	jie'shou'shi'mian'ma'ya'hua'er'chang	0
界首市棉麻轧花一厂	jie'shou'shi'mian'ma'ya'hua'yi'chang	0
金昌市东寨亚麻制品工业公司	jin'chang'shi'dong'zhai'ya'ma'zhi'pin'gong'ye'gong'si	0
金城棉麻纺织有限公司	jin'cheng'mian'ma'fang'zhi'you'xian'gong'si	0
金湖县土产棉麻总公司	jin'hu'xian'tu'chan'mian'ma'zong'gong'si	0
晋州市棉麻纺织厂	jin'zhou'shi'mian'ma'fang'zhi'chang	0
静海县棉麻公司	jing'hai'xian'mian'ma'gong'si	0
精河县棉麻公司八家户轧花厂	jing'he'xian'mian'ma'gong'si'ba'jia'hu'ya'hua'chang	0
精河县棉麻公司大河沿子轧花厂	jing'he'xian'mian'ma'gong'si'da'he'yan'zi'ya'hua'chang	0
精河县棉麻公司茫丁乡轧花厂	jing'he'xian'mian'ma'gong'si'mang'ding'xiang'ya'hua'chang	0
精河县棉麻公司棉纺厂	jing'he'xian'mian'ma'gong'si'mian'fang'chang	0
泾县棉麻公司轧花厂	jing'xian'mian'ma'gong'si'ya'hua'chang	0
井研县棉麻菸公司第一棉厂	jing'yan'xian'mian'ma'yan'gong'si'di'yi'mian'chang	0
靖州县棉麻土产公司农副部	jing'zhou'xian'mian'ma'tu'chan'gong'si'nong'fu'bu	0
浚县棉麻总公司	jun'xian'mian'ma'zong'gong'si	0
喀什地区棉麻公司	ka'shi'di'qu'mian'ma'gong'si	0
喀什市棉麻公司轧花厂	ka'shi'shi'mian'ma'gong'si'ya'hua'chang	0
开封市棉麻公司	kai'feng'shi'mian'ma'gong'si	0
开封县棉麻公司	kai'feng'xian'mian'ma'gong'si	0
开原吉星亚麻纺织有限公司	kai'yuan'ji'xing'ya'ma'fang'zhi'you'xian'gong'si	0
开原市亚麻纺织厂	kai'yuan'shi'ya'ma'fang'zhi'chang	0
开原市亚麻原料厂	kai'yuan'shi'ya'ma'yuan'liao'chang	0
克东县华兴亚麻原料厂	ke'dong'xian'hua'xing'ya'ma'yuan'liao'chang	0
克山县北兴镇亚麻原料厂	ke'shan'xian'bei'xing'zhen'ya'ma'yuan'liao'chang	0
克山县赛克亚麻制品加工厂	ke'shan'xian'sai'ke'ya'ma'zhi'pin'jia'gong'chang	0
克山县向华乡亚麻厂	ke'shan'xian'xiang'hua'xiang'ya'ma'chang	0
克山县向华乡亚麻原料厂	ke'shan'xian'xiang'hua'xiang'ya'ma'yuan'liao'chang	0
克山县亚麻纺织厂	ke'shan'xian'ya'ma'fang'zhi'chang	0
克山县亚麻原料厂	ke'shan'xian'ya'ma'yuan'liao'chang	0
克山县亚麻制品加工厂	ke'shan'xian'ya'ma'zhi'pin'jia'gong'chang	0
来安县棉麻公司梳棉厂	lai'an'xian'mian'ma'gong'si'shu'mian'chang	0
来安县棉麻公司轧花厂	lai'an'xian'mian'ma'gong'si'ya'hua'chang	0
涞水县棉麻烟公司	lai'shui'xian'mian'ma'yan'gong'si	0
莱州市亚麻纺织厂	lai'zhou'shi'ya'ma'fang'zhi'chang	0
兰西省榆林镇亚麻原料厂	lan'xi'sheng'yu'lin'zhen'ya'ma'yuan'liao'chang	0
兰西县北安乡亚麻原料厂	lan'xi'xian'bei'an'xiang'ya'ma'yuan'liao'chang	0
兰西县长岗乡亚麻原料厂	lan'xi'xian'chang'gang'xiang'ya'ma'yuan'liao'chang	0
兰西县长江乡亚麻原料厂	lan'xi'xian'chang'jiang'xiang'ya'ma'yuan'liao'chang	0
兰西县奋斗乡万顺亚麻厂	lan'xi'xian'fen'dou'xiang'wan'shun'ya'ma'chang	0
兰西县红星乡亚麻原料厂	lan'xi'xian'hong'xing'xiang'ya'ma'yuan'liao'chang	0
兰西县康荣乡亚麻原料厂	lan'xi'xian'kang'rong'xiang'ya'ma'yuan'liao'chang	0
兰西县兰河乡亚麻原料厂	lan'xi'xian'lan'he'xiang'ya'ma'yuan'liao'chang	0
兰西县燎原乡亚麻厂	lan'xi'xian'liao'yuan'xiang'ya'ma'chang	0
兰西县临江镇亚麻原料厂	lan'xi'xian'lin'jiang'zhen'ya'ma'yuan'liao'chang	0
兰西县平山镇金兴亚麻原料厂	lan'xi'xian'ping'shan'zhen'jin'xing'ya'ma'yuan'liao'chang	0
兰西县平山镇亚麻原料厂	lan'xi'xian'ping'shan'zhen'ya'ma'yuan'liao'chang	0
兰西县平山镇亚麻原料加工厂	lan'xi'xian'ping'shan'zhen'ya'ma'yuan'liao'jia'gong'chang	0
兰西县胜利乡亚麻厂	lan'xi'xian'sheng'li'xiang'ya'ma'chang	0
兰西县胜利乡亚麻原料厂	lan'xi'xian'sheng'li'xiang'ya'ma'yuan'liao'chang	0
兰西县星火乡亚麻厂	lan'xi'xian'xing'huo'xiang'ya'ma'chang	0
兰西县移新乡亚麻原料厂	lan'xi'xian'yi'xin'xiang'ya'ma'yuan'liao'chang	0
兰西县榆林镇亚麻原料厂	lan'xi'xian'yu'lin'zhen'ya'ma'yuan'liao'chang	0
兰西县远大乡亚麻原料厂	lan'xi'xian'yuan'da'xiang'ya'ma'yuan'liao'chang	0
兰西亚麻干纺总公司	lan'xi'ya'ma'gan'fang'zong'gong'si	0
廊坊市棉麻公司	lang'fang'shi'mian'ma'gong'si	0
阆中市棉麻公司	lang'zhong'shi'mian'ma'gong'si	0
乐陵市棉麻公司	le'ling'shi'mian'ma'gong'si	0
乐至县棉麻公司	le'zhi'xian'mian'ma'gong'si	0
耒阳市棉麻纺织厂	lei'yang'shi'mian'ma'fang'zhi'chang	0
澧县棉麻公司	li'xian'mian'ma'gong'si	0
溧阳市棉麻土产总公司	li'yang'shi'mian'ma'tu'chan'zong'gong'si	0
涟水县棉麻公司	lian'shui'xian'mian'ma'gong'si	0
连云港市棉麻公司轧花厂	lian'yun'gang'shi'mian'ma'gong'si'ya'hua'chang	0
连云港市云台区棉麻公司	lian'yun'gang'shi'yun'tai'qu'mian'ma'gong'si	0
聊城地区棉麻公司	liao'cheng'di'qu'mian'ma'gong'si	0
辽宁省黑山县棉麻总公司	liao'ning'sheng'hei'shan'xian'mian'ma'zong'gong'si	0
辽宁省棉麻公司	liao'ning'sheng'mian'ma'gong'si	0
临川市上顿渡棉麻公司	lin'chuan'shi'shang'dun'du'mian'ma'gong'si	0
林甸县红旗镇亚麻厂	lin'dian'xian'hong'qi'zhen'ya'ma'chang	0
林甸县宏伟亚麻原料厂	lin'dian'xian'hong'wei'ya'ma'yuan'liao'chang	0
临澧县棉麻公司	lin'li'xian'mian'ma'gong'si	0
临泉县棉麻公司	lin'quan'xian'mian'ma'gong'si	0
临沭县棉麻公司	lin'shu'xian'mian'ma'gong'si	0
临西棉麻公司	lin'xi'mian'ma'gong'si	0
临湘市棉麻总公司轧花厂	lin'xiang'shi'mian'ma'zong'gong'si'ya'hua'chang	0
临沂市土产棉麻总公司	lin'yi'shi'tu'chan'mian'ma'zong'gong'si	0
临邑县棉麻公司	lin'yi'xian'mian'ma'gong'si	0
临猗县棉麻公司	lin'yi'xian'mian'ma'gong'si	0
临颍县棉麻公司	lin'ying'xian'mian'ma'gong'si	0
林州市棉麻公司棉制品加工厂	lin'zhou'shi'mian'ma'gong'si'mian'zhi'pin'jia'gong'chang	0
凌海市棉麻公司锦州分公司	ling'hai'shi'mian'ma'gong'si'jin'zhou'fen'gong'si	0
凌海市棉麻公司石山分公司	ling'hai'shi'mian'ma'gong'si'shi'shan'fen'gong'si	0
凌海市棉麻公司田屯分公司	ling'hai'shi'mian'ma'gong'si'tian'tun'fen'gong'si	0
柳州市郊区白露棉麻制品厂	liu'zhou'shi'jiao'qu'bai'lu'mian'ma'zhi'pin'chang	0
隆昌县棉麻纺织厂	long'chang'xian'mian'ma'fang'zhi'chang	0
龙井市亚麻纺织厂	long'jing'shi'ya'ma'fang'zhi'chang	0
龙井市亚麻制品有限责任公司	long'jing'shi'ya'ma'zhi'pin'you'xian'ze'ren'gong'si	0
鹿城区棉麻公司	lu'cheng'qu'mian'ma'gong'si	0
鹿邑县棉麻集团公司棉花二厂	lu'yi'xian'mian'ma'ji'tuan'gong'si'mian'hua'er'chang	0
鹿邑县棉麻集团公司新集棉花加厂	lu'yi'xian'mian'ma'ji'tuan'gong'si'xin'ji'mian'hua'jia'chang	0
鹿邑县棉麻集团公司玄武镇棉花厂	lu'yi'xian'mian'ma'ji'tuan'gong'si'xuan'wu'zhen'mian'hua'chang	0
鹿邑县棉麻集团公司张店棉花厂	lu'yi'xian'mian'ma'ji'tuan'gong'si'zhang'dian'mian'hua'chang	0
轮台县棉麻公司加工厂	lun'tai'xian'mian'ma'gong'si'jia'gong'chang	0
漯河市棉麻公司	luo'he'shi'mian'ma'gong'si	0
漯河市源汇区供销合作社棉麻公司	luo'he'shi'yuan'hui'qu'gong'xiao'he'zuo'she'mian'ma'gong'si	0
罗山县供销社棉麻公司	luo'shan'xian'gong'xiao'she'mian'ma'gong'si	0
罗山县棉麻公司棉花加工厂	luo'shan'xian'mian'ma'gong'si'mian'hua'jia'gong'chang	0
玛纳斯县供销社棉麻公司	ma'na'si'xian'gong'xiao'she'mian'ma'gong'si	0
眉山供销社棉麻公司	mei'shan'gong'xiao'she'mian'ma'gong'si	0
蒙城县棉麻纺织集团总公司	meng'cheng'xian'mian'ma'fang'zhi'ji'tuan'zong'gong'si	0
蒙城县棉麻公司双涧轧花厂	meng'cheng'xian'mian'ma'gong'si'shuang'jian'ya'hua'chang	0
蒙城县棉麻公司坛城轧花厂布厂	meng'cheng'xian'mian'ma'gong'si'tan'cheng'ya'hua'chang'bu'chang	0
蒙城县棉麻公司银花气流纺织厂	meng'cheng'xian'mian'ma'gong'si'yin'hua'qi'liu'fang'zhi'chang	0
蒙城县棉麻公司银花絮棉厂	meng'cheng'xian'mian'ma'gong'si'yin'hua'xu'mian'chang	0
孟县棉麻公司城关镇棉花加工厂	meng'xian'mian'ma'gong'si'cheng'guan'zhen'mian'hua'jia'gong'chang	0
孟州市棉麻公司城伯棉花加工厂	meng'zhou'shi'mian'ma'gong'si'cheng'bo'mian'hua'jia'gong'chang	0
棉麻公司	mian'ma'gong'si	0
棉麻工业公司	mian'ma'gong'ye'gong'si	0
棉麻集团公司马铺棉花加工厂	mian'ma'ji'tuan'gong'si'ma'pu'mian'hua'jia'gong'chang	0
绵阳市棉麻总公司	mian'yang'shi'mian'ma'zong'gong'si	0
明光市棉麻公司	ming'guang'shi'mian'ma'gong'si	0
明水县棉麻公司	ming'shui'xian'mian'ma'gong'si	0
明水县通泉乡亚麻原料厂	ming'shui'xian'tong'quan'xiang'ya'ma'yuan'liao'chang	0
明水县亚麻原料厂	ming'shui'xian'ya'ma'yuan'liao'chang	0
明水县永兴镇亚麻厂	ming'shui'xian'yong'xing'zhen'ya'ma'chang	0
牡丹江市郊区东兴亚麻厂	mu'dan'jiang'shi'jiao'qu'dong'xing'ya'ma'chang	0
牡丹江市棉麻厂	mu'dan'jiang'shi'mian'ma'chang	0
牡丹江市庆江亚麻加工厂	mu'dan'jiang'shi'qing'jiang'ya'ma'jia'gong'chang	0
牡丹江市双龙亚麻厂	mu'dan'jiang'shi'shuang'long'ya'ma'chang	0
牡丹江市顺达亚麻厂	mu'dan'jiang'shi'shun'da'ya'ma'chang	0
牡丹江市铁岭棉麻厂	mu'dan'jiang'shi'tie'ling'mian'ma'chang	0
牡丹江市新兴棉麻厂	mu'dan'jiang'shi'xin'xing'mian'ma'chang	0
牡丹江市新旭亚麻厂	mu'dan'jiang'shi'xin'xu'ya'ma'chang	0
牡丹江市兴达亚麻加工厂	mu'dan'jiang'shi'xing'da'ya'ma'jia'gong'chang	0
牡丹江市阳明亚麻加工厂	mu'dan'jiang'shi'yang'ming'ya'ma'jia'gong'chang	0
南京棉麻化纤公司	nan'jing'mian'ma'hua'xian'gong'si	0
南京市江宁县土产棉麻总公司	nan'jing'shi'jiang'ning'xian'tu'chan'mian'ma'zong'gong'si	0
南京市棉麻总公司	nan'jing'shi'mian'ma'zong'gong'si	0
南乐县棉麻公司韩张轧花厂	nan'le'xian'mian'ma'gong'si'han'zhang'ya'hua'chang	0
南乐县棉麻公司元村轧花厂	nan'le'xian'mian'ma'gong'si'yuan'cun'ya'hua'chang	0
南平土产棉麻站针纺织品经营部	nan'ping'tu'chan'mian'ma'zhan'zhen'fang'zhi'pin'jing'ying'bu	0
南县棉麻总公司	nan'xian'mian'ma'zong'gong'si	0
南亚麻棉纺织印染总厂	nan'ya'ma'mian'fang'zhi'yin'ran'zong'chang	0
南阳市棉麻公司	nan'yang'shi'mian'ma'gong'si	0
内黄县棉麻公司井店轧花厂	nei'huang'xian'mian'ma'gong'si'jing'dian'ya'hua'chang	0
内黄县棉麻公司李庄轧花厂	nei'huang'xian'mian'ma'gong'si'li'zhuang'ya'hua'chang	0
内黄县棉麻公司田氏轧花厂	nei'huang'xian'mian'ma'gong'si'tian'shi'ya'hua'chang	0
内蒙古阿荣旗亚麻原料厂	nei'meng'gu'a'rong'qi'ya'ma'yuan'liao'chang	0
内乡县供销社棉麻公司	nei'xiang'xian'gong'xiao'she'mian'ma'gong'si	0
内乡县棉麻公司棉花加工二厂	nei'xiang'xian'mian'ma'gong'si'mian'hua'jia'gong'er'chang	0
内乡县棉麻公司棉花加工一厂	nei'xiang'xian'mian'ma'gong'si'mian'hua'jia'gong'yi'chang	0
尼勒克县乌赞亚麻原料厂	ni'le'ke'xian'wu'zan'ya'ma'yuan'liao'chang	0
宁安市棉麻制品厂	ning'an'shi'mian'ma'zhi'pin'chang	0
宁河县棉麻纺织厂	ning'he'xian'mian'ma'fang'zhi'chang	0
宁晋县棉麻公司	ning'jin'xian'mian'ma'gong'si	0
宁陵县棉麻公司	ning'ling'xian'mian'ma'gong'si	0
宁夏区棉麻日杂总公司	ning'xia'qu'mian'ma'ri'za'zong'gong'si	0
宁夏亚麻纺织印染厂	ning'xia'ya'ma'fang'zhi'yin'ran'chang	0
宁阳县棉麻公司东疏棉厂	ning'yang'xian'mian'ma'gong'si'dong'shu'mian'chang	0
宁阳县棉麻公司棉厂	ning'yang'xian'mian'ma'gong'si'mian'chang	0
宁阳县棉麻公司乡饮棉厂	ning'yang'xian'mian'ma'gong'si'xiang'yin'mian'chang	0
宁远县棉麻土产公司棉花加工厂	ning'yuan'xian'mian'ma'tu'chan'gong'si'mian'hua'jia'gong'chang	0
宁远县棉麻土产公司喜炮筒厂	ning'yuan'xian'mian'ma'tu'chan'gong'si'xi'pao'tong'chang	0
蓬莱市棉麻厂	peng'lai'shi'mian'ma'chang	0
蓬溪棉麻集团公司	peng'xi'mian'ma'ji'tuan'gong'si	0
彭阳县王洼乡亚麻厂	peng'yang'xian'wang'wa'xiang'ya'ma'chang	0
皮山县棉麻公司	pi'shan'xian'mian'ma'gong'si	0
平湖市化纤棉麻有限公司	ping'hu'shi'hua'xian'mian'ma'you'xian'gong'si	0
平罗县亚麻厂	ping'luo'xian'ya'ma'chang	0
平乡县棉麻公司油棉厂	ping'xiang'xian'mian'ma'gong'si'you'mian'chang	0
平阴县棉麻公司	ping'yin'xian'mian'ma'gong'si	0
蒲圻市棉麻纺织厂	pu'qi'shi'mian'ma'fang'zhi'chang	0
濮阳市棉麻公司	pu'yang'shi'mian'ma'gong'si	0
濮阳县棉麻公司	pu'yang'xian'mian'ma'gong'si	0
启东棉麻纺织厂	qi'dong'mian'ma'fang'zhi'chang	0
启东棉麻内衣厂	qi'dong'mian'ma'nei'yi'chang	0
启东市棉麻内衣厂	qi'dong'shi'mian'ma'nei'yi'chang	0
齐齐哈尔齐侨亚麻纺织有限公司	qi'qi'ha'er'qi'qiao'ya'ma'fang'zhi'you'xian'gong'si	0
齐齐哈尔市北方亚麻加工厂	qi'qi'ha'er'shi'bei'fang'ya'ma'jia'gong'chang	0
齐齐哈尔亚麻纺织厂	qi'qi'ha'er'ya'ma'fang'zhi'chang	0
杞县棉麻公司	qi'xian'mian'ma'gong'si	0
淇县棉麻公司第三轧花厂	qi'xian'mian'ma'gong'si'di'san'ya'hua'chang	0
淇县棉麻公司高村轧花厂	qi'xian'mian'ma'gong'si'gao'cun'ya'hua'chang	0
祁县棉麻公司棉花综合加工厂	qi'xian'mian'ma'gong'si'mian'hua'zong'he'jia'gong'chang	0
迁安市供销合作社联合社土产日杂棉麻公司	qian'an'shi'gong'xiao'he'zuo'she'lian'he'she'tu'chan'ri'za'mian'ma'gong'si	0
乾安县亚麻纺织厂	qian'an'xian'ya'ma'fang'zhi'chang	0
秦皇岛市棉麻土产公司	qin'huang'dao'shi'mian'ma'tu'chan'gong'si	0
青岛华昌棉麻纺织厂	qing'dao'hua'chang'mian'ma'fang'zhi'chang	0
青岛亚麻厂上海办	qing'dao'ya'ma'chang'shang'hai'ban	0
清丰县棉麻公司	qing'feng'xian'mian'ma'gong'si	0
青冈县互助乡亚麻厂	qing'gang'xian'hu'zhu'xiang'ya'ma'chang	0
青冈县互助亚麻厂	qing'gang'xian'hu'zhu'ya'ma'chang	0
青冈县劳动乡亚麻厂	qing'gang'xian'lao'dong'xiang'ya'ma'chang	0
青冈县芦河镇亚麻厂	qing'gang'xian'lu'he'zhen'ya'ma'chang	0
青冈县祯祥镇亚麻原料厂	qing'gang'xian'zhen'xiang'zhen'ya'ma'yuan'liao'chang	0
青阳县童埠棉麻纤维厂	qing'yang'xian'tong'bu'mian'ma'xian'wei'chang	0
庆云县棉麻公司	qing'yun'xian'mian'ma'gong'si	0
邱县供销合作社棉麻公司	qiu'xian'gong'xiao'he'zuo'she'mian'ma'gong'si	0
邱县棉麻公司优种棉加工厂	qiu'xian'mian'ma'gong'si'you'zhong'mian'jia'gong'chang	0
曲周县供销合作社棉麻公司	qu'zhou'xian'gong'xiao'he'zuo'she'mian'ma'gong'si	0
全椒县棉麻公司	quan'jiao'xian'mian'ma'gong'si	0
确山县棉麻公司棉花加工厂	que'shan'xian'mian'ma'gong'si'mian'hua'jia'gong'chang	0
任城区棉麻公司针织厂	ren'cheng'qu'mian'ma'gong'si'zhen'zhi'chang	0
如东县棉麻茧实业总公司	ru'dong'xian'mian'ma'jian'shi'ye'zong'gong'si	0
如皋市棉麻总公司	ru'gao'shi'mian'ma'zong'gong'si	0
汝阳县棉麻公司小店棉花加工厂	ru'yang'xian'mian'ma'gong'si'xiao'dian'mian'hua'jia'gong'chang	0
汝州市棉麻公司小屯棉花加工厂	ru'zhou'shi'mian'ma'gong'si'xiao'tun'mian'hua'jia'gong'chang	0
瑞昌市棉麻纺织厂	rui'chang'shi'mian'ma'fang'zhi'chang	0
瑞昌市棉麻公司	rui'chang'shi'mian'ma'gong'si	0
三台棉麻总公司	san'tai'mian'ma'zong'gong'si	0
三台县棉麻总公司观桥棉花加工厂	san'tai'xian'mian'ma'zong'gong'si'guan'qiao'mian'hua'jia'gong'chang	0
三台县棉麻总公司芦溪棉花加工厂	san'tai'xian'mian'ma'zong'gong'si'lu'xi'mian'hua'jia'gong'chang	0
三台县棉麻总公司西平棉花加工厂	san'tai'xian'mian'ma'zong'gong'si'xi'ping'mian'hua'jia'gong'chang	0
莎车县棉麻公司	sha'che'xian'mian'ma'gong'si	0
沙湾县棉麻公司	sha'wan'xian'mian'ma'gong'si	0
沙雅县棉麻公司	sha'ya'xian'mian'ma'gong'si	0
山东省苍山县棉麻公司	shan'dong'sheng'cang'shan'xian'mian'ma'gong'si	0
山东省德州市棉麻公司	shan'dong'sheng'de'zhou'shi'mian'ma'gong'si	0
山东省菏泽市棉麻公司	shan'dong'sheng'he'ze'shi'mian'ma'gong'si	0
山东省济阳县棉麻公司	shan'dong'sheng'ji'yang'xian'mian'ma'gong'si	0
山东省鄄城县棉麻公司	shan'dong'sheng'juan'cheng'xian'mian'ma'gong'si	0
山东省乐陵市棉麻公司	shan'dong'sheng'le'ling'shi'mian'ma'gong'si	0
山东省利津县棉麻公司	shan'dong'sheng'li'jin'xian'mian'ma'gong'si	0
山东省棉麻公司	shan'dong'sheng'mian'ma'gong'si	0
山东省宁阳县棉麻公司	shan'dong'sheng'ning'yang'xian'mian'ma'gong'si	0
山东省平阴县棉麻公司	shan'dong'sheng'ping'yin'xian'mian'ma'gong'si	0
山东省齐河县棉麻纺织厂	shan'dong'sheng'qi'he'xian'mian'ma'fang'zhi'chang	0
山东省青州市棉麻公司	shan'dong'sheng'qing'zhou'shi'mian'ma'gong'si	0
山东省日照市棉麻公司	shan'dong'sheng'ri'zhao'shi'mian'ma'gong'si	0
山东省天鹏棉麻股份有限公司	shan'dong'sheng'tian'peng'mian'ma'gu'fen'you'xian'gong'si	0
山东省五莲县棉麻公司	shan'dong'sheng'wu'lian'xian'mian'ma'gong'si	0
山东省夏津县棉麻公司第二棉花加工厂	shan'dong'sheng'xia'jin'xian'mian'ma'gong'si'di'er'mian'hua'jia'gong'chang	0
山东省夏津县棉麻公司第九棉花加工厂	shan'dong'sheng'xia'jin'xian'mian'ma'gong'si'di'jiu'mian'hua'jia'gong'chang	0
山东省夏津县棉麻公司第七棉花加工厂	shan'dong'sheng'xia'jin'xian'mian'ma'gong'si'di'qi'mian'hua'jia'gong'chang	0
山东省夏津县棉麻公司第三油棉加工厂	shan'dong'sheng'xia'jin'xian'mian'ma'gong'si'di'san'you'mian'jia'gong'chang	0
山东省夏津县棉麻公司第四油棉加工厂	shan'dong'sheng'xia'jin'xian'mian'ma'gong'si'di'si'you'mian'jia'gong'chang	0
山东省夏津县棉麻公司第五棉花加工厂	shan'dong'sheng'xia'jin'xian'mian'ma'gong'si'di'wu'mian'hua'jia'gong'chang	0
山东省夏津县棉麻公司第一棉花加工厂	shan'dong'sheng'xia'jin'xian'mian'ma'gong'si'di'yi'mian'hua'jia'gong'chang	0
山东省郓城县棉麻纺织厂	shan'dong'sheng'yun'cheng'xian'mian'ma'fang'zhi'chang	0
山东天鹏棉麻股份有限公司	shan'dong'tian'peng'mian'ma'gu'fen'you'xian'gong'si	0
山东天鹏棉麻有限公司	shan'dong'tian'peng'mian'ma'you'xian'gong'si	0
山西棉麻公司介休棉麻纺织品采购供应站	shan'xi'mian'ma'gong'si'jie'xiu'mian'ma'fang'zhi'pin'cai'gou'gong'ying'zhan	0
陕西省棉麻公司	shan'xi'sheng'mian'ma'gong'si	0
山西省朔州亚麻厂	shan'xi'sheng'shuo'zhou'ya'ma'chang	0
山西省夏县棉麻总公司	shan'xi'sheng'xia'xian'mian'ma'zong'gong'si	0
山西省运城市棉麻公司	shan'xi'sheng'yun'cheng'shi'mian'ma'gong'si	0
陕县棉麻公司大营轧花厂	shan'xian'mian'ma'gong'si'da'ying'ya'hua'chang	0
上蔡县棉麻公司	shang'cai'xian'mian'ma'gong'si	0
商都县亚麻纺织厂	shang'du'xian'ya'ma'fang'zhi'chang	0
商丘地区棉麻总公司	shang'qiu'di'qu'mian'ma'zong'gong'si	0
商丘县棉麻第十一棉厂	shang'qiu'xian'mian'ma'di'shi'yi'mian'chang	0
商丘县棉麻公司第九棉厂	shang'qiu'xian'mian'ma'gong'si'di'jiu'mian'chang	0
商丘县棉麻公司第六棉厂	shang'qiu'xian'mian'ma'gong'si'di'liu'mian'chang	0
商丘县棉麻公司第三棉厂	shang'qiu'xian'mian'ma'gong'si'di'san'mian'chang	0
商丘县棉麻公司第十棉厂	shang'qiu'xian'mian'ma'gong'si'di'shi'mian'chang	0
商丘县棉麻公司第四厂	shang'qiu'xian'mian'ma'gong'si'di'si'chang	0
商丘县棉麻公司第一棉厂	shang'qiu'xian'mian'ma'gong'si'di'yi'mian'chang	0
商水县棉麻公司	shang'shui'xian'mian'ma'gong'si	0
上虞市四新棉麻纺织厂	shang'yu'shi'si'xin'mian'ma'fang'zhi'chang	0
尚志市华鑫棉麻厂	shang'zhi'shi'hua'xin'mian'ma'chang	0
绍兴银龙棉麻纺织有限公司	shao'xing'yin'long'mian'ma'fang'zhi'you'xian'gong'si	0
沈阳市棉麻公司	shen'yang'shi'mian'ma'gong'si	0
深泽县棉麻公司纺纱厂	shen'ze'xian'mian'ma'gong'si'fang'sha'chang	0
深圳汇翔亚麻纺织有限公司	shen'zhen'hui'xiang'ya'ma'fang'zhi'you'xian'gong'si	0
深圳新龙亚麻纺织漂染公司	shen'zhen'xin'long'ya'ma'fang'zhi'piao'ran'gong'si	0
深圳新龙亚麻纺织漂染有限公司	shen'zhen'xin'long'ya'ma'fang'zhi'piao'ran'you'xian'gong'si	0
省棉麻集团公司徐州总公司	sheng'mian'ma'ji'tuan'gong'si'xu'zhou'zong'gong'si	0
嵊州市棉麻纺织印染总厂	sheng'zhou'shi'mian'ma'fang'zhi'yin'ran'zong'chang	0
石家庄市第一棉麻总公司	shi'jia'zhuang'shi'di'yi'mian'ma'zong'gong'si	0
市郊区棉麻茧茶公司	shi'jiao'qu'mian'ma'jian'cha'gong'si	0
石门县棉麻蚕茧公司	shi'men'xian'mian'ma'can'jian'gong'si	0
市棉麻土产公司轧花厂	shi'mian'ma'tu'chan'gong'si'ya'hua'chang	0
市棉麻总公司	shi'mian'ma'zong'gong'si	0
寿县棉麻公司苏王轧花厂	shou'xian'mian'ma'gong'si'su'wang'ya'hua'chang	0
寿县棉麻公司瓦埠轧花厂	shou'xian'mian'ma'gong'si'wa'bu'ya'hua'chang	0
寿县棉麻公司堰口轧花厂	shou'xian'mian'ma'gong'si'yan'kou'ya'hua'chang	0
寿县棉麻公司炎刘梳棉纺织厂	shou'xian'mian'ma'gong'si'yan'liu'shu'mian'fang'zhi'chang	0
寿县棉麻公司迎河轧花厂	shou'xian'mian'ma'gong'si'ying'he'ya'hua'chang	0
舒城县棉麻公司	shu'cheng'xian'mian'ma'gong'si	0
疏附县棉麻公司	shu'fu'xian'mian'ma'gong'si	0
疏勒县棉麻公司	shu'le'xian'mian'ma'gong'si	0
双城市朝阳乡亚麻厂	shuang'cheng'shi'chao'yang'xiang'ya'ma'chang	0
双城市单城镇亚麻原料厂	shuang'cheng'shi'dan'cheng'zhen'ya'ma'yuan'liao'chang	0
双城市亚麻纺织福利织布厂	shuang'cheng'shi'ya'ma'fang'zhi'fu'li'zhi'bu'chang	0
水富县棉麻纺织品厂	shui'fu'xian'mian'ma'fang'zhi'pin'chang	0
朔州亚麻纺织厂	shuo'zhou'ya'ma'fang'zhi'chang	0
四川棉麻公司南充经营站棉机厂	si'chuan'mian'ma'gong'si'nan'chong'jing'ying'zhan'mian'ji'chang	0
四川省安岳县棉麻公司	si'chuan'sheng'an'yue'xian'mian'ma'gong'si	0
四川省棉麻土产总公司	si'chuan'sheng'mian'ma'tu'chan'zong'gong'si	0
四川省内江市棉麻总公司	si'chuan'sheng'nei'jiang'shi'mian'ma'zong'gong'si	0
四川省仁寿县棉麻菸公司	si'chuan'sheng'ren'shou'xian'mian'ma'yan'gong'si	0
四川省三台棉麻总公司棉编织厂	si'chuan'sheng'san'tai'mian'ma'zong'gong'si'mian'bian'zhi'chang	0
四川省三台棉麻总公司棉纺织厂	si'chuan'sheng'san'tai'mian'ma'zong'gong'si'mian'fang'zhi'chang	0
松江棉麻土产总公司纺织原料分公司	song'jiang'mian'ma'tu'chan'zong'gong'si'fang'zhi'yuan'liao'fen'gong'si	0
宿迁市棉麻公司	su'qian'shi'mian'ma'gong'si	0
宿松县棉麻纺织厂	su'song'xian'mian'ma'fang'zhi'chang	0
苏州南亚麻棉纺织印染	su'zhou'nan'ya'ma'mian'fang'zhi'yin'ran	0
苏州南亚麻棉纺织印染总厂	su'zhou'nan'ya'ma'mian'fang'zhi'yin'ran'zong'chang	0
宿州市第一棉麻公司第二轧花厂	su'zhou'shi'di'yi'mian'ma'gong'si'di'er'ya'hua'chang	0
宿州市第一棉麻公司第三轧花厂	su'zhou'shi'di'yi'mian'ma'gong'si'di'san'ya'hua'chang	0
宿州市第一棉麻公司第四轧花厂	su'zhou'shi'di'yi'mian'ma'gong'si'di'si'ya'hua'chang	0
宿州市第一棉麻公司第五轧花厂	su'zhou'shi'di'yi'mian'ma'gong'si'di'wu'ya'hua'chang	0
宿州市第一棉麻公司第一轧花厂	su'zhou'shi'di'yi'mian'ma'gong'si'di'yi'ya'hua'chang	0
宿州市茂源棉麻厂	su'zhou'shi'mao'yuan'mian'ma'chang	0
苏州市棉麻物资公司	su'zhou'shi'mian'ma'wu'zi'gong'si	0
绥化港艺亚麻纺织有限公司	sui'hua'gang'yi'ya'ma'fang'zhi'you'xian'gong'si	0
绥化市港艺亚麻纺织有限公司	sui'hua'shi'gang'yi'ya'ma'fang'zhi'you'xian'gong'si	0
绥化市连岗乡亚麻厂	sui'hua'shi'lian'gang'xiang'ya'ma'chang	0
绥化市连岗亚麻厂	sui'hua'shi'lian'gang'ya'ma'chang	0
绥化市隆太亚麻厂	sui'hua'shi'long'tai'ya'ma'chang	0
绥化市西长发镇亚麻厂	sui'hua'shi'xi'chang'fa'zhen'ya'ma'chang	0
绥化市永安亚麻厂	sui'hua'shi'yong'an'ya'ma'chang	0
绥化市永安镇亚麻厂	sui'hua'shi'yong'an'zhen'ya'ma'chang	0
绥棱县克音河乡九井亚麻厂	sui'leng'xian'ke'yin'he'xiang'jiu'jing'ya'ma'chang	0
绥棱县双岔河乡亚麻厂	sui'leng'xian'shuang'cha'he'xiang'ya'ma'chang	0
绥棱县双岔河亚麻厂	sui'leng'xian'shuang'cha'he'ya'ma'chang	0
遂宁市中区棉麻公司白马分公司	sui'ning'shi'zhong'qu'mian'ma'gong'si'bai'ma'fen'gong'si	0
遂宁市中区棉麻公司东禅分公司	sui'ning'shi'zhong'qu'mian'ma'gong'si'dong'chan'fen'gong'si	0
遂宁市中区棉麻公司桂花分公司	sui'ning'shi'zhong'qu'mian'ma'gong'si'gui'hua'fen'gong'si	0
遂宁市中区棉麻公司横山分公司	sui'ning'shi'zhong'qu'mian'ma'gong'si'heng'shan'fen'gong'si	0
遂宁市中区棉麻公司栏江分公司	sui'ning'shi'zhong'qu'mian'ma'gong'si'lan'jiang'fen'gong'si	0
遂宁市中区棉麻公司西眉分公司	sui'ning'shi'zhong'qu'mian'ma'gong'si'xi'mei'fen'gong'si	0
遂宁市中区棉麻集团公司	sui'ning'shi'zhong'qu'mian'ma'ji'tuan'gong'si	0
睢宁县棉麻公司织布厂	sui'ning'xian'mian'ma'gong'si'zhi'bu'chang	0
睢宁县棉麻总公司	sui'ning'xian'mian'ma'zong'gong'si	0
绥中县棉麻公司	sui'zhong'xian'mian'ma'gong'si	0
泰安市郊区棉麻公司	tai'an'shi'jiao'qu'mian'ma'gong'si	0
泰安市棉麻公司	tai'an'shi'mian'ma'gong'si	0
太仓市棉麻总公司	tai'cang'shi'mian'ma'zong'gong'si	0
太和县棉麻公司	tai'he'xian'mian'ma'gong'si	0
太和县肖口镇棉麻纺厂	tai'he'xian'xiao'kou'zhen'mian'ma'fang'chang	0
太湖县棉麻公司皮革制品厂	tai'hu'xian'mian'ma'gong'si'pi'ge'zhi'pin'chang	0
太康县棉麻集团棉纺织厂	tai'kang'xian'mian'ma'ji'tuan'mian'fang'zhi'chang	0
泰兴市棉麻有限责任公司	tai'xing'shi'mian'ma'you'xian'ze'ren'gong'si	0
唐山市棉麻总公司	tang'shan'shi'mian'ma'zong'gong'si	0
桃源县江源联合棉麻纺织厂	tao'yuan'xian'jiang'yuan'lian'he'mian'ma'fang'zhi'chang	0
桃源县棉麻蚕茧公司	tao'yuan'xian'mian'ma'can'jian'gong'si	0
滕州市棉麻公司棉花加工厂	teng'zhou'shi'mian'ma'gong'si'mian'hua'jia'gong'chang	0
滕州市棉麻总公司	teng'zhou'shi'mian'ma'zong'gong'si	0
天长市棉麻总公司	tian'chang'shi'mian'ma'zong'gong'si	0
天津市宝坻县棉麻公司	tian'jin'shi'bao'di'xian'mian'ma'gong'si	0
天津市宏兴棉麻塑料厂	tian'jin'shi'hong'xing'mian'ma'su'liao'chang	0
天津市棉麻总公司	tian'jin'shi'mian'ma'zong'gong'si	0
天津市宁河县棉麻公司	tian'jin'shi'ning'he'xian'mian'ma'gong'si	0
天津岳兴棉麻有限公司	tian'jin'yue'xing'mian'ma'you'xian'gong'si	0
铁岭市亚麻精品厂	tie'ling'shi'ya'ma'jing'pin'chang	0
桐城县棉麻茶茧公司	tong'cheng'xian'mian'ma'cha'jian'gong'si	0
铜陵县棉麻公司织布厂	tong'ling'xian'mian'ma'gong'si'zhi'bu'chang	0
铜山县棉麻公司	tong'shan'xian'mian'ma'gong'si	0
桐乡市亚麻纺织厂	tong'xiang'shi'ya'ma'fang'zhi'chang	0
通许县棉麻公司玉皇庙棉花加工厂	tong'xu'xian'mian'ma'gong'si'yu'huang'miao'mian'hua'jia'gong'chang	0
通州市棉麻机械厂	tong'zhou'shi'mian'ma'ji'xie'chang	0
通州市棉麻总公司	tong'zhou'shi'mian'ma'zong'gong'si	0
吐鲁番市棉麻公司	tu'lu'fan'shi'mian'ma'gong'si	0
托克逊县供销合作联社棉麻公司	tuo'ke'xun'xian'gong'xiao'he'zuo'lian'she'mian'ma'gong'si	0
万源市棉麻纺织厂	wan'yuan'shi'mian'ma'fang'zhi'chang	0
万载县棉麻纺织进出口公司	wan'zai'xian'mian'ma'fang'zhi'jin'chu'kou'gong'si	0
望江县棉麻织布厂	wang'jiang'xian'mian'ma'zhi'bu'chang	0
望奎县恭六乡亚麻厂	wang'kui'xian'gong'liu'xiang'ya'ma'chang	0
望奎县先锋乡亚麻厂	wang'kui'xian'xian'feng'xiang'ya'ma'chang	0
望奎县先锋亚麻厂	wang'kui'xian'xian'feng'ya'ma'chang	0
望奎县兴海亚麻厂	wang'kui'xian'xing'hai'ya'ma'chang	0
潍坊市棉麻公司	wei'fang'shi'mian'ma'gong'si	0
威海市土产杂品棉麻总公司	wei'hai'shi'tu'chan'za'pin'mian'ma'zong'gong'si	0
卫辉市棉麻公司棉花加工厂	wei'hui'shi'mian'ma'gong'si'mian'hua'jia'gong'chang	0
卫辉市棉麻公司轧花厂	wei'hui'shi'mian'ma'gong'si'ya'hua'chang	0
尉氏县门楼任乡棉麻纺织厂	wei'shi'xian'men'lou'ren'xiang'mian'ma'fang'zhi'chang	0
威县棉麻公司	wei'xian'mian'ma'gong'si	0
文水棉麻纺织公司棉绒制品综合厂	wen'shui'mian'ma'fang'zhi'gong'si'mian'rong'zhi'pin'zong'he'chang	0
文水棉麻纺织公司批发部	wen'shui'mian'ma'fang'zhi'gong'si'pi'fa'bu	0
文水棉麻纺织品公司针纺织品专店	wen'shui'mian'ma'fang'zhi'pin'gong'si'zhen'fang'zhi'pin'zhuan'dian	0
温宿县供销社棉麻公司	wen'su'xian'gong'xiao'she'mian'ma'gong'si	0
温宿县棉麻公司茶畜公司皮革厂	wen'su'xian'mian'ma'gong'si'cha'chu'gong'si'pi'ge'chang	0
温宿县棉麻公司轧花厂	wen'su'xian'mian'ma'gong'si'ya'hua'chang	0
温县棉麻公司轧花厂	wen'xian'mian'ma'gong'si'ya'hua'chang	0
温州市瓯海梧埏棉麻加工厂	wen'zhou'shi'ou'hai'wu'shan'mian'ma'jia'gong'chang	0
武安市棉麻公司	wu'an'shi'mian'ma'gong'si	0
五常市拉林棉麻加工厂	wu'chang'shi'la'lin'mian'ma'jia'gong'chang	0
武汉市胜利纺织品批发公司棉麻劳保用品厂	wu'han'shi'sheng'li'fang'zhi'pin'pi'fa'gong'si'mian'ma'lao'bao'yong'pin'chang	0
武汉市新春棉麻加工厂	wu'han'shi'xin'chun'mian'ma'jia'gong'chang	0
五河县棉麻公司纺纱厂	wu'he'xian'mian'ma'gong'si'fang'sha'chang	0
五河县棉麻公司纺织厂	wu'he'xian'mian'ma'gong'si'fang'zhi'chang	0
五河县棉麻公司沫河口轧花厂	wu'he'xian'mian'ma'gong'si'mo'he'kou'ya'hua'chang	0
五河县棉麻公司新集轧花厂	wu'he'xian'mian'ma'gong'si'xin'ji'ya'hua'chang	0
五河县棉麻公司轧花厂	wu'he'xian'mian'ma'gong'si'ya'hua'chang	0
芜湖市棉麻公司	wu'hu'shi'mian'ma'gong'si	0
芜湖县棉麻土产公司	wu'hu'xian'mian'ma'tu'chan'gong'si	0
芜湖县棉麻土产公司轧花厂	wu'hu'xian'mian'ma'tu'chan'gong'si'ya'hua'chang	0
武进市水利棉麻织造厂	wu'jin'shi'shui'li'mian'ma'zhi'zao'chang	0
武进市土产棉麻公司	wu'jin'shi'tu'chan'mian'ma'gong'si	0
乌鲁木齐棉麻厂	wu'lu'mu'qi'mian'ma'chang	0
武清县棉麻公司	wu'qing'xian'mian'ma'gong'si	0
乌什县棉麻公司	wu'shi'xian'mian'ma'gong'si	0
乌苏市棉麻公司	wu'su'shi'mian'ma'gong'si	0
武威市黄羊亚麻厂	wu'wei'shi'huang'yang'ya'ma'chang	0
吴县市蠡口化纤棉麻纺织厂	wu'xian'shi'li'kou'hua'xian'mian'ma'fang'zhi'chang	0
吴县市土产棉麻公司	wu'xian'shi'tu'chan'mian'ma'gong'si	0
武陟县棉麻公司纺织厂	wu'zhi'xian'mian'ma'gong'si'fang'zhi'chang	0
西充县棉麻公司	xi'chong'xian'mian'ma'gong'si	0
西华县棉麻公司	xi'hua'xian'mian'ma'gong'si	0
西吉县白崖乡亚麻纤维厂	xi'ji'xian'bai'ya'xiang'ya'ma'xian'wei'chang	0
西吉县兴隆镇亚麻厂	xi'ji'xian'xing'long'zhen'ya'ma'chang	0
希勤乡亚麻厂	xi'qin'xiang'ya'ma'chang	0
息县棉麻公司	xi'xian'mian'ma'gong'si	0
夏邑县棉麻公司	xia'yi'xian'mian'ma'gong'si	0
咸阳市棉麻公司	xian'yang'shi'mian'ma'gong'si	0
咸阳市渭城区棉麻公司	xian'yang'shi'wei'cheng'qu'mian'ma'gong'si	0
象山县棉麻针织厂	xiang'shan'xian'mian'ma'zhen'zhi'chang	0
响水县棉麻公司	xiang'shui'xian'mian'ma'gong'si	0
萧县棉麻公司	xiao'xian'mian'ma'gong'si	0
孝义市棉麻纺织品公司	xiao'yi'shi'mian'ma'fang'zhi'pin'gong'si	0
新疆巴州棉麻公司	xin'jiang'ba'zhou'mian'ma'gong'si	0
新疆兵团棉麻公司	xin'jiang'bing'tuan'mian'ma'gong'si	0
新疆兵团农五师棉麻公司农五师分司	xin'jiang'bing'tuan'nong'wu'shi'mian'ma'gong'si'nong'wu'shi'fen'si	0
新疆昌吉回族自治州棉麻公司	xin'jiang'chang'ji'hui'zu'zi'zhi'zhou'mian'ma'gong'si	0
新疆昌吉市棉麻公司	xin'jiang'chang'ji'shi'mian'ma'gong'si	0
新疆和硕县棉麻公司	xin'jiang'he'shuo'xian'mian'ma'gong'si	0
新疆和田地区和田市棉麻公司轧花厂	xin'jiang'he'tian'di'qu'he'tian'shi'mian'ma'gong'si'ya'hua'chang	0
新疆和田地区棉麻公司	xin'jiang'he'tian'di'qu'mian'ma'gong'si	0
新疆和田地区墨玉县棉麻公司轧花厂	xin'jiang'he'tian'di'qu'mo'yu'xian'mian'ma'gong'si'ya'hua'chang	0
新疆和田县供销社棉麻公司	xin'jiang'he'tian'xian'gong'xiao'she'mian'ma'gong'si	0
新疆呼图壁县供销社总公司棉麻公司	xin'jiang'hu'tu'bi'xian'gong'xiao'she'zong'gong'si'mian'ma'gong'si	0
新疆轮台县棉麻公司加工厂	xin'jiang'lun'tai'xian'mian'ma'gong'si'jia'gong'chang	0
新疆麦盖提县棉麻公司	xin'jiang'mai'gai'ti'xian'mian'ma'gong'si	0
新疆棉麻公司大河沿棉麻站	xin'jiang'mian'ma'gong'si'da'he'yan'mian'ma'zhan	0
新疆棉麻公司服务中心洁玉书刊发行部	xin'jiang'mian'ma'gong'si'fu'wu'zhong'xin'jie'yu'shu'kan'fa'xing'bu	0
新疆墨玉县供销联社总公司棉麻公司	xin'jiang'mo'yu'xian'gong'xiao'lian'she'zong'gong'si'mian'ma'gong'si	0
新疆且末县棉麻公司	xin'jiang'qie'mo'xian'mian'ma'gong'si	0
新疆若羌县棉麻公司棉花加工厂	xin'jiang'ruo'qiang'xian'mian'ma'gong'si'mian'hua'jia'gong'chang	0
新疆鄯善县供销社棉麻公司	xin'jiang'shan'shan'xian'gong'xiao'she'mian'ma'gong'si	0
新疆石河子市棉麻公司农八师棉麻公司	xin'jiang'shi'he'zi'shi'mian'ma'gong'si'nong'ba'shi'mian'ma'gong'si	0
新绛县棉麻公司南关棉油厂	xin'jiang'xian'mian'ma'gong'si'nan'guan'mian'you'chang	0
新绛县棉麻公司泽掌棉油厂	xin'jiang'xian'mian'ma'gong'si'ze'zhang'mian'you'chang	0
新疆亚麻纺织集团有限公司	xin'jiang'ya'ma'fang'zhi'ji'tuan'you'xian'gong'si	0
新疆尉犁县棉麻公司	xin'jiang'yu'li'xian'mian'ma'gong'si	0
新疆于田县棉麻公司	xin'jiang'yu'tian'xian'mian'ma'gong'si	0
新乡市棉麻公司网套加工厂	xin'xiang'shi'mian'ma'gong'si'wang'tao'jia'gong'chang	0
新亚棉麻制品厂	xin'ya'mian'ma'zhi'pin'chang	0
信阳地区棉麻公司	xin'yang'di'qu'mian'ma'gong'si	0
信阳县棉麻公司明港轧花厂	xin'yang'xian'mian'ma'gong'si'ming'gang'ya'hua'chang	0
新野县棉麻公司	xin'ye'xian'mian'ma'gong'si	0
新余市棉麻公司	xin'yu'shi'mian'ma'gong'si	0
新余市渝水区棉麻公司	xin'yu'shi'yu'shui'qu'mian'ma'gong'si	0
新余市渝水区棉麻烟公司水西轧花厂	xin'yu'shi'yu'shui'qu'mian'ma'yan'gong'si'shui'xi'ya'hua'chang	0
新源县亚麻原料厂	xin'yuan'xian'ya'ma'yuan'liao'chang	0
兴化市棉麻公司	xing'hua'shi'mian'ma'gong'si	0
邢台市棉麻总公司	xing'tai'shi'mian'ma'zong'gong'si	0
行唐县棉麻公司胶背地毯厂	xing'tang'xian'mian'ma'gong'si'jiao'bei'di'tan'chang	0
星子县棉麻公司	xing'zi'xian'mian'ma'gong'si	0
雄县棉麻公司油棉加工厂	xiong'xian'mian'ma'gong'si'you'mian'jia'gong'chang	0
修武县棉麻公司轧花厂	xiu'wu'xian'mian'ma'gong'si'ya'hua'chang	0
岫岩县棉麻果品公司轧花厂	xiu'yan'xian'mian'ma'guo'pin'gong'si'ya'hua'chang	0
延边金龙亚麻纺织股份有限公司	yan'bian'jin'long'ya'ma'fang'zhi'gu'fen'you'xian'gong'si	0
延边亚麻厂	yan'bian'ya'ma'chang	0
郾城县棉麻公司	yan'cheng'xian'mian'ma'gong'si	0
鄢陵县棉麻公司陈化店棉花加工厂	yan'ling'xian'mian'ma'gong'si'chen'hua'dian'mian'hua'jia'gong'chang	0
延寿县亚麻纺沙有限公司	yan'shou'xian'ya'ma'fang'sha'you'xian'gong'si	0
延寿县亚麻纺织厂	yan'shou'xian'ya'ma'fang'zhi'chang	0
延寿县亚麻分公司	yan'shou'xian'ya'ma'fen'gong'si	0
延寿亚麻纺纱有限公司	yan'shou'ya'ma'fang'sha'you'xian'gong'si	0
烟台市牟平区三利亚麻染织厂	yan'tai'shi'mu'ping'qu'san'li'ya'ma'ran'zhi'chang	0
阳信县棉麻公司	yang'xin'xian'mian'ma'gong'si	0
依安县亚麻厂服务队	yi'an'xian'ya'ma'chang'fu'wu'dui	0
依安县亚麻原料厂	yi'an'xian'ya'ma'yuan'liao'chang	0
依兰县三道岗镇棉麻加工厂	yi'lan'xian'san'dao'gang'zhen'mian'ma'jia'gong'chang	0
依兰县亚麻原料厂	yi'lan'xian'ya'ma'yuan'liao'chang	0
伊犁亚麻纺织厂	yi'li'ya'ma'fang'zhi'chang	0
伊犁亚麻纺织工业联合公司伊宁县亚麻原料厂	yi'li'ya'ma'fang'zhi'gong'ye'lian'he'gong'si'yi'ning'xian'ya'ma'yuan'liao'chang	0
伊犁州棉麻公司	yi'li'zhou'mian'ma'gong'si	0
仪陇县棉麻公司	yi'long'xian'mian'ma'gong'si	0
伊宁县亚麻厂	yi'ning'xian'ya'ma'chang	0
沂水县棉麻公司后埠子棉油加工厂	yi'shui'xian'mian'ma'gong'si'hou'bu'zi'mian'you'jia'gong'chang	0
易县棉麻烟公司棉油厂	yi'xian'mian'ma'yan'gong'si'mian'you'chang	0
宜兴市凌津亚麻厂	yi'xing'shi'ling'jin'ya'ma'chang	0
宜兴市棉麻纺织厂	yi'xing'shi'mian'ma'fang'zhi'chang	0
宜兴市棉麻公司	yi'xing'shi'mian'ma'gong'si	0
仪征市棉麻公司	yi'zheng'shi'mian'ma'gong'si	0
鄞县高塘桥棉麻纺织厂	yin'xian'gao'tang'qiao'mian'ma'fang'zhi'chang	0
英吉沙县棉麻公司	ying'ji'sha'xian'mian'ma'gong'si	0
营口市宏达棉麻纺织厂	ying'kou'shi'hong'da'mian'ma'fang'zhi'chang	0
永昌县北海亚麻厂	yong'chang'xian'bei'hai'ya'ma'chang	0
永川市棉麻公司	yong'chuan'shi'mian'ma'gong'si	0
永修县棉麻公司	yong'xiu'xian'mian'ma'gong'si	0
尉犁县棉麻纺织厂	yu'li'xian'mian'ma'fang'zhi'chang	0
沅江市棉麻土产公司	yuan'jiang'shi'mian'ma'tu'chan'gong'si	0
岳普湖县棉麻公司	yue'pu'hu'xian'mian'ma'gong'si	0
乐清市西利棉麻工艺厂	yue'qing'shi'xi'li'mian'ma'gong'yi'chang	0
乐清市亚麻纺织机械有限公司	yue'qing'shi'ya'ma'fang'zhi'ji'xie'you'xian'gong'si	0
岳阳棉麻蚕茧公司	yue'yang'mian'ma'can'jian'gong'si	0
岳阳市君山棉麻纺织厂	yue'yang'shi'jun'shan'mian'ma'fang'zhi'chang	0
岳阳市君山棉麻油脂厂	yue'yang'shi'jun'shan'mian'ma'you'zhi'chang	0
岳阳市棉麻蚕茧总公司	yue'yang'shi'mian'ma'can'jian'zong'gong'si	0
岳阳县供销合作联社棉麻油脂公司	yue'yang'xian'gong'xiao'he'zuo'lian'she'mian'ma'you'zhi'gong'si	0
郓城县棉麻纺织厂	yun'cheng'xian'mian'ma'fang'zhi'chang	0
云南省曲靖地区土产副食日杂棉麻公司	yun'nan'sheng'qu'jing'di'qu'tu'chan'fu'shi'ri'za'mian'ma'gong'si	0
云南省昭通地区棉麻日杂公司	yun'nan'sheng'zhao'tong'di'qu'mian'ma'ri'za'gong'si	0
枣庄市峄城区棉麻公司	zao'zhuang'shi'yi'cheng'qu'mian'ma'gong'si	0
张北县白庙滩乡亚麻纤维厂	zhang'bei'xian'bai'miao'tan'xiang'ya'ma'xian'wei'chang	0
张家港市棉麻总公司	zhang'jia'gang'shi'mian'ma'zong'gong'si	0
张家口市棉麻综合经营总公司	zhang'jia'kou'shi'mian'ma'zong'he'jing'ying'zong'gong'si	0
章丘市棉麻公司	zhang'qiu'shi'mian'ma'gong'si	0
肇东市德昌亚麻原料厂	zhao'dong'shi'de'chang'ya'ma'yuan'liao'chang	0
肇东市四站亚麻制品厂	zhao'dong'shi'si'zhan'ya'ma'zhi'pin'chang	0
肇东市亚麻针刺毡厂	zhao'dong'shi'ya'ma'zhen'ci'zhan'chang	0
肇融亚麻纺织有限公司	zhao'rong'ya'ma'fang'zhi'you'xian'gong'si	0
赵县棉麻公司	zhao'xian'mian'ma'gong'si	0
肇州县亚麻原料厂	zhao'zhou'xian'ya'ma'yuan'liao'chang	0
肇州县肇丰亚麻有限责任公司	zhao'zhou'xian'zhao'feng'ya'ma'you'xian'ze'ren'gong'si	0
柘城县棉麻公司	zhe'cheng'xian'mian'ma'gong'si	0
浙江丽水棉麻纺织厂	zhe'jiang'li'shui'mian'ma'fang'zhi'chang	0
浙江三元亚麻纺织有限公司	zhe'jiang'san'yuan'ya'ma'fang'zhi'you'xian'gong'si	0
浙江省丽水棉麻纺织厂	zhe'jiang'sheng'li'shui'mian'ma'fang'zhi'chang	0
浙江嵊州棉麻纺织印染总厂剑织分厂	zhe'jiang'sheng'zhou'mian'ma'fang'zhi'yin'ran'zong'chang'jian'zhi'fen'chang	0
镇平县棉麻公司	zhen'ping'xian'mian'ma'gong'si	0
中牟县棉麻公司	zhong'mu'xian'mian'ma'gong'si	0
周口地区棉麻集团公司	zhou'kou'di'qu'mian'ma'ji'tuan'gong'si	0
株洲渌口棉麻纺织厂	zhu'zhou'lu'kou'mian'ma'fang'zhi'chang	0
株洲市棉麻土产总公司	zhu'zhou'shi'mian'ma'tu'chan'zong'gong'si	0
株洲县渌口棉麻纺织厂	zhu'zhou'xian'lu'kou'mian'ma'fang'zhi'chang	0
庄浪县亚麻加工厂	zhuang'lang'xian'ya'ma'jia'gong'chang	0
淄博棉麻公司	zi'bo'mian'ma'gong'si	0
淄博雪绒棉麻有限公司	zi'bo'xue'rong'mian'ma'you'xian'gong'si	0
淄博亚麻纺织厂	zi'bo'ya'ma'fang'zhi'chang	0
自贡市自流井区棉麻针织品厂	zi'gong'shi'zi'liu'jing'qu'mian'ma'zhen'zhi'pin'chang	0
自贡市自流井区棉麻针织制品厂	zi'gong'shi'zi'liu'jing'qu'mian'ma'zhen'zhi'zhi'pin'chang	0
梓潼县棉麻总公司	zi'tong'xian'mian'ma'zong'gong'si	0
资阳市供销合作社棉麻土产果品公司	zi'yang'shi'gong'xiao'he'zuo'she'mian'ma'tu'chan'guo'pin'gong'si	0
