爱莲说	ai'lian'shuo	0
爱士卒	ai'shi'zu	0
哀转久绝	ai'zhuan'jiu'jue	0
安陵君不听寡人	an'ling'jun'bu'ting'gua'ren	0
安陵君其许寡人	an'ling'jun'qi'xu'gua'ren	0
安陵君受地于先王而守之	an'ling'jun'shou'di'yu'xian'wang'er'shou'zhi	0
安陵君因使唐雎使于秦	an'ling'jun'yin'shi'tang'ju'shi'yu'qin	0
安陵君曰	an'ling'jun'yue	0
安求其能千里也	an'qiu'qi'neng'qian'li'ye	0
岸芷汀兰	an'zhi'ting'lan	0
安知我不知鱼之乐	an'zhi'wo'bu'zhi'yu'zhi'le	0
安知鱼之乐	an'zhi'yu'zhi'le	0
昂首观之	ang'shou'guan'zhi	0
凹者为壑	ao'zhe'wei'he	0
巴东三峡巫峡长	ba'dong'san'xia'wu'xia'chang	0
把酒临风	ba'jiu'lin'feng	0
八年级上册	ba'nian'ji'shang'ce	0
八年级下册	ba'nian'ji'xia'ce	0
拔山倒树而来	ba'shan'dao'shu'er'lai	0
百二十城	bai'er'shi'cheng	0
百废具兴	bai'fei'ju'xing	0
白虹贯日	bai'hong'guan'ri	0
百里奚举于市	bai'li'xi'ju'yu'shi	0
百千儿哭	bai'qian'er'ku	0
百千齐作	bai'qian'qi'zuo	0
百千犬吠	bai'qian'quan'fei	0
百姓多闻其贤	bai'xing'duo'wen'qi'xian	0
白雪纷纷何所似	bai'xue'fen'fen'he'suo'si	0
保其岩阻	bao'qi'yan'zu	0
北定中原	bei'ding'zhong'yuan	0
北方有侮臣者	bei'fang'you'wu'chen'zhe	0
北山愚公长息曰	bei'shan'yu'gong'chang'xi'yue	0
北山愚公者	bei'shan'yu'gong'zhe	0
北饮大泽	bei'yin'da'ze	0
本在冀州之南	ben'zai'ji'zhou'zhi'nan	0
必将有盗	bi'jiang'you'dao	0
彼竭我盈	bi'jie'wo'ying	0
必能裨补阙漏	bi'neng'bi'bu'que'lou	0
必能使行阵和睦	bi'neng'shi'hang'zhen'he'mu	0
彼其受之天也	bi'qi'shou'zhi'tian'ye	0
必取宋	bi'qu'song	0
碧瓦飞甍	bi'wa'fei'meng	0
必为有窃疾矣	bi'wei'you'qie'ji'yi	0
陛下亦宜自谋	bi'xia'yi'yi'zi'mou	0
必先苦其心志	bi'xian'ku'qi'xin'zhi	0
必以分人	bi'yi'fen'ren	0
必以情	bi'yi'qing	0
必以信	bi'yi'xin	0
必有得天时者矣	bi'you'de'tian'shi'zhe'yi	0
必有我师焉	bi'you'wo'shi'yan	0
闭之	bi'zhi	0
比至陈	bi'zhi'chen	0
便得一山	bian'de'yi'shan	0
便扶向路	bian'fu'xiang'lu	0
便舍船	bian'she'chuan	0
鞭数十	bian'shu'shi	0
便欣然忘食	bian'xin'ran'wang'shi	0
便要还家	bian'yao'huan'jia	0
便有妇人惊觉欠伸	bian'you'fu'ren'jing'jue'qian'shen	0
宾客意少舒	bin'ke'yi'shao'shu	0
兵革非不坚利也	bing'ge'fei'bu'jian'li'ye	0
兵甲已足	bing'jia'yi'zu	0
并杀两尉	bing'sha'liang'wei	0
并怡然自乐	bing'yi'ran'zi'le	0
并有乘骑弄旗标枪舞刀于水面者	bing'you'cheng'qi'nong'qi'biao'qiang'wu'dao'yu'shui'mian'zhe	0
并自为其名	bing'zi'wei'qi'ming	0
波澜不惊	bo'lan'bu'jing	0
薄暮冥冥	bo'mu'ming'ming	0
波色乍明	bo'se'zha'ming	0
不必藏于己	bu'bi'cang'yu'ji	0
不蔽风日	bu'bi'feng'ri	0
不必为己	bu'bi'wei'ji	0
不当立	bu'dang'li	0
不独子其子	bu'du'zi'qi'zi	0
不复出焉	bu'fu'chu'yan	0
不复得路	bu'fu'de'lu	0
不敢出一言以复	bu'gan'chu'yi'yan'yi'fu	0
不敢稍逾约	bu'gan'shao'yu'yue	0
不汲汲于富贵	bu'ji'ji'yu'fu'gui	0
不见曦月	bu'jian'xi'yue	0
不觉呀然一惊	bu'jue'ya'ran'yi'jing	0
不可	bu'ke	0
不可不学	bu'ke'bu'xue	0
不可计其层次矣	bu'ke'ji'qi'ceng'ci'yi	0
不可久居	bu'ke'jiu'ju	0
不可屈致也	bu'ke'qu'zhi'ye	0
不可谓强	bu'ke'wei'qiang	0
不可谓仁	bu'ke'wei'ren	0
不可谓智	bu'ke'wei'zhi	0
不可谓知类	bu'ke'wei'zhi'lei	0
不可谓忠	bu'ke'wei'zhong	0
不可知其源	bu'ke'zhi'qi'yuan	0
不蔓不枝	bu'man'bu'zhi	0
不慕荣利	bu'mu'rong'li	0
不能称前时之闻	bu'neng'cheng'qian'shi'zhi'wen	0
不能绝也	bu'neng'jue'ye	0
不能名其一处也	bu'neng'ming'qi'yi'chu'ye	0
不能指其一端	bu'neng'zhi'qi'yi'duan	0
不戚戚于贫贱	bu'qi'qi'yu'pin'jian	0
不求甚解	bu'qiu'shen'jie	0
不求闻达于诸侯	bu'qiu'wen'da'yu'zhu'hou	0
不使学	bu'shi'xue	0
不受之人	bu'shou'zhi'ren	0
不效	bu'xiao	0
不以己悲	bu'yi'ji'bei	0
不以疾也	bu'yi'ji'ye	0
不亦君子乎	bu'yi'jun'zi'hu	0
不亦乐乎	bu'yi'le'hu	0
不宜偏私	bu'yi'pian'si	0
不以千里称也	bu'yi'qian'li'cheng'ye	0
不宜妄自菲薄	bu'yi'wang'zi'fei'bo	0
不以物喜	bu'yi'wu'xi	0
不宜异同	bu'yi'yi'tong	0
不亦远乎	bu'yi'yuan'hu	0
不亦说乎	bu'yi'yue'hu	0
布衣之怒	bu'yi'zhi'nu	0
不亦重乎	bu'yi'zhong'hu	0
不一状	bu'yi'zhuang	0
卜者知其指意	bu'zhe'zhi'qi'zhi'yi	0
不知口体之奉不若人也	bu'zhi'kou'ti'zhi'feng'bu'ruo'ren'ye	0
不知所言	bu'zhi'suo'yan	0
不知为不知	bu'zhi'wei'bu'zhi	0
不筑	bu'zhu	0
不足为外人道也	bu'zu'wei'wai'ren'dao'ye	0
才美不外见	cai'mei'bu'wai'jian	0
裁如星点	cai'ru'xing'dian	0
才通人	cai'tong'ren	0
苍颜白发	cang'yan'bai'fa	0
仓鹰击于殿上	cang'ying'ji'yu'dian'shang	0
曹操比于袁绍	cao'cao'bi'yu'yuan'shao	0
曹刿论战	cao'gui'lun'zhan	0
曹刿请见	cao'gui'qing'jian	0
草色入帘青	cao'se'ru'lian'qing	0
操蛇之神闻之	cao'she'zhi'shen'wen'zhi	0
侧目微笑默叹	ce'mu'wei'xiao'mo'tan	0
策之不以其道	ce'zhi'bu'yi'qi'dao	0
参差披拂	cen'ci'pi'fu	0
曾不吝情去留	ceng'bu'lin'qing'qu'liu	0
曾不能毁山之一毛	ceng'bu'neng'hui'shan'zhi'yi'mao	0
曾不能损魁父之丘	ceng'bu'neng'sun'kui'fu'zhi'qiu	0
曾不若孀妻弱子	ceng'bu'ruo'shuang'qi'ruo'zi	0
层层指数	ceng'ceng'zhi'shu	0
曾益其所不能	ceng'yi'qi'suo'bu'neng	0
察纳雅言	cha'na'ya'yan	0
蝉则千转不穷	chan'ze'qian'zhuan'bu'qiong	0
长跪而谢之曰	chang'gui'er'xie'zhi'yue	0
怅恨久之	chang'hen'jiu'zhi	0
尝趋百里外	chang'qu'bai'li'wai	0
尝贻余核舟一	chang'yi'yu'he'zhou'yi	0
常有高猿长啸	chang'you'gao'yuan'chang'xiao	0
尝与人佣耕	chang'yu'ren'yong'geng	0
场主积薪其中	chang'zhu'ji'xin'qi'zhong	0
常著文章自娱	chang'zhu'wen'zhang'zi'yu	0
朝而往	chao'er'wang	0
朝服衣冠	chao'fu'yi'guan	0
朝廷之臣莫不畏王	chao'ting'zhi'chen'mo'bu'wei'wang	0
车六七百乘	che'liu'qi'bai'sheng	0
车马塞途	che'ma'sai'tu	0
撤屏视之	che'ping'shi'zhi	0
臣本布衣	chen'ben'bu'yi	0
臣不胜受恩感激	chen'bu'sheng'shou'en'gan'ji	0
臣诚知不如徐公美	chen'cheng'zhi'bu'ru'xu'gong'mei	0
沉鳞竞跃	chen'lin'jing'yue	0
尘气莽莽然	chen'qi'mang'mang'ran	0
陈涉乃立为王	chen'she'nai'li'wei'wang	0
陈涉少时	chen'she'shao'shi	0
陈涉世家	chen'she'shi'jia	0
陈涉太息曰	chen'she'tai'xi'yue	0
陈胜王	chen'sheng'wang	0
陈胜吴广皆次当行	chen'sheng'wu'guang'jie'ci'dang'hang	0
陈胜吴广乃谋曰	chen'sheng'wu'guang'nai'mou'yue	0
陈胜吴广喜	chen'sheng'wu'guang'xi	0
陈胜曰	chen'sheng'yue	0
陈胜者	chen'sheng'zhe	0
陈胜自立为将军	chen'sheng'zi'li'wei'jiang'jun	0
陈胜佐之	chen'sheng'zuo'zhi	0
陈寿	chen'shou	0
陈守令皆不在	chen'shou'ling'jie'bu'zai	0
陈太丘与友期	chen'tai'qiu'yu'you'qi	0
陈太丘与友期行	chen'tai'qiu'yu'you'qi'xing	0
臣未尝闻也	chen'wei'chang'wen'ye	0
臣以王吏之攻宋也	chen'yi'wang'li'zhi'gong'song'ye	0
臣之客欲有求于臣	chen'zhi'ke'yu'you'qiu'yu'chen	0
臣之妻私臣	chen'zhi'qi'si'chen	0
臣之妾畏臣	chen'zhi'qie'wei'chen	0
城北徐公	cheng'bei'xu'gong	0
称大楚	cheng'da'chu	0
城非不高也	cheng'fei'bu'gao'ye	0
诚如是	cheng'ru'shi	0
惩山北之塞	cheng'shan'bei'zhi'sai	0
城市依稀而已	cheng'shi'yi'xi'er'yi	0
诚宜开张圣听	cheng'yi'kai'zhang'sheng'ting	0
弛担持刀	chi'dan'chi'dao	0
池非不深也	chi'fei'bu'shen'ye	0
宠辱偕忘	chong'ru'xie'wang	0
重岩叠嶂	chong'yan'die'zhang	0
崇祯五年十二月	chong'zhen'wu'nian'shi'er'yue	0
鯈鱼出游从容	chou'yu'chu'you'cong'rong	0
处处志之	chu'chu'zhi'zhi	0
俶尔远逝	chu'er'yuan'shi	0
初极狭	chu'ji'xia	0
处江湖之远	chu'jiang'hu'zhi'yuan	0
出没于鲸波万仞中	chu'mo'yu'jing'bo'wan'ren'zhong	0
初平山人	chu'ping'shan'ren	0
楚人怜之	chu'ren'lian'zhi	0
滁人游也	chu'ren'you'ye	0
出入之迂也	chu'ru'zhi'yu'ye	0
出师表	chu'shi'biao	0
楚王问其故	chu'wang'wen'qi'gu	0
楚王曰	chu'wang'yue	0
出则无敌国外患者	chu'ze'wu'di'guo'wai'huan'zhe	0
传不习乎	chuan'bu'xi'hu	0
船头坐三人	chuan'tou'zuo'san'ren	0
传一乡秀才观之	chuan'yi'xiang'xiu'cai'guan'zhi	0
窗扉皆洞开	chuang'fei'jie'dong'kai	0
春冬之时	chun'dong'zhi'shi	0
辍耕之垄上	chuo'geng'zhi'long'shang	0
此诚不可与争锋	ci'cheng'bu'ke'yu'zheng'feng	0
此诚危急存亡之秋也	ci'cheng'wei'ji'cun'wang'zhi'qiu'ye	0
此殆天所以资将军	ci'dai'tian'suo'yi'zi'jiang'jun	0
此独以跛之故	ci'du'yi'bo'zhi'gu	0
此何遽不能为祸乎	ci'he'ju'bu'neng'wei'huo'hu	0
此何遽不为福乎	ci'he'ju'bu'wei'fu'hu	0
此后汉所以倾颓也	ci'hou'han'suo'yi'qing'tui'ye	0
此教我先威众耳	ci'jiao'wo'xian'wei'zhong'er	0
此皆良实	ci'jie'liang'shi	0
此可以为援而不可图也	ci'ke'yi'wei'yuan'er'bu'ke'tu'ye	0
此乐何极	ci'le'he'ji	0
辞去	ci'qu	0
此人可就见	ci'ren'ke'jiu'jian	0
此人一一为具言所闻	ci'ren'yi'yi'wei'ju'yan'suo'wen	0
此三子者	ci'san'zi'zhe	0
此所谓战胜于朝廷	ci'suo'wei'zhan'sheng'yu'chao'ting	0
此为何若人	ci'wei'he'ruo'ren	0
此悉贞良死节之臣	ci'xi'zhen'liang'si'jie'zhi'chen	0
此先汉所以兴隆也	ci'xian'han'suo'yi'xing'long'ye	0
此庸夫之怒也	ci'yong'fu'zhi'nu'ye	0
此用武之国	ci'yong'wu'zhi'guo	0
此犹锦绣之与短褐也	ci'you'jin'xiu'zhi'yu'duan'he'ye	0
此犹粱肉之与糠糟也	ci'you'liang'rou'zhi'yu'kang'zao'ye	0
此犹文轩之与敝舆也	ci'you'wen'xuan'zhi'yu'bi'yu'ye	0
此则岳阳楼之大观也	ci'ze'yue'yang'lou'zhi'da'guan'ye	0
此之谓失其本心	ci'zhi'wei'shi'qi'ben'xin	0
此中人语云	ci'zhong'ren'yu'yun	0
从口入	cong'kou'ru	0
从流飘荡	cong'liu'piao'dang	0
从民欲也	cong'min'yu'ye	0
从先人还家	cong'xian'ren'huan'jia	0
从乡之先达执经叩问	cong'xiang'zhi'xian'da'zhi'jing'kou'wen	0
从小丘西行百二十步	cong'xiao'qiu'xi'xing'bai'er'shi'bu	0
蹴尔而与之	cu'er'er'yu'zhi	0
卒中往往语	cu'zhong'wang'wang'yu	0
崔氏二小生	cui'shi'er'xiao'sheng	0
村中闻有此人	cun'zhong'wen'you'ci'ren	0
大楚兴	da'chu'xing	0
大道之行也	da'dao'zhi'xing'ye	0
大儿初醒声	da'er'chu'xing'sheng	0
大惊曰	da'jing'yue	0
大声如雷霆	da'sheng'ru'lei'ting	0
大啼	da'ti	0
大王尝闻布衣之怒乎	da'wang'chang'wen'bu'yi'zhi'nu'hu	0
大王加惠	da'wang'jia'hui	0
大喜曰	da'xi'yue	0
答谢中书书	da'xie'zhong'shu'shu	0
大兄何见事之晚乎	da'xiong'he'jian'shi'zhi'wan'hu	0
大雪三日	da'xue'san'ri	0
大雪深数尺	da'xue'shen'shu'chi	0
达于汉阴	da'yu'han'yin	0
答曰	da'yue	0
待君久不至	dai'jun'jiu'bu'zhi	0
戴朱缨宝饰之帽	dai'zhu'ying'bao'shi'zhi'mao	0
眈眈相向	dan'dan'xiang'xiang	0
但当涉猎	dan'dang'she'lie	0
箪瓢屡空	dan'piao'lv'kong	0
旦日	dan'ri	0
但少闲人如吾两人者耳	dan'shao'xian'ren'ru'wu'liang'ren'zhe'er	0
但闻屏障中抚尺一下	dan'wen'ping'zhang'zhong'fu'chi'yi'xia	0
担中肉尽	dan'zhong'rou'jin	0
当此时	dang'ci'shi	0
当奖率三军	dang'jiang'lv'san'jun	0
当立者乃公子扶苏	dang'li'zhe'nai'gong'zi'fu'su	0
当是时	dang'shi'shi	0
当余之从师也	dang'yu'zhi'cong'shi'ye	0
道不通	dao'bu'tong	0
道渴而死	dao'ke'er'si	0
盗窃乱贼而不作	dao'qie'luan'zei'er'bu'zuo	0
到亭上	dao'ting'shang	0
得道多助	de'dao'duo'zhu	0
得道者多助	de'dao'zhe'duo'zhu	0
得其船	de'qi'chuan	0
得为众人而已耶	de'wei'zhong'ren'er'yi'ye	0
得无异乎	de'wu'yi'hu	0
得鱼腹中书	de'yu'fu'zhong'shu	0
得之心而寓之酒也	de'zhi'xin'er'yu'zhi'jiu'ye	0
得之则生	de'zhi'ze'sheng	0
登轼而望之	deng'shi'er'wang'zhi	0
等死	deng'si	0
登斯楼也	deng'si'lou'ye	0
地不满东南	di'bu'man'dong'nan	0
帝感其诚	di'gan'qi'cheng	0
地利不如人和	di'li'bu'ru'ren'he	0
地维绝	di'wei'jue	0
雕栏相望焉	diao'lan'xiang'wang'yan	0
定神细视	ding'shen'xi'shi	0
丁壮者引弦而战	ding'zhuang'zhe'yin'xian'er'zhan	0
冻风时作	dong'feng'shi'zuo	0
东连吴会	dong'lian'wu'hui	0
东坡现右足	dong'po'xian'you'zu	0
东坡右手执卷端	dong'po'you'shou'zhi'juan'duan	0
斗折蛇行	dou'zhe'she'xing	0
独守丞与战谯门中	du'shou'cheng'yu'zhan'qiao'men'zhong	0
独往湖心亭看雪	du'wang'hu'xin'ting'kan'xue	0
度已失期	du'yi'shi'qi	0
短褐穿结	duan'he'chuan'jie	0
短文两篇	duan'wen'liang'pian	0
对联题名并篆文	dui'lian'ti'ming'bing'zhuan'wen	0
对曰	dui'yue	0
对子骂父	dui'zi'ma'fu	0
蹲其身	dun'qi'shen	0
夺而杀尉	duo'er'sha'wei	0
堕而折其髀	duo'er'zhe'qi'bi	0
多会于此	duo'hui'yu'ci	0
多助之至	duo'zhu'zhi'zhi	0
俄而百千人大呼	e'er'bai'qian'ren'da'hu	0
俄而雪骤	e'er'xue'zhou	0
恶能无纪	e'neng'wu'ji	0
饿其体肤	e'qi'ti'fu	0
而安陵以五十里之地存者	er'an'ling'yi'wu'shi'li'zhi'di'cun'zhe	0
而伯乐不常有	er'bo'le'bu'chang'you	0
而不知人之乐	er'bu'zhi'ren'zhi'le	0
而不知太守之乐其乐也	er'bu'zhi'tai'shou'zhi'le'qi'le'ye	0
而城居者未之知也	er'cheng'ju'zhe'wei'zhi'zhi'ye	0
而此地适与余近	er'ci'di'shi'yu'yu'jin	0
而飞于北海	er'fei'yu'bei'hai	0
而复问其妾曰	er'fu'wen'qi'qie'yue	0
儿含乳啼	er'han'ru'ti	0
儿含乳啼声	er'han'ru'ti'sheng	0
而或长烟一空	er'huo'chang'yan'yi'kong	0
而计其长曾不盈寸	er'ji'qi'chang'ceng'bu'ying'cun	0
而僦赁看幕	er'jiu'lin'kan'mu	0
而君逆寡人者	er'jun'ni'gua'ren'zhe	0
而君以五十里之地存者	er'jun'yi'wu'shi'li'zhi'di'cun'zhe	0
尔来二十有一年矣	er'lai'er'shi'you'yi'nian'yi	0
而乐亦无穷也	er'le'yi'wu'qiong'ye	0
而两狼之并驱如故	er'liang'lang'zhi'bing'qu'ru'gu	0
而楼上人往来屑屑	er'lou'shang'ren'wang'lai'xie'xie	0
而年又最高	er'nian'you'zui'gao	0
而旗尾略不沾湿	er'qi'wei'lve'bu'zhan'shi	0
而其主不能守	er'qi'zhu'bu'neng'shou	0
而顷刻两毙	er'qing'ke'liang'bi	0
而山不加增	er'shan'bu'jia'zeng	0
二世杀之	er'shi'sha'zhi	0
二世元年七月	er'shi'yuan'nian'qi'yue	0
而竖其左膝	er'shu'qi'zuo'xi	0
而戍死者固十六七	er'shu'si'zhe'gu'shi'liu'qi	0
而形貌昳丽	er'xing'mao'yi'li	0
而疑邻人之父	er'yi'lin'ren'zhi'fu	0
而曰	er'yue	0
二者不可得兼	er'zhe'bu'ke'de'jian	0
而智术浅短	er'zhi'shu'qian'duan	0
法皆斩	fa'jie'zhan	0
发闾左適戍渔阳	fa'lv'zuo'shi'shu'yu'yang	0
伐无道	fa'wu'dao	0
伐竹取道	fa'zhu'qu'dao	0
凡曝沙之鸟	fan'bao'sha'zhi'niao	0
凡三往	fan'san'wang	0
凡所应有	fan'suo'ying'you	0
范仲淹	fan'zhong'yan	0
芳草鲜美	fang'cao'xian'mei	0
方出神	fang'chu'shen	0
仿佛若有光	fang'fu'ruo'you'guang	0
方七百里	fang'qi'bai'li	0
方其远出海门	fang'qi'yuan'chu'hai'men	0
坊若者	fang'ruo'zhe	0
方欲行	fang'yu'xing	0
非独贤者有是心也	fei'du'xian'zhe'you'shi'xin'ye	0
非复吴下阿蒙	fei'fu'wu'xia'a'meng	0
非醴泉不饮	fei'li'quan'bu'yin	0
非练实不食	fei'lian'shi'bu'shi	0
飞乃止	fei'nai'zhi	0
非人哉	fei'ren'zai	0
非若是也	fei'ruo'shi'ye	0
非士之怒也	fei'shi'zhi'nu'ye	0
飞漱其间	fei'shu'qi'jian	0
非丝非竹	fei'si'fei'zhu	0
非惟天时	fei'wei'tian'shi	0
非梧桐不止	fei'wu'tong'bu'zhi	0
忿恚尉	fen'hui'wei	0
分列两岸	fen'lie'liang'an	0
奋袖出臂	fen'xiu'chu'bi	0
峰回路转	feng'hui'lu'zhuan	0
风力虽尚劲	feng'li'sui'shang'jin	0
奉命于危难之间	feng'ming'yu'wei'nan'zhi'jian	0
风霜高洁	feng'shuang'gao'jie	0
风烟俱净	feng'yan'ju'jing	0
佛印居右	fo'yin'ju'you	0
佛印绝类弥勒	fo'yin'jue'lei'mi'le	0
夫不能以游堕事	fu'bu'neng'yi'you'duo'shi	0
夫叱大儿声	fu'chi'da'er'sheng	0
夫大国	fu'da'guo	0
复到舅家问焉	fu'dao'jiu'jia'wen'yan	0
弗得则死	fu'de'ze'si	0
妇抚儿乳	fu'fu'er'ru	0
弗敢加也	fu'gan'jia'ye	0
弗敢易	fu'gan'yi	0
弗敢专也	fu'gan'zhuan'ye	0
浮光跃金	fu'guang'yue'jin	0
夫韩	fu'han	0
夫齁声起	fu'hou'sheng'qi	0
夫环而攻之	fu'huan'er'gong'zhi	0
复立楚国之社稷	fu'li'chu'guo'zhi'she'ji	0
父利其然也	fu'li'qi'ran'ye	0
妇梦中咳嗽	fu'meng'zhong'ke'sou	0
妇拍而呜之	fu'pai'er'wu'zhi	0
妇拍儿亦渐拍渐止	fu'pai'er'yi'jian'pai'jian'zhi	0
夫起大呼	fu'qi'da'hu	0
复前行	fu'qian'xing	0
负箧曳屣行深山巨谷中	fu'qie'ye'xi'xing'shen'shan'ju'gu'zhong	0
俯身倾耳以请	fu'shen'qing'er'yi'qing	0
弗胜	fu'sheng	0
伏尸百万	fu'shi'bai'wan	0
伏尸二人	fu'shi'er'ren	0
负势竞上	fu'shi'jing'shang	0
妇手拍儿声	fu'shou'pai'er'sheng	0
傅说举于版筑之间	fu'shuo'ju'yu'ban'zhu'zhi'jian	0
扶苏以数谏故	fu'su'yi'shu'jian'gu	0
复投之	fu'tou'zhi	0
复行数十步	fu'xing'shu'shi'bu	0
妇亦起大呼	fu'yi'qi'da'hu	0
夫亦醒	fu'yi'xing	0
父异焉	fu'yi'yan	0
夫鹓鶵发于南海	fu'yuan'chu'fa'yu'nan'hai	0
夫战	fu'zhan	0
弗之怠	fu'zhi'dai	0
夫专诸之刺王僚也	fu'zhuan'zhu'zhi'ci'wang'liao'ye	0
夫子何命焉为	fu'zi'he'ming'yan'wei	0
父子相保	fu'zi'xiang'bao	0
盖大苏泛赤壁云	gai'da'su'fan'chi'bi'yun	0
盖简桃核修狭者为之	gai'jian'tao'he'xiu'xia'zhe'wei'zhi	0
盖一癞虾蟆	gai'yi'lai'ha'ma	0
盖以诱敌	gai'yi'you'di	0
盖余之勤且艰若此	gai'yu'zhi'qin'qie'jian'ruo'ci	0
盖竹柏影也	gai'zhu'bai'ying'ye	0
盖追先帝之殊遇	gai'zhui'xian'di'zhi'shu'yu	0
感极而悲者矣	gan'ji'er'bei'zhe'yi	0
高插青冥	gao'cha'qing'ming	0
高峰入云	gao'feng'ru'yun	0
高可二黍许	gao'ke'er'shu'xu	0
高柳夹堤	gao'liu'jia'di	0
高尚士也	gao'shang'shi'ye	0
高万仞	gao'wan'ren	0
高垣睥睨	gao'yuan'pi'ni	0
告之于帝	gao'zhi'yu'di	0
高祖因之以成帝业	gao'zu'yin'zhi'yi'cheng'di'ye	0
隔篁竹	ge'huang'zhu	0
各具情态	ge'ju'qing'tai	0
葛天氏之民欤	ge'tian'shi'zhi'min'yu	0
各微侧	ge'wei'ce	0
各隐卷底衣褶中	ge'yin'juan'di'yi'zhe'zhong	0
更有痴似相公者	geng'you'chi'si'xiang'gong'zhe	0
共八扇	gong'ba'shan	0
攻陈	gong'chen	0
觥筹交错	gong'chou'jiao'cuo	0
公大笑乐	gong'da'xiao'le	0
攻大泽乡	gong'da'ze'xiang	0
公等遇雨	gong'deng'yu'yu	0
宫妇左右莫不私王	gong'fu'zuo'you'mo'bu'si'wang	0
躬耕于南阳	gong'geng'yu'nan'yang	0
共工怒触不周山	gong'gong'nu'chu'bu'zhou'shan	0
共工与颛顼争为帝	gong'gong'yu'zhuan'xu'zheng'wei'di	0
龚古	gong'gu	0
公将驰之	gong'jiang'chi'zhi	0
公将鼓之	gong'jiang'gu'zhi	0
公将战	gong'jiang'zhan	0
攻亲戚之所畔	gong'qin'qi'zhi'suo'pan	0
公输	gong'shu	0
公输盘不说	gong'shu'pan'bu'shuo	0
公输盘服	gong'shu'pan'fu	0
公输盘九设攻城之机变	gong'shu'pan'jiu'she'gong'cheng'zhi'ji'bian	0
公输盘诎	gong'shu'pan'qu	0
公输盘为楚造云梯之械	gong'shu'pan'wei'chu'zao'yun'ti'zhi'xie	0
公输盘为我为云梯	gong'shu'pan'wei'wo'wei'yun'ti	0
公输盘曰	gong'shu'pan'yue	0
公输盘之攻械尽	gong'shu'pan'zhi'gong'xie'jin	0
公输子之意不过欲杀臣	gong'shu'zi'zhi'yi'bu'guo'yu'sha'chen	0
公问其故	gong'wen'qi'gu	0
公欣然曰	gong'xin'ran'yue	0
公亦尝闻天子之怒乎	gong'yi'chang'wen'tian'zi'zhi'nu'hu	0
功宜为王	gong'yi'wei'wang	0
公与之乘	gong'yu'zhi'cheng	0
公曰	gong'yue	0
攻铚酂苦柘谯	gong'zhi'cuo'ku'zhe'qiao	0
宫中府中	gong'zhong'fu'zhong	0
苟富贵	gou'fu'gui	0
钩画了了	gou'hua'le'le	0
苟全性命于乱世	gou'quan'xing'ming'yu'luan'shi	0
故不错意也	gu'bu'cuo'yi'ye	0
孤不度德量力	gu'bu'duo'de'liang'li	0
固不可彻	gu'bu'ke'che	0
故不为苟得也	gu'bu'wei'gou'de'ye	0
固不知子矣	gu'bu'zhi'zi'yi	0
孤常读书	gu'chang'du'shu	0
固国不以山溪之险	gu'guo'bu'yi'shan'xi'zhi'xian	0
故患有所不辟也	gu'huan'you'suo'bu'pi'ye	0
故君子有不战	gu'jun'zi'you'bu'zhan	0
故克之	gu'ke'zhi	0
古来共谈	gu'lai'gong'tan	0
故临崩寄臣以大事也	gu'lin'beng'ji'chen'yi'da'shi'ye	0
孤岂欲卿治经为博士邪	gu'qi'yu'qing'zhi'jing'wei'bo'shi'xie	0
故人不独亲其亲	gu'ren'bu'du'qin'qi'qin	0
故日月星辰移焉	gu'ri'yue'xing'chen'yi'yan	0
故事两则	gu'shi'liang'ze	0
故时有物外之趣	gu'shi'you'wu'wai'zhi'qu	0
故水潦尘埃归焉	gu'shui'liao'chen'ai'gui'yan	0
故虽有名马	gu'sui'you'ming'ma	0
故天将降大任于是人也	gu'tian'jiang'jiang'da'ren'yu'shi'ren'ye	0
故外户而不闭	gu'wai'hu'er'bu'bi	0
故五月渡泸	gu'wu'yue'du'lu	0
顾野有麦场	gu'ye'you'mai'chang	0
固以怪之矣	gu'yi'guai'zhi'yi	0
骨已尽矣	gu'yi'jin'yi	0
故又名鬼市云	gu'you'ming'gui'shi'yun	0
故余虽愚	gu'yu'sui'yu	0
故渔者歌曰	gu'yu'zhe'ge'yue	0
故曰	gu'yue	0
孤之有孔明	gu'zhi'you'kong'ming	0
固众人	gu'zhong'ren	0
故逐之	gu'zhu'zhi	0
故自号曰醉翁也	gu'zi'hao'yue'zui'weng'ye	0
寡人以五百里之地易安陵	gua'ren'yi'wu'bai'li'zhi'di'yi'an'ling	0
寡人谕矣	gua'ren'yu'yi	0
寡人欲以五百里之地易安陵	gua'ren'yu'yi'wu'bai'li'zhi'di'yi'an'ling	0
寡助之至	gua'zhu'zhi'zhi	0
观潮	guan'chao	0
矜寡孤独	guan'gua'gu'du	0
矜寡孤独废疾者皆有所养	guan'gua'gu'du'fei'ji'zhe'jie'you'suo'yang	0
管夷吾举于士	guan'yi'wu'ju'yu'shi	0
关羽张飞等不悦	guan'yu'zhang'fei'deng'bu'yue	0
观之	guan'zhi	0
广故数言欲亡	guang'gu'shu'yan'yu'wang	0
广起	guang'qi	0
刿曰	gui'yue	0
国恒亡	guo'heng'wang	0
果然鹤也	guo'ran'he'ye	0
果如鹤唳云端	guo'ru'he'li'yun'duan	0
国险而民附	guo'xian'er'min'fu	0
过中不至	guo'zhong'bu'zhi	0
海涌银为郭	hai'yong'yin'wei'guo	0
还自扬州	hai'zi'yang'zhou	0
汉室可兴矣	han'shi'ke'xing'yi	0
汉室倾颓	han'shi'qing'tui	0
寒暑易节	han'shu'yi'jie	0
韩愈	han'yu	0
汉之阴	han'zhi'yin	0
好读书	hao'du'shu	0
浩浩汤汤	hao'hao'shang'shang	0
豪杰并起	hao'jie'bing'qi	0
号令召三老豪杰与皆来会计事	hao'ling'zhao'san'lao'hao'jie'yu'jie'lai'kuai'ji'shi	0
好鸟相鸣	hao'niao'xiang'ming	0
好为梁父吟	hao'wei'liang'fu'yin	0
号为张楚	hao'wei'zhang'chu	0
皓月千里	hao'yue'qian'li	0
何处无竹柏	he'chu'wu'zhu'bai	0
何富贵也	he'fu'gui'ye	0
何苦而不平	he'ku'er'bu'ping	0
何陋之有	he'lou'zhi'you	0
河曲智叟亡以应	he'qu'zhi'sou'wang'yi'ying	0
河曲智叟笑而止之曰	he'qu'zhi'sou'xiao'er'zhi'zhi'yue	0
河渭不足	he'wei'bu'zu	0
河阳之北	he'yang'zhi'bei	0
何也	he'ye	0
何夜无月	he'ye'wu'yue	0
何以战	he'yi'zhan	0
何哉	he'zai	0
何至于此	he'zhi'yu'ci	0
核舟记	he'zhou'ji	0
横柯上蔽	heng'ke'shang'bi	0
横无际涯	heng'wu'ji'ya	0
红装而蹇者	hong'zhuang'er'jian'zhe	0
后狼止而前狼又至	hou'lang'zhi'er'qian'lang'you'zhi	0
后遂无问津者	hou'sui'wu'wen'jin'zhe	0
后天下之乐而乐	hou'tian'xia'zhi'le'er'le	0
后者应	hou'zhe'ying	0
后值倾覆	hou'zhi'qing'fu	0
胡不见我于王	hu'bu'jian'wo'yu'wang	0
忽大风起	hu'da'feng'qi	0
呼尔而与之	hu'er'er'yu'zhi	0
忽逢桃花林	hu'feng'tao'hua'lin	0
呼呼风声	hu'hu'feng'sheng	0
忽见山头有孤塔耸起	hu'jian'shan'tou'you'gu'ta'song'qi	0
狐鸣呼曰	hu'ming'hu'yue	0
忽然抚尺一下	hu'ran'fu'chi'yi'xia	0
胡人大入塞	hu'ren'da'ru'sai	0
湖上影子	hu'shang'ying'zi	0
忽啼求之	hu'ti'qiu'zhi	0
互相轩邈	hu'xiang'xuan'miao	0
虎啸猿啼	hu'xiao'yuan'ti	0
湖心亭看雪	hu'xin'ting'kan'xue	0
湖心亭一点	hu'xin'ting'yi'dian	0
忽一人大呼	hu'yi'ren'da'hu	0
忽有庞然大物	hu'you'pang'ran'da'wu	0
湖中人鸟声俱绝	hu'zhong'ren'niao'sheng'ju'jue	0
湖中焉得更有此人	hu'zhong'yan'de'geng'you'ci'ren	0
花台小草丛杂处	hua'tai'xiao'cao'cong'za'chu	0
化为邓林	hua'wei'deng'lin	0
花朝节后	hua'zhao'jie'hou	0
花之富贵者也	hua'zhi'fu'gui'zhe'ye	0
花之君子者也	hua'zhi'jun'zi'zhe'ye	0
花之隐逸者也	hua'zhi'yin'yi'zhe'ye	0
怀民亦未寝	huai'min'yi'wei'qin	0
淮南子	huai'nan'zi	0
怀怒未发	huai'nu'wei'fa	0
环滁皆山也	huan'chu'jie'shan'ye	0
环堵萧然	huan'du'xiao'ran	0
环而攻之而不胜	huan'er'gong'zhi'er'bu'sheng	0
奂山山市	huan'shan'shan'shi	0
还于旧都	huan'yu'jiu'du	0
黄发垂髫	huang'fa'chui'tiao	0
会宾客大宴	hui'bin'ke'da'yan	0
恢弘志士之气	hui'hong'zhi'shi'zhi'qi	0
晦明变化者	hui'ming'bian'hua'zhe	0
诲女知之乎	hui'nv'zhi'zhi'hu	0
回清倒影	hui'qing'dao'ying	0
会天大雨	hui'tian'da'yu	0
彗星袭月	hui'xing'xi'yue	0
惠子相梁	hui'zi'xiang'liang	0
惠子曰	hui'zi'yue	0
火爆声	huo'bao'sheng	0
货恶其弃于地也	huo'e'qi'qi'yu'di'ye	0
或凭或立	huo'ping'huo'li	0
火起	huo'qi	0
豁然开朗	huo'ran'kai'lang	0
或王命急宣	huo'wang'ming'ji'xuan	0
或谓惠子曰	huo'wei'hui'zi'yue	0
或异二者之为	huo'yi'er'zhe'zhi'wei	0
或以钱币乞之	huo'yi'qian'bi'qi'zhi	0
或以为死	huo'yi'wei'si	0
或以为亡	huo'yi'wei'wang	0
或遇其叱咄	huo'yu'qi'chi'duo	0
或置酒而招之	huo'zhi'jiu'er'zhao'zhi	0
箕畚运于渤海之尾	ji'ben'yun'yu'bo'hai'zhi'wei	0
忌不自信	ji'bu'zi'xin	0
记承天寺夜游	ji'cheng'tian'si'ye'you	0
既出	ji'chu	0
藉第令毋斩	ji'di'ling'wu'zhan	0
既而儿醒	ji'er'er'xing	0
既而风定天清	ji'er'feng'ding'tian'qing	0
既而渐近	ji'er'jian'jin	0
既而尽奔腾分合五阵之势	ji'er'jin'ben'teng'fen'he'wu'zhen'zhi'shi	0
即更刮目相待	ji'geng'gua'mu'xiang'dai	0
即公大兄无奕女	ji'gong'da'xiong'wu'yi'nv	0
己亥之二月也	ji'hai'zhi'er'yue'ye	0
既加冠	ji'jia'guan	0
及郡下	ji'jun'xia	0
既克	ji'ke	0
寂寥无人	ji'liao'wu'ren	0
及鲁肃过寻阳	ji'lu'su'guo'xun'yang	0
期年之后	ji'nian'zhi'hou	0
鸡犬相闻	ji'quan'xiang'wen	0
计日以还	ji'ri'yi'huan	0
即书诗四句	ji'shu'shi'si'ju	0
己所不欲	ji'suo'bu'yu	0
急湍甚箭	ji'tuan'shen'jian	0
及下船	ji'xia'chuan	0
技亦灵怪矣哉	ji'yi'ling'guai'yi'zai	0
祭以尉首	ji'yi'wei'shou	0
既已知吾知之而问我	ji'yi'zhi'wu'zhi'zhi'er'wen'wo	0
几欲先走	ji'yu'xian'zou	0
冀之南	ji'zhi'nan	0
既醉而退	ji'zui'er'tui	0
楫左右舟子各一人	ji'zuo'you'zhou'zi'ge'yi'ren	0
夹岸高山	jia'an'gao'shan	0
夹岸数百步	jia'an'shu'bai'bu	0
家富良马	jia'fu'liang'ma	0
佳木秀而繁阴	jia'mu'xiu'er'fan'yin	0
家贫	jia'pin	0
家贫不能常得	jia'pin'bu'neng'chang'de	0
见不贤而内自省也	jian'bu'xian'er'nei'zi'xing'ye	0
奸臣窃命	jian'chen'qie'ming	0
见二虫斗草间	jian'er'chong'dou'cao'jian	0
见宫殿数十所	jian'gong'dian'shu'shi'suo	0
见公输盘	jian'gong'shu'pan	0
见藐小之物必细察其纹理	jian'miao'xiao'zhi'wu'bi'xi'cha'qi'wen'li	0
见山上人烟市肆	jian'shan'shang'ren'yan'shi'si	0
见往事耳	jian'wang'shi'er	0
见贤思齐焉	jian'xian'si'qi'yan	0
见余	jian'yu	0
见渔人	jian'yu'ren	0
江干上下十余里间	jiang'gan'shang'xia'shi'yu'li'jian	0
江汉之鱼鳖鼋鼍为天下富	jiang'han'zhi'yu'bie'yuan'tuo'wei'tian'xia'fu	0
江横玉系腰	jiang'heng'yu'xi'yao	0
将军既帝室之胄	jiang'jun'ji'di'shi'zhi'zhou	0
将军岂有意乎	jiang'jun'qi'you'yi'hu	0
将军岂愿见之乎	jiang'jun'qi'yuan'jian'zhi'hu	0
将军身率益州之众出于秦川	jiang'jun'shen'lv'yi'zhou'zhi'zhong'chu'yu'qin'chuan	0
将军身被坚执锐	jiang'jun'shen'pi'jian'zhi'rui	0
将军向宠	jiang'jun'xiang'chong	0
将军宜枉驾顾之	jiang'jun'yi'wang'jia'gu'zhi	0
将尉醉	jiang'wei'zui	0
讲信修睦	jiang'xin'xiu'mu	0
将以攻宋	jiang'yi'gong'song	0
胶鬲举于鱼盐之中	jiao'ge'ju'yu'yu'yan'zhi'zhong	0
矫首昂视	jiao'shou'ang'shi	0
皆布衣之士也	jie'bu'yi'zhi'shi'ye	0
皆朝于齐	jie'chao'yu'qi	0
皆出酒食	jie'chu'jiu'shi	0
嗟夫	jie'fu	0
嗟乎	jie'hu	0
借旁近与之	jie'pang'jin'yu'zhi	0
皆披发文身	jie'pi'fa'wen'shen	0
皆若空游无所依	jie'ruo'kong'you'wu'suo'yi	0
皆生寒树	jie'sheng'han'shu	0
皆叹惋	jie'tan'wan	0
皆下之	jie'xia'zhi	0
皆刑其长吏	jie'xing'qi'zhang'li	0
皆以美于徐公	jie'yi'mei'yu'xu'gong	0
皆已失期	jie'yi'shi'qi	0
解衣欲睡	jie'yi'yu'shui	0
结友而别	jie'you'er'bie	0
皆指目陈胜	jie'zhi'mu'chen'sheng	0
近岸	jin'an	0
今操已拥百万之众	jin'cao'yi'yong'bai'wan'zhi'zhong	0
今诚以吾众诈自称公子扶苏项燕	jin'cheng'yi'wu'zhong'zha'zi'cheng'gong'zi'fu'su'xiang'yan	0
今当远离	jin'dang'yuan'li	0
今夫不受之天	jin'fu'bu'shou'zhi'tian	0
今或闻无罪	jin'huo'wen'wu'zui	0
进尽忠言	jin'jin'zhong'yan	0
锦鳞游泳	jin'lin'you'yong	0
今南方已定	jin'nan'fang'yi'ding	0
今齐地方千里	jin'qi'di'fang'qian'li	0
今日是也	jin'ri'shi'ye	0
仅如银线	jin'ru'yin'xian	0
近塞上之人有善术者	jin'sai'shang'zhi'ren'you'shan'shu'zhe	0
近塞之人	jin'sai'zhi'ren	0
晋太元中	jin'tai'yuan'zhong	0
晋陶渊明独爱菊	jin'tao'yuan'ming'du'ai'ju	0
今天下三分	jin'tian'xia'san'fen	0
今亡亦死	jin'wang'yi'si	0
今为宫室之美为之	jin'wei'gong'shi'zhi'mei'wei'zhi	0
今为妻妾之奉为之	jin'wei'qi'qie'zhi'feng'wei'zhi	0
今为所识穷乏者得我而为之	jin'wei'suo'shi'qiong'fa'zhe'de'wo'er'wei'zhi	0
今吾以十倍之地	jin'wu'yi'shi'bei'zhi'di	0
金溪民方仲永	jin'xi'min'fang'zhong'yong	0
仅有敌船为火所焚	jin'you'di'chuan'wei'huo'suo'fen	0
今有人于此	jin'you'ren'yu'ci	0
今子欲以子之梁国而吓我邪	jin'zi'yu'yi'zi'zhi'liang'guo'er'xia'wo'xie	0
荆国有余于地而不足于民	jing'guo'you'yu'yu'di'er'bu'zu'yu'min	0
经纶世务者	jing'lun'shi'wu'zhe	0
敬受命	jing'shou'ming	0
静影沉璧	jing'ying'chen'bi	0
荆有长松文梓楩楠豫章	jing'you'chang'song'wen'zi'pian'nan'yu'zhang	0
荆有云梦	jing'you'yun'meng	0
荆之地方五千里	jing'zhi'di'fang'wu'qian'li	0
京中有善口技者	jing'zhong'you'shan'kou'ji'zhe	0
荆州北据汉沔	jing'zhou'bei'ju'han'mian	0
九百人屯大泽乡	jiu'bai'ren'tun'da'ze'xiang	0
久而乃和	jiu'er'nai'he	0
九年级上册	jiu'nian'ji'shang'ce	0
九年级下册	jiu'nian'ji'xia'ce	0
久之	jiu'zhi	0
局促一室之内	ju'cu'yi'shi'zhi'nei	0
举大计亦死	ju'da'ji'yi'si	0
具答之	ju'da'zhi	0
居庙堂之高则忧其民	ju'miao'tang'zhi'gao'ze'you'qi'min	0
惧其不已也	ju'qi'bu'yi'ye	0
居然城郭矣	ju'ran'cheng'guo'yi	0
聚室而谋曰	ju'shi'er'mou'yue	0
居数月	ju'shu'yue	0
俱为一体	ju'wei'yi'ti	0
居一年	ju'yi'nian	0
惧有伏焉	ju'you'fu'yan	0
居右者椎髻仰面	ju'you'zhe'zhui'ji'yang'mian	0
菊之爱	ju'zhi'ai	0
居左者右手执蒲葵扇	ju'zuo'zhe'you'shou'zhi'pu'kui'shan	0
娟然如拭	juan'ran'ru'shi	0
卷石底以出	juan'shi'di'yi'chu	0
绝巘多生怪柏	jue'yan'duo'sheng'guai'bai	0
君美甚	jun'mei'shen	0
君谓计将安出	jun'wei'ji'jiang'an'chu	0
君与家君期日中	jun'yu'jia'jun'qi'ri'zhong	0
君与俱来	jun'yu'ju'lai	0
可爱者甚蕃	ke'ai'zhe'shen'fan	0
客此	ke'ci	0
客从外来	ke'cong'wai'lai	0
可乎	ke'hu	0
可计日而待也	ke'ji'ri'er'dai'ye	0
可见其顶	ke'jian'qi'ding	0
刻唐贤今人诗赋于其上	ke'tang'xian'jin'ren'shi'fu'yu'qi'shang	0
客问元方	ke'wen'yuan'fang	0
可矣	ke'yi	0
可以调素琴	ke'yi'tiao'su'qin	0
可以为师矣	ke'yi'wei'shi'yi	0
可以一战	ke'yi'yi'zhan	0
可远观而不可亵玩焉	ke'yuan'guan'er'bu'ke'xie'wan'yan	0
客曰	ke'yue	0
客之美我者	ke'zhi'mei'wo'zhe	0
空乏其身	kong'fa'qi'shen	0
恐付托不效	kong'fu'tuo'bu'xiao	0
空谷传响	kong'gu'chuan'xiang	0
恐前后受其敌	kong'qian'hou'shou'qi'di	0
孔子云	kong'zi'yun	0
口技	kou'ji	0
口技人坐屏障中	kou'ji'ren'zuo'ping'zhang'zhong	0
叩石垦壤	kou'shi'ken'rang	0
口有百舌	kou'you'bai'she	0
口中呜声	kou'zhong'wu'sheng	0
夸父与日逐走	kua'fu'yu'ri'zhu'zou	0
夸父逐日	kua'fu'zhu'ri	0
跨州连郡者不可胜数	kua'zhou'lian'jun'zhe'bu'ke'sheng'shu	0
窥谷忘反	kui'gu'wang'fan	0
窥镜	kui'jing	0
窥镜而自视	kui'jing'er'zi'shi	0
困于心衡于虑而后作	kun'yu'xin'heng'yu'lv'er'hou'zuo	0
拉余同饮	la'yu'tong'yin	0
览物之情	lan'wu'zhi'qing	0
狼不敢前	lang'bu'gan'qian	0
琅琊也	lang'ya'ye	0
狼亦黠矣	lang'yi'xia'yi	0
劳其筋骨	lao'qi'jin'gu	0
罍而歌者	lei'er'ge'zhe	0
力不足	li'bu'zu	0
郦道元	li'dao'yuan	0
力恶其不出于身也	li'e'qi'bu'chu'yu'shen'ye	0
隶而从者	li'er'cong'zhe	0
礼记	li'ji	0
利尽南海	li'jin'nan'hai	0
历历在目	li'li'zai'mu	0
里仁	li'ren	0
礼愈至	li'yu'zhi	0
连亘六七里	lian'gen'liu'qi'li	0
连月不开	lian'yue'bu'kai	0
莲之爱	lian'zhi'ai	0
两岸连山	liang'an'lian'shan	0
两岸石壁	liang'an'shi'bi	0
亮答曰	liang'da'yue	0
良多趣味	liang'duo'qu'wei	0
两儿齐哭	liang'er'qi'ku	0
亮躬耕陇亩	liang'gong'geng'long'mu	0
两股战战	liang'gu'zhan'zhan	0
两小儿辩日	liang'xiao'er'bian'ri	0
两则	liang'ze	0
两章	liang'zhang	0
列子	lie'zi	0
临表涕零	lin'biao'ti'ling	0
林寒涧肃	lin'han'jian'su	0
林壑尤美	lin'he'you'mei	0
林尽水源	lin'jin'shui'yuan	0
鳞浪层层	lin'lang'ceng'ceng	0
邻人京城氏之孀妻有遗男	lin'ren'jing'cheng'shi'zhi'shuang'qi'you'yi'nan	0
林嗣环	lin'si'huan	0
临溪而渔	lin'xi'er'yu	0
邻有敝舆而欲窃之	lin'you'bi'yu'er'yu'qie'zhi	0
邻有短褐而欲窃之	lin'you'duan'he'er'yu'qie'zhi	0
邻有糠糟而欲窃之	lin'you'kang'zao'er'yu'qie'zhi	0
令初下	ling'chu'xia	0
泠泠作响	ling'ling'zuo'xiang	0
令辱之	ling'ru'zhi	0
令作诗	ling'zuo'shi	0
柳条将舒未舒	liu'tiao'jiang'shu'wei'shu	0
流血千里	liu'xue'qian'li	0
流血五步	liu'xue'wu'bu	0
刘义庆	liu'yi'qing	0
刘禹锡	liu'yu'xi	0
刘璋暗弱	liu'zhang'an'ruo	0
柳宗元	liu'zong'yuan	0
隆中对	long'zhong'dui	0
楼渐低	lou'jian'di	0
陋室铭	lou'shi'ming	0
楼外天也	lou'wai'tian'ye	0
楼五架	lou'wu'jia	0
楼愈高	lou'yu'gao	0
录毕	lu'bi	0
庐陵欧阳修也	lu'ling'ou'yang'xiu'ye	0
炉上有壶	lu'shang'you'hu	0
鲁直居左	lu'zhi'ju'zuo	0
鲁直现左足	lu'zhi'xian'zuo'zu	0
鲁直左手执卷末	lu'zhi'zuo'shou'zhi'juan'mo	0
略无慕艳意	lve'wu'mu'yan'yi	0
略无阙处	lve'wu'que'chu	0
论语	lun'yu	0
论语十则	lun'yu'shi'ze	0
落英缤纷	luo'ying'bin'fen	0
率妻子邑人来此绝境	lv'qi'zi'yi'ren'lai'ci'jue'jing	0
马说	ma'shuo	0
马无故亡而入胡	ma'wu'gu'wang'er'ru'hu	0
马之千里者	ma'zhi'qian'li'zhe	0
麦田浅鬣寸许	mai'tian'qian'lie'cun'xu	0
满井游记	man'jing'you'ji	0
满目萧然	man'mu'xiao'ran	0
满坐宾客无不伸颈	man'zuo'bin'ke'wu'bu'shen'jing	0
满坐寂然	man'zuo'ji'ran	0
毛羽鳞鬣之间皆有喜气	mao'yu'lin'lie'zhi'jian'jie'you'xi'qi	0
每假借于藏书之家	mei'jia'jie'yu'cang'shu'zhi'jia	0
每冒风驰行	mei'mao'feng'chi'xing	0
每岁京尹出浙江亭教阅水军	mei'sui'jing'yin'chu'zhe'jiang'ting'jiao'yue'shui'jun	0
每有会意	mei'you'hui'yi	0
每与臣论此事	mei'yu'chen'lun'ci'shi	0
每至晴初霜旦	mei'zhi'qing'chu'shuang'dan	0
每自比于管仲乐毅	mei'zi'bi'yu'guan'zhong'yue'yi	0
门人弟子填其室	men'ren'di'zi'tian'qi'shi	0
门庭若市	men'ting'ruo'shi	0
门外戏	men'wai'xi	0
艨艟数百	meng'chong'shu'bai	0
蒙辞以军中多务	meng'ci'yi'jun'zhong'duo'wu	0
猛浪若奔	meng'lang'ruo'ben	0
蒙络摇缀	meng'luo'yao'zhui	0
蒙乃始就学	meng'nai'shi'jiu'xue	0
蒙曰	meng'yue	0
孟子	meng'zi	0
米粟非不多也	mi'su'fei'bu'duo'ye	0
面山而居	mian'shan'er'ju	0
民弗从也	min'fu'cong'ye	0
泯然众人矣	min'ran'zhong'ren'yi	0
民殷国富而不知存恤	min'yin'guo'fu'er'bu'zhi'cun'xu	0
明察秋毫	ming'cha'qiu'hao	0
明道中	ming'dao'zhong	0
命夸娥氏二子负二山	ming'kua'e'shi'er'zi'fu'er'shan	0
明灭可见	ming'mie'ke'jian	0
明日徐公来	ming'ri'xu'gong'lai	0
鸣声上下	ming'sheng'shang'xia	0
明有奇巧人曰王叔远	ming'you'qi'qiao'ren'yue'wang'shu'yuan	0
鸣之而不能通其意	ming'zhi'er'bu'neng'tong'qi'yi	0
名之者谁	ming'zhi'zhe'shui	0
莫说相公痴	mo'shuo'xiang'gong'chi	0
墨子	mo'zi	0
牡丹	mu'dan	0
牡丹之爱	mu'dan'zhi'ai	0
暮到江陵	mu'dao'jiang'ling	0
暮而归	mu'er'gui	0
暮而果大亡其财	mu'er'guo'da'wang'qi'cai	0
暮寝而思之	mu'qin'er'si'zhi	0
目似瞑	mu'si'ming	0
乃不知有汉	nai'bu'zhi'you'han	0
乃重修岳阳楼	nai'chong'xiu'yue'yang'lou	0
乃大惊	nai'da'jing	0
乃丹书帛曰	nai'dan'shu'bo'yue	0
乃记之而去	nai'ji'zhi'er'qu	0
乃见	nai'jian	0
乃可攻也	nai'ke'gong'ye	0
乃令符离人葛婴将兵徇蕲以东	nai'ling'fu'li'ren'ge'ying'jiang'bing'xun'qi'yi'dong	0
乃入见	nai'ru'jian	0
乃入据陈	nai'ru'ju'chen	0
乃悟前狼假寐	nai'wu'qian'lang'jia'mei	0
乃下令	nai'xia'ling	0
乃行卜	nai'xing'bu	0
乃诈称公子扶苏项燕	nai'zha'cheng'gong'zi'fu'su'xiang'yan	0
难测也	nan'ce'ye	0
南方有鸟	nan'fang'you'niao	0
南抚夷越	nan'fu'yi'yue	0
南极潇湘	nan'ji'xiao'xiang	0
男女衣着	nan'nv'yi'zhuo	0
南阳刘子骥	nan'yang'liu'zi'ji	0
南阳诸葛庐	nan'yang'zhu'ge'lu	0
男有分	nan'you'fen	0
内修政理	nei'xiu'zheng'li	0
能谤讥于市朝	neng'bang'ji'yu'shi'chao	0
能面刺寡人之过者	neng'mian'ci'gua'ren'zhi'guo'zhe	0
能以径寸之木	neng'yi'jing'cun'zhi'mu	0
能张目对日	neng'zhang'mu'dui'ri	0
廿二日天稍和	nian'er'ri'tian'shao'he	0
念鬼	nian'gui	0
念近中无此禅院	nian'jin'zhong'wu'ci'chan'yuan	0
年且九十	nian'qie'jiu'shi	0
念无与为乐者	nian'wu'yu'wei'le'zhe	0
酿泉为酒	niang'quan'wei'jiu	0
酿泉也	niang'quan'ye	0
聂政之刺韩傀也	nie'zheng'zhi'ci'han'kui'ye	0
怒而触不周之山	nu'er'chu'bu'zhou'zhi'shan	0
女有归	nv'you'gui	0
欧阳修	ou'yang'xiu	0
旁开小窗	pang'kai'xiao'chuang	0
盆器倾侧	pen'qi'qing'ce	0
骈死于槽枥之间	pian'si'yu'cao'li'zhi'jian	0
颇示己志	po'shi'ji'zhi	0
泼水声	po'shui'sheng	0
蒲松龄	pu'song'ling	0
其岸势犬牙差互	qi'an'shi'quan'ya'cha'hu	0
其必曰	qi'bi'yue	0
其不善者而改之	qi'bu'shan'zhe'er'gai'zhi	0
其船背稍夷	qi'chuan'bei'shao'yi	0
启窗而观	qi'chuang'er'guan	0
其夫呓语	qi'fu'yi'yu	0
其父曰	qi'fu'yue	0
齐国之美丽者也	qi'guo'zhi'mei'li'zhe'ye	0
其家甚智其子	qi'jia'shen'zhi'qi'zi	0
其间千二百里	qi'jian'qian'er'bai'li	0
七里之郭	qi'li'zhi'guo	0
其两膝相比者	qi'liang'xi'xiang'bi'zhe	0
其邻人之父亦云	qi'lin'ren'zhi'fu'yi'yun	0
其马将胡骏马而归	qi'ma'jiang'hu'jun'ma'er'gui	0
其名为鹓鶵	qi'ming'wei'yuan'chu	0
七年级上册	qi'nian'ji'shang'ce	0
七年级下册	qi'nian'ji'xia'ce	0
其妻献疑曰	qi'qi'xian'yi'yue	0
其妻曰	qi'qi'yue	0
弃其杖	qi'qi'zhang	0
骑千余	qi'qian'yu	0
妻妾之奉	qi'qie'zhi'feng	0
乞人不屑也	qi'ren'bu'xie'ye	0
齐人三鼓	qi'ren'san'gu	0
其人视端容寂	qi'ren'shi'duan'rong'ji	0
期日中	qi'ri'zhong	0
其如土石何	qi'ru'tu'shi'he	0
祇辱于奴隶人之手	qi'ru'yu'nu'li'ren'zhi'shou	0
其色丹	qi'se'dan	0
其色墨	qi'se'mo	0
奇山异水	qi'shan'yi'shui	0
凄神寒骨	qi'shen'han'gu	0
齐师败绩	qi'shi'bai'ji	0
齐师伐我	qi'shi'fa'wo	0
其诗以养父母	qi'shi'yi'yang'fu'mu	0
其受之天也	qi'shou'zhi'tian'ye	0
其恕乎	qi'shu'hu	0
其文理皆有可观者	qi'wen'li'jie'you'ke'guan'zhe	0
其西南诸峰	qi'xi'nan'zhu'feng	0
其喜洋洋者矣	qi'xi'yang'yang'zhe'yi	0
蕲下	qi'xia	0
其乡人曰	qi'xiang'ren'yue	0
气象万千	qi'xiang'wan'qian	0
其言兹若人之俦乎	qi'yan'zi'ruo'ren'zhi'chou'hu	0
其一犬坐于前	qi'yi'quan'zuo'yu'qian	0
起于鲁	qi'yu'lu	0
期在必醉	qi'zai'bi'zui	0
其真不知马也	qi'zhen'bu'zhi'ma'ye	0
其真无马邪	qi'zhen'wu'ma'xie	0
岂直五百里哉	qi'zhi'wu'bai'li'zai	0
其中往来种作	qi'zhong'wang'lai'zhong'zuo	0
其子好骑	qi'zi'hao'qi	0
其子曰	qi'zi'yue	0
起坐而喧哗者	qi'zuo'er'xuan'hua'zhe	0
千百成峰	qian'bai'cheng'feng	0
迁客骚人	qian'ke'sao'ren	0
千里马常有	qian'li'ma'chang'you	0
黔娄之妻有言	qian'lou'zhi'qi'you'yan	0
阡陌交通	qian'mo'jiao'tong	0
前人之述备矣	qian'ren'zhi'shu'bei'yi	0
千丈见底	qian'zhang'jian'di	0
前者呼	qian'zhe'hu	0
抢夺声	qiang'duo'sheng	0
樯倾楫摧	qiang'qing'ji'cui	0
悄怆幽邃	qiao'chuang'you'sui	0
且秦灭韩亡魏	qie'qin'mie'han'wang'wei	0
且为众人	qie'wei'zhong'ren	0
且焉置土石	qie'yan'zhi'tu'shi	0
且欲与常马等不可得	qie'yu'yu'chang'ma'deng'bu'ke'de	0
妾曰	qie'yue	0
妾之美我者	qie'zhi'mei'wo'zhe	0
且壮士不死即已	qie'zhuang'shi'bu'si'ji'yi	0
亲旧知其如此	qin'jiu'zhi'qi'ru'ci	0
亲戚畔之	qin'qi'pan'zhi	0
禽兽之变诈几何哉	qin'shou'zhi'bian'zha'ji'he'zai	0
秦王不悦	qin'wang'bu'yue	0
秦王怫然怒	qin'wang'fu'ran'nu	0
秦王色挠	qin'wang'se'nao	0
秦王使人谓安陵君曰	qin'wang'shi'ren'wei'an'ling'jun'yue	0
秦王谓唐雎曰	qin'wang'wei'tang'ju'yue	0
秦王曰	qin'wang'yue	0
亲贤臣	qin'xian'chen	0
亲小人	qin'xiao'ren	0
清澈见底	qing'che'jian'di	0
清风徐来	qing'feng'xu'lai	0
轻寡人与	qing'gua'ren'yu	0
请广于君	qing'guang'yu'jun	0
卿今当涂掌事	qing'jin'dang'tu'zhang'shi	0
卿今者才略	qing'jin'zhe'cai'lve	0
庆历四年春	qing'li'si'nian'chun	0
青林翠竹	qing'lin'cui'zhu	0
清流见底	qing'liu'jian'di	0
清荣峻茂	qing'rong'jun'mao	0
青树翠蔓	qing'shu'cui'man	0
请说之	qing'shuo'zhi	0
请献十金	qing'xian'shi'jin	0
请循其本	qing'xun'qi'ben	0
卿言多务	qing'yan'duo'wu	0
穷冬烈风	qiong'dong'lie'feng	0
去后乃至	qu'hou'nai'zhi	0
诎右臂支船	qu'you'bi'zhi'chuan	0
驱之别院	qu'zhi'bie'yuan	0
泉而茗者	quan'er'ming'zhe	0
全石以为底	quan'shi'yi'wei'di	0
泉水激石	quan'shui'ji'shi	0
权谓吕蒙曰	quan'wei'lv'meng'yue	0
泉香而酒洌	quan'xiang'er'jiu'lie	0
权曰	quan'yue	0
群臣进谏	qun'chen'jin'jian	0
群臣吏民	qun'chen'li'min	0
群响毕绝	qun'xiang'bi'jue	0
然操遂能克绍	ran'cao'sui'neng'ke'shao	0
然臣之弟子禽滑厘等三百人	ran'chen'zhi'di'zi'qin'hua'li'deng'san'bai'ren	0
然而不胜者	ran'er'bu'sheng'zhe	0
然而禽鸟知山林之乐	ran'er'qin'niao'zhi'shan'lin'zhi'le	0
然后施行	ran'hou'shi'xing	0
然后有千里马	ran'hou'you'qian'li'ma	0
然后知生于忧患而死于安乐也	ran'hou'zhi'sheng'yu'you'huan'er'si'yu'an'le'ye	0
然后知松柏之后凋也	ran'hou'zhi'song'bai'zhi'hou'diao'ye	0
然胡不已乎	ran'hu'bu'yi'hu	0
然侍卫之臣不懈于内	ran'shi'wei'zhi'chen'bu'xie'yu'nei	0
然数年恒不一见	ran'shu'nian'heng'bu'yi'jian	0
然徒步则汗出浃背	ran'tu'bu'ze'han'chu'jia'bei	0
然则北通巫峡	ran'ze'bei'tong'wu'xia	0
然则何时而乐耶	ran'ze'he'shi'er'le'ye	0
然志犹未已	ran'zhi'you'wei'yi	0
然足下卜之鬼乎	ran'zu'xia'bu'zhi'gui'hu	0
攘除奸凶	rang'chu'jian'xiong	0
人不知而不愠	ren'bu'zhi'er'bu'yun	0
人恒过然后能改	ren'heng'guo'ran'hou'neng'gai	0
人皆吊之	ren'jie'diao'zhi	0
人皆贺之	ren'jie'he'zhi	0
人皆有之	ren'jie'you'zhi	0
人物略不相睹	ren'wu'lve'bu'xiang'du	0
任意东西	ren'yi'dong'xi	0
仁以为己任	ren'yi'wei'ji'ren	0
人影散乱	ren'ying'san'luan	0
人有百口	ren'you'bai'kou	0
人知从太守游而乐	ren'zhi'cong'tai'shou'you'er'le	0
任重而道远	ren'zhong'er'dao'yuan	0
日扳仲永环谒于邑人	ri'ban'zhong'yong'huan'ye'yu'yi'ren	0
日光下澈	ri'guang'xia'che	0
日星隐曜	ri'xing'yin'yao	0
日中不至	ri'zhong'bu'zhi	0
柔梢披风	rou'shao'pi'feng	0
肉食者鄙	rou'shi'zhe'bi	0
肉食者谋之	rou'shi'zhe'mou'zhi	0
如此其贤也	ru'ci'qi'xian'ye	0
如履平地	ru'lv'ping'di	0
如鸣珮环	ru'ming'pei'huan	0
如倩女之靧面而髻鬟之始掠也	ru'qian'nv'zhi'hui'mian'er'ji'huan'zhi'shi'lve'ye	0
入日	ru'ri	0
如使人之所欲莫甚于生	ru'shi'ren'zhi'suo'yu'mo'shen'yu'sheng	0
如太行	ru'tai'hang	0
汝心之固	ru'xin'zhi'gu	0
如有所语	ru'you'suo'yu	0
入则无法家拂士	ru'ze'wu'fa'jia'bi'shi	0
汝之不惠	ru'zhi'bu'hui	0
若夫日出而林霏开	ruo'fu'ri'chu'er'lin'fei'kai	0
若夫淫雨霏霏	ruo'fu'yin'yu'fei'fei	0
若跨有荆益	ruo'kua'you'jing'yi	0
箬篷覆之	ruo'peng'fu'zhi	0
若士必怒	ruo'shi'bi'nu	0
若听茶声然	ruo'ting'cha'sheng'ran	0
若脱笼之鹄	ruo'tuo'long'zhi'hu	0
若为佣耕	ruo'wei'yong'geng	0
若无兴德之言	ruo'wu'xing'de'zhi'yan	0
若啸呼状	ruo'xiao'hu'zhuang	0
若有作奸犯科及为忠善者	ruo'you'zuo'jian'fan'ke'ji'wei'zhong'shan'zhe	0
撒盐空中差可拟	sa'yan'kong'zhong'cha'ke'ni	0
塞翁失马	sai'weng'shi'ma	0
三而竭	san'er'jie	0
三顾臣于草庐之中	san'gu'chen'yu'cao'lu'zhi'zhong	0
三老豪杰皆曰	san'lao'hao'jie'jie'yue	0
三里之城	san'li'zhi'cheng	0
三人行	san'ren'xing	0
三峡	san'xia	0
色愈恭	se'yu'gong	0
杀臣	sha'chen	0
沙鸥翔集	sha'ou'xiang'ji	0
杀所不足而争所有余	sha'suo'bu'zu'er'zheng'suo'you'yu	0
杀之以应陈涉	sha'zhi'yi'ying'chen'she	0
苫蔽成丘	shan'bi'cheng'qiu	0
山不在高	shan'bu'zai'gao	0
山川之美	shan'chuan'zhi'mei	0
山高月小	shan'gao'yue'xiao	0
山间之四时也	shan'jian'zhi'si'shi'ye	0
山间之朝暮也	shan'jian'zhi'zhao'mu'ye	0
山峦为晴雪所洗	shan'luan'wei'qing'xue'suo'xi	0
山市	shan'shi	0
山水之乐	shan'shui'zhi'le	0
山行六七里	shan'xing'liu'qi'li	0
山肴野蔌	shan'yao'ye'su	0
山有小口	shan'you'xiao'kou	0
山岳潜形	shan'yue'qian'xing	0
善哉	shan'zai	0
山之僧智仙也	shan'zhi'seng'zhi'xian'ye	0
商旅不行	shang'lv'bu'xing	0
上使外将兵	shang'shi'wai'jiang'bing	0
上书谏寡人者	shang'shu'jian'gua'ren'zhe	0
上下天光	shang'xia'tian'guang	0
上下一白	shang'xia'yi'bai	0
伤仲永	shang'zhong'yong	0
少顷	shao'qing	0
稍稍宾客其父	shao'shao'bin'ke'qi'fu	0
稍稍正坐	shao'shao'zheng'zuo	0
少时	shao'shi	0
设酒杀鸡作食	she'jiu'sha'ji'zuo'shi	0
舍其锦绣	she'qi'jin'xiu	0
舍其粱肉	she'qi'liang'rou	0
舍其文轩	she'qi'wen'xuan	0
舍生而取义者也	she'sheng'er'qu'yi'zhe'ye	0
舌一吐而二虫尽为所吞	she'yi'tu'er'er'chong'jin'wei'suo'tun	0
舍鱼而取熊掌者也	she'yu'er'qu'xiong'zhang'zhe'ye	0
射者中	she'zhe'zhong	0
身长八尺	shen'chang'ba'chi	0
神定	shen'ding	0
沈复	shen'fu	0
神弗福也	shen'fu'fu'ye	0
神情与苏黄不属	shen'qing'yu'su'huang'bu'shu	0
深入不毛	shen'ru'bu'mao	0
甚善	shen'shan	0
甚矣	shen'yi	0
身已半入	shen'yi'ban'ru	0
神游其中	shen'you'qi'zhong	0
深追先帝遗诏	shen'zhui'xian'di'yi'zhao	0
声如崩山	sheng'ru'beng'shan	0
生亦我所欲	sheng'yi'wo'suo'yu	0
生于忧患	sheng'yu'you'huan	0
施八尺屏障	shi'ba'chi'ping'zhang	0
士别三日	shi'bie'san'ri	0
食不饱	shi'bu'bao	0
士不可以不弘毅	shi'bu'ke'yi'bu'hong'yi	0
始龀	shi'chen	0
失道寡助	shi'dao'gua'zhu	0
失道者寡助	shi'dao'zhe'gua'zhu	0
是地利不如人和也	shi'di'li'bu'ru'ren'he'ye	0
十二三矣	shi'er'san'yi	0
是故谋闭而不兴	shi'gu'mou'bi'er'bu'xing	0
是故所欲有甚于生者	shi'gu'suo'yu'you'shen'yu'sheng'zhe	0
势极雄豪	shi'ji'xiong'hao	0
是金陵人	shi'jin'ling'ren	0
是进亦忧	shi'jin'yi'you	0
使老有所终	shi'lao'you'suo'zhong	0
世隶耕	shi'li'geng	0
时六年九月十五日	shi'liu'nian'jiu'yue'shi'wu'ri	0
是马也	shi'ma'ye	0
食马者不知其能千里而食也	shi'ma'zhe'bu'zhi'qi'neng'qian'li'er'shi'ye	0
使内外异法也	shi'nei'wai'yi'fa'ye	0
十年春	shi'nian'chun	0
失期	shi'qi	0
失期当斩	shi'qi'dang'zhan	0
石青糁之	shi'qing'shen'zhi	0
时人莫之许也	shi'ren'mo'zhi'xu'ye	0
世人盛爱牡丹	shi'ren'sheng'ai'mu'dan	0
使人之所恶莫甚于死者	shi'ren'zhi'suo'e'mo'shen'yu'si'zhe	0
是日更定矣	shi'ri'geng'ding'yi	0
时时而间进	shi'shi'er'jian'jin	0
实是欲界之仙都	shi'shi'yu'jie'zhi'xian'du	0
世说新语	shi'shuo'xin'yu	0
世说新语两则	shi'shuo'xin'yu'liang'ze	0
世说新语刘义庆	shi'shuo'xin'yu'liu'yi'qing	0
是天时不如地利也	shi'tian'shi'bu'ru'di'li'ye	0
是谓大同	shi'wei'da'tong	0
事无大小	shi'wu'da'xiao	0
始悟为山市	shi'wu'wei'shan'shi	0
时先主屯新野	shi'xian'zhu'tun'xin'ye	0
是亦不可以已乎	shi'yi'bu'ke'yi'yi'hu	0
始一反焉	shi'yi'fan'yan	0
是以先帝简拔以遗陛下	shi'yi'xian'di'jian'ba'yi'yi'bi'xia	0
是以众议举宠为督	shi'yi'zhong'yi'ju'chong'wei'du	0
试用于昔日	shi'yong'yu'xi'ri	0
世有伯乐	shi'you'bo'le	0
使与台齐	shi'yu'tai'qi	0
是鱼之乐也	shi'yu'zhi'le'ye	0
食之不能尽其材	shi'zhi'bu'neng'jin'qi'cai	0
使之冲烟而飞鸣	shi'zhi'chong'yan'er'fei'ming	0
始知郊田之外未始无春	shi'zhi'jiao'tian'zhi'wai'wei'shi'wu'chun	0
是知也	shi'zhi'ye	0
侍中尚书长史参军	shi'zhong'shang'shu'zhang'shi'can'jun	0
侍中侍郎郭攸之费祎董允等	shi'zhong'shi'lang'guo'you'zhi'fei'yi'dong'yun'deng	0
士卒多为用者	shi'zu'duo'wei'yong'zhe	0
守丞死	shou'cheng'si	0
手持十幅大彩旗	shou'chi'shi'fu'da'cai'qi	0
受地于先王	shou'di'yu'xian'wang	0
收而攻蕲	shou'er'gong'qi	0
受命以来	shou'ming'yi'lai	0
受任于败军之际	shou'ren'yu'bai'jun'zhi'ji	0
受上赏	shou'shang'shang	0
受下赏	shou'xia'shang	0
手有百指	shou'you'bai'zhi	0
手指不可屈伸	shou'zhi'bu'ke'qu'shen	0
受之天也	shou'zhi'tian'ye	0
受中赏	shou'zhong'shang	0
手自笔录	shou'zi'bi'lu	0
收族为意	shou'zu'wei'yi	0
述而	shu'er	0
倏尔黄烟四起	shu'er'huang'yan'si'qi	0
倏忽如拳如豆	shu'hu'ru'quan'ru'dou	0
庶竭驽钝	shu'jie'nu'dun	0
树林阴翳	shu'lin'yin'yi	0
数日	shu'ri	0
孰若孤	shu'ruo'gu	0
孰视之	shu'shi'zhi	0
疏条交映	shu'tiao'jiao'ying	0
属引凄异	shu'yin'qi'yi	0
数有功	shu'you'gong	0
属予作文以记之	shu'yu'zuo'wen'yi'ji'zhi	0
庶曰	shu'yue	0
数月之后	shu'yue'zhi'hou	0
数至八层	shu'zhi'ba'ceng	0
水爆轰震	shui'bao'hong'zhen	0
水波不兴	shui'bo'bu'xing	0
水不在深	shui'bu'zai'shen	0
水皆缥碧	shui'jie'piao'bi	0
水陆草木之花	shui'lu'cao'mu'zhi'hua	0
水落而石出者	shui'luo'er'shi'chu'zhe	0
水落石出	shui'luo'shi'chu	0
水尤清冽	shui'you'qing'lie	0
水中藻荇交横	shui'zhong'zao'xing'jiao'heng	0
舜发于畎亩之中	shun'fa'yu'quan'mu'zhi'zhong	0
说如此	shuo'ru'ci	0
思而不学则殆	si'er'bu'xue'ze'dai	0
死而后已	si'er'hou'yi	0
死国可乎	si'guo'ke'hu	0
死即举大名耳	si'ji'ju'da'ming'er	0
四境之内莫不有求于王	si'jing'zhi'nei'mo'bu'you'qiu'yu'wang	0
司马迁	si'ma'qian	0
四面竹树环合	si'mian'zhu'shu'huan'he	0
私拟作群鹤舞于空中	si'ni'zuo'qun'he'wu'yu'kong'zhong	0
俟其欣悦	si'qi'xin'yue	0
四时俱备	si'shi'ju'bei	0
斯是陋室	si'shi'lou'shi	0
四时之景不同	si'shi'zhi'jing'bu'tong	0
私我也	si'wo'ye	0
思贤如渴	si'xian'ru'ke	0
死亦我所恶	si'yi'wo'suo'e	0
死于安乐	si'yu'an'le	0
似与游者相乐	si'yu'you'zhe'xiang'le	0
死者十九	si'zhe'shi'jiu	0
四支僵劲不能动	si'zhi'jiang'jin'bu'neng'dong	0
送东阳马生序	song'dong'yang'ma'sheng'xu	0
宋何罪之有	song'he'zui'zhi'you	0
宋濂	song'lian	0
宋莫能守	song'mo'neng'shou	0
宋所谓无雉兔鲋鱼者也	song'suo'wei'wu'zhi'tu'fu'yu'zhe'ye	0
宋无长木	song'wu'chang'mu	0
宋无罪而攻之	song'wu'zui'er'gong'zhi	0
宋有富人	song'you'fu'ren	0
宋之地方五百里	song'zhi'di'fang'wu'bai'li	0
搜于国中三日三夜	sou'yu'guo'zhong'san'ri'san'ye	0
苏黄共阅一手卷	su'huang'gong'yue'yi'shou'juan	0
苏轼	su'shi	0
肃遂拜蒙母	su'sui'bai'meng'mu	0
夙夜忧叹	su'ye'you'tan	0
溯迎而上	su'ying'er'shang	0
随波而逝	sui'bo'er'shi	0
遂不可见	sui'bu'ke'jian	0
虽不能察	sui'bu'neng'cha	0
虽乘奔御风	sui'cheng'ben'yu'feng	0
岁寒	sui'han	0
遂率子孙荷担者三夫	sui'lv'zi'sun'he'dan'zhe'san'fu	0
遂迷	sui'mi	0
虽千里不敢易也	sui'qian'li'bu'gan'yi'ye	0
虽然	sui'ran	0
虽人有百手	sui'ren'you'bai'shou	0
虽杀臣	sui'sha'chen	0
虽我之死	sui'wo'zhi'si	0
虽席地不容间也	sui'xi'di'bu'rong'jian'ye	0
遂许先帝以驱驰	sui'xu'xian'di'yi'qu'chi	0
遂用猖蹶	sui'yong'chang'jue	0
虽有千里之能	sui'you'qian'li'zhi'neng	0
遂与外人间隔	sui'yu'wai'ren'jian'ge	0
虽欲言	sui'yu'yan	0
遂至承天寺寻张怀民	sui'zhi'cheng'tian'si'xun'zhang'huai'min	0
遂逐齐师	sui'zhu'qi'shi	0
孙公子禹年与同人饮楼上	sun'gong'zi'yu'nian'yu'tong'ren'yin'lou'shang	0
孙权据有江东	sun'quan'ju'you'jiang'dong	0
孙权劝学	sun'quan'quan'xue	0
孙叔敖举于海	sun'shu'ao'ju'yu'hai	0
孙又生子	sun'you'sheng'zi	0
所恶有甚于死者	suo'e'you'shen'yu'si'zhe	0
所识穷乏者得我与	suo'shi'qiong'fa'zhe'de'wo'yu	0
所以动心忍性	suo'yi'dong'xin'ren'xing	0
所欲有甚于生者	suo'yu'you'shen'yu'sheng'zhe	0
泰伯	tai'bo	0
太行	tai'hang	0
苔痕上阶绿	tai'hen'shang'jie'lv	0
太丘舍去	tai'qiu'she'qu	0
太守归而宾客从也	tai'shou'gui'er'bin'ke'cong'ye	0
太守即遣人随其往	tai'shou'ji'qian'ren'sui'qi'wang	0
太守谓谁	tai'shou'wei'shui	0
太守宴也	tai'shou'yan'ye	0
太守也	tai'shou'ye	0
太守与客来饮于此	tai'shou'yu'ke'lai'yin'yu'ci	0
太守自谓也	tai'shou'zi'wei'ye	0
太守醉也	tai'shou'zui'ye	0
潭西南而望	tan'xi'nan'er'wang	0
谈笑有鸿儒	tan'xiao'you'hong'ru	0
袒胸露乳	tan'xiong'lu'ru	0
袒右	tan'you	0
潭中鱼可百许头	tan'zhong'yu'ke'bai'xu'tou	0
唐雎不辱使命	tang'ju'bu'ru'shi'ming	0
唐雎对曰	tang'ju'dui'yue	0
唐雎曰	tang'ju'yue	0
堂若者	tang'ruo'zhe	0
陶弘景	tao'hong'jing	0
陶后鲜有闻	tao'hou'xian'you'wen	0
桃花源记	tao'hua'yuan'ji	0
陶渊明	tao'yuan'ming	0
腾身百变	teng'shen'bai'bian	0
滕子京谪守巴陵郡	teng'zi'jing'zhe'shou'ba'ling'jun	0
天大寒	tian'da'han	0
天府之土	tian'fu'zhi'tu	0
天启壬戌秋日	tian'qi'ren'xu'qiu'ri	0
天倾西北	tian'qing'xi'bei	0
天山共色	tian'shan'gong'se	0
天时不如地利	tian'shi'bu'ru'di'li	0
天下独绝	tian'xia'du'jue	0
天下缟素	tian'xia'gao'su	0
天下苦秦久矣	tian'xia'ku'qin'jiu'yi	0
天下顺之	tian'xia'shun'zhi	0
天下为公	tian'xia'wei'gong	0
天下无马	tian'xia'wu'ma	0
天下有变	tian'xia'you'bian	0
天下之伟观也	tian'xia'zhi'wei'guan'ye	0
天雨墙坏	tian'yu'qiang'huai	0
天与云与山与水	tian'yu'yun'yu'shan'yu'shui	0
天柱折	tian'zhu'zhe	0
天子之怒	tian'zi'zhi'nu	0
跳往助之	tiao'wang'zhu'zhi	0
挺剑而起	ting'jian'er'qi	0
停数日	ting'shu'ri	0
亭亭净植	ting'ting'jing'zhi	0
庭下如积水空明	ting'xia'ru'ji'shui'kong'ming	0
通计一舟	tong'ji'yi'zhou	0
童趣	tong'qu	0
同舍生皆被绮绣	tong'she'sheng'jie'bei'qi'xiu	0
同游者	tong'you'zhe	0
同予者何人	tong'yu'zhe'he'ren	0
投以骨	tou'yi'gu	0
投诸渤海之尾	tou'zhu'bo'hai'zhi'wei	0
屠暴起	tu'bao'qi	0
屠大窘	tu'da'jiong	0
土地平旷	tu'di'ping'kuang	0
土膏微润	tu'gao'wei'run	0
屠惧	tu'ju	0
屠乃奔倚其下	tu'nai'ben'yi'qi'xia	0
徒属皆曰	tu'shu'jie'yue	0
徒以有先生也	tu'yi'you'xian'sheng'ye	0
途中两狼	tu'zhong'liang'lang	0
屠自后断其股	tu'zi'hou'duan'qi'gu	0
颓然乎其间者	tui'ran'hu'qi'jian'zhe	0
退亦忧	tui'yi'you	0
吞长江	tun'chang'jiang	0
吞天沃日	tun'tian'wo'ri	0
外结好孙权	wai'jie'hao'sun'quan	0
万钟于我何加焉	wan'zhong'yu'wo'he'jia'yan	0
万钟则不辩礼义而受之	wan'zhong'ze'bu'bian'li'yi'er'shou'zhi	0
王安石	wang'an'shi	0
罔不因势象形	wang'bu'yin'shi'xiang'xing	0
望峰息心	wang'feng'xi'xin	0
王侯将相宁有种乎	wang'hou'jiang'xiang'ning'you'zhong'hu	0
忘怀得失	wang'huai'de'shi	0
往来而不绝者	wang'lai'er'bu'jue'zhe	0
往来无白丁	wang'lai'wu'bai'ding	0
往来翕忽	wang'lai'xi'hu	0
忘路之远近	wang'lu'zhi'yuan'jin	0
望其旗靡	wang'qi'qi'mi	0
王屋二山	wang'wu'er'shan	0
王屋何	wang'wu'he	0
王曰	wang'yue	0
王之蔽甚矣	wang'zhi'bi'shen'yi	0
望之蔚然而深秀者	wang'zhi'wei'ran'er'shen'xiu'zhe	0
王子曰	wang'zi'yue	0
未百步辄返	wei'bai'bu'zhe'fan	0
未尝不叹息痛恨于桓灵也	wei'chang'bu'tan'xi'tong'hen'yu'huan'ling'ye	0
惟长堤一痕	wei'chang'di'yi'hen	0
未尝稍降辞色	wei'chang'shao'jiang'ci'se	0
未尝识书具	wei'chang'shi'shu'ju	0
为窗八	wei'chuang'ba	0
惟此官也	wei'ci'guan'ye	0
为坻为屿	wei'di'wei'yu	0
委而去之	wei'er'qu'zhi	0
未复有能与其奇者	wei'fu'you'neng'yu'qi'qi'zhe	0
为宫室器皿人物	wei'gong'shi'qi'min'ren'wu	0
为宫室之美	wei'gong'shi'zhi'mei	0
未果	wei'guo	0
尉果笞广	wei'guo'chi'guang	0
未几	wei'ji	0
尉剑挺	wei'jian'ting	0
未可	wei'ke	0
卫灵公	wei'ling'gong	0
魏灭亡	wei'mie'wang	0
未能远谋	wei'neng'yuan'mou	0
谓其妻曰	wei'qi'qi'yue	0
为人谋而不忠乎	wei'ren'mou'er'bu'zhong'hu	0
为人五	wei'ren'wu	0
未若柳絮因风起	wei'ruo'liu'xu'yin'feng'qi	0
微斯人	wei'si'ren	0
为坛而盟	wei'tan'er'meng	0
谓唐雎曰	wei'tang'ju'yue	0
威天下不以兵革之利	wei'tian'xia'bu'yi'bing'ge'zhi'li	0
为天下唱	wei'tian'xia'chang	0
为屯长	wei'tun'zhang	0
惟危楼一座	wei'wei'lou'yi'zuo	0
谓为信然	wei'wei'xin'ran	0
微闻有鼠作作索索	wei'wen'you'shu'zuo'zuo'suo'suo	0
畏我也	wei'wo'ye	0
惟吾德馨	wei'wu'de'xin	0
谓先主曰	wei'xian'zhu'yue	0
魏学洢	wei'xue'yi	0
为与此同类	wei'yu'ci'tong'lei	0
为嵁为岩	wei'zhan'wei'yan	0
为政	wei'zheng	0
未至	wei'zhi	0
未知其死也	wei'zhi'qi'si'ye	0
为之怡然称快	wei'zhi'yi'ran'cheng'kuai	0
为字共三十有四	wei'zi'gong'san'shi'you'si	0
猥自枉屈	wei'zi'wang'qu	0
温故而知新	wen'gu'er'zhi'xin	0
闻寡人之耳者	wen'gua'ren'zhi'er'zhe	0
问今是何世	wen'jin'shi'he'shi	0
问其姓氏	wen'qi'xing'shi	0
闻水声	wen'shui'sheng	0
问所从来	wen'suo'cong'lai	0
文曰	wen'yue	0
闻之	wen'zhi	0
问之客曰	wen'zhi'ke'yue	0
我非子	wo'fei'zi	0
卧龙也	wo'long'ye	0
我孰与城北徐公美	wo'shu'yu'cheng'bei'xu'gong'mei	0
我所欲也	wo'suo'yu'ye	0
沃野千里	wo'ye'qian'li	0
卧右膝	wo'you'xi	0
我知之濠上也	wo'zhi'zhi'hao'shang'ye	0
无案牍之劳形	wu'an'du'zhi'lao'xing	0
吾不言	wu'bu'yan	0
吾从北方闻子为梯	wu'cong'bei'fang'wen'zi'wei'ti	0
无从致书以观	wu'cong'zhi'shu'yi'guan	0
吴儿善泅者数百	wu'er'shan'qiu'zhe'shu'bai	0
无敢哗者	wu'gan'hua'zhe	0
吴广素爱人	wu'guang'su'ai'ren	0
吴广为都尉	wu'guang'wei'du'wei	0
吴广以为然	wu'guang'yi'wei'ran	0
吴广者	wu'guang'zhe	0
无何	wu'he	0
呜呼	wu'hu	0
无怀氏之民欤	wu'huai'shi'zhi'min'yu	0
吾既已言之王矣	wu'ji'yi'yan'zhi'wang'yi	0
吴均	wu'jun	0
无可进者	wu'ke'jin'zhe	0
武陵人捕鱼为业	wu'ling'ren'bu'yu'wei'ye	0
五柳先生传	wu'liu'xian'sheng'zhuan	0
无陇断焉	wu'long'duan'yan	0
无论魏晋	wu'lun'wei'jin	0
吾妻之美我者	wu'qi'zhi'mei'wo'zhe	0
吾请无攻宋矣	wu'qing'wu'gong'song'yi	0
吾日三省吾身	wu'ri'san'xing'wu'shen	0
五色交辉	wu'se'jiao'hui	0
屋舍俨然	wu'she'yan'ran	0
吾视其辙乱	wu'shi'qi'zhe'luan	0
勿施于人	wu'shi'yu'ren	0
吾孰与徐公美	wu'shu'yu'xu'gong'mei	0
吾谁与归	wu'shui'yu'gui	0
无丝竹之乱耳	wu'si'zhu'zhi'luan'er	0
雾凇沆砀	wu'song'hang'dang	0
无所不有	wu'suo'bu'you	0
吾闻二世少子也	wu'wen'er'shi'shao'zi'ye	0
吴武陵	wu'wu'ling	0
无鲜肥滋味之享	wu'xian'fei'zi'wei'zhi'xiang	0
无相忘	wu'xiang'wang	0
吾义固不杀人	wu'yi'gu'bu'sha'ren	0
吾与汝毕力平险	wu'yu'ru'bi'li'ping'xian	0
吾与徐公孰美	wu'yu'xu'gong'shu'mei	0
吾知所以距子矣	wu'zhi'suo'yi'ju'zi'yi	0
吾知子之所以距我	wu'zhi'zi'zhi'suo'yi'ju'wo	0
西和诸戎	xi'he'zhu'rong	0
夕日欲颓	xi'ri'yu'tui	0
悉如外人	xi'ru'wai'ren	0
细若蚊足	xi'ruo'wen'zu	0
溪深而鱼肥	xi'shen'er'yu'fei	0
牺牲玉帛	xi'sheng'yu'bo	0
西蜀子云亭	xi'shu'zi'yun'ting	0
犀兕麋鹿满之	xi'si'mi'lu'man'zhi	0
西通巴蜀	xi'tong'ba'shu	0
悉以咨之	xi'yi'zi'zhi	0
昔者	xi'zhe	0
下车引之	xia'che'yin'zhi	0
下见小潭	xia'jian'xiao'tan	0
呷浪之鳞	xia'lang'zhi'lin	0
下视其辙	xia'shi'qi'zhe	0
夏蚊成雷	xia'wen'cheng'lei	0
先达德隆望尊	xian'da'de'long'wang'zun	0
先帝不以臣卑鄙	xian'di'bu'yi'chen'bei'bi	0
先帝称之曰能	xian'di'cheng'zhi'yue'neng	0
先帝创业未半而中道崩殂	xian'di'chuang'ye'wei'ban'er'zhong'dao'beng'cu	0
先帝在时	xian'di'zai'shi	0
先帝知臣谨慎	xian'di'zhi'chen'jin'shen	0
闲静少言	xian'jing'shao'yan	0
咸来问讯	xian'lai'wen'xun	0
贤能为之用	xian'neng'wei'zhi'yong	0
衔觞赋诗	xian'shang'fu'shi	0
先生不知何许人也	xian'sheng'bu'zhi'he'xu'ren'ye	0
先生坐	xian'sheng'zuo	0
先天下之忧而忧	xian'tian'xia'zhi'you'er'you	0
鲜妍明媚	xian'yan'ming'mei	0
贤于材人远矣	xian'yu'cai'ren'yuan'yi	0
衔远山	xian'yuan'shan	0
贤者能勿丧耳	xian'zhe'neng'wu'sang'er	0
先主解之曰	xian'zhu'jie'zhi'yue	0
先主器之	xian'zhu'qi'zhi	0
先主曰	xian'zhu'yue	0
相顾惊疑	xiang'gu'jing'yi	0
相委而去	xiang'wei'er'qu	0
乡为身死而不受	xiang'wei'shen'si'er'bu'shou	0
项为之强	xiang'wei'zhi'qiang	0
项燕为楚将	xiang'yan'wei'chu'jiang	0
相与步于中庭	xiang'yu'bu'yu'zhong'ting	0
香远益清	xiang'yuan'yi'qing	0
晓畅军事	xiao'chang'jun'shi	0
小大之狱	xiao'da'zhi'yu	0
小惠未徧	xiao'hui'wei'bian	0
潇然于山石草木之间者	xiao'ran'yu'shan'shi'cao'mu'zhi'jian'zhe	0
小石潭记	xiao'shi'tan'ji	0
晓雾将歇	xiao'wu'jiang'xie	0
小信未孚	xiao'xin'wei'fu	0
偕数友出东直	xie'shu'you'chu'dong'zhi	0
谢太傅寒雪日内集	xie'tai'fu'han'xue'ri'nei'ji	0
挟天子而令诸侯	xie'tian'zi'er'ling'zhu'hou	0
心乐之	xin'le'zhi	0
欣然规往	xin'ran'gui'wang	0
欣然起行	xin'ran'qi'xing	0
信义著于四海	xin'yi'zhu'yu'si'hai	0
心之所向	xin'zhi'suo'xiang	0
行道之人弗受	xing'dao'zhi'ren'fu'shou	0
兴复汉室	xing'fu'han'shi	0
行拂乱其所为	xing'fu'luan'qi'suo'wei	0
醒能述以文者	xing'neng'shu'yi'wen'zhe	0
性嗜酒	xing'shi'jiu	0
行十日十夜而至于郢	xing'shi'ri'shi'ye'er'zhi'yu'ying	0
行收兵	xing'shou'bing	0
性行淑均	xing'xing'shu'jun	0
行者休于树	xing'zhe'xiu'yu'shu	0
兴正浓	xing'zheng'nong	0
兄女曰	xiong'nv'yue	0
熊掌	xiong'zhang	0
兄子胡儿曰	xiong'zi'hu'er'yue	0
休祲降于天	xiu'jin'jiang'yu'tian	0
徐公不若君之美也	xu'gong'bu'ruo'jun'zhi'mei'ye	0
徐公何能及君也	xu'gong'he'neng'ji'jun'ye	0
徐喷以烟	xu'pen'yi'yan	0
徐庶见先主	xu'shu'jian'xian'zhu	0
絮絮不止	xu'xu'bu'zhi	0
悬泉瀑布	xuan'quan'pu'bu	0
选贤与能	xuan'xian'yu'neng	0
学而	xue'er	0
学而不思则罔	xue'er'bu'si'ze'wang	0
学而时习之	xue'er'shi'xi'zhi	0
寻病终	xun'bing'zhong	0
寻向所志	xun'xiang'suo'zhi	0
砚冰坚	yan'bing'jian	0
燕地寒	yan'di'han	0
宴酣之乐	yan'han'zhi'le	0
燕雀安知鸿鹄之志哉	yan'que'an'zhi'hong'hu'zhi'zhi'zai	0
晏如也	yan'ru'ye	0
沿溯阻绝	yan'su'zu'jue	0
烟消波静	yan'xiao'bo'jing	0
燕赵韩魏闻之	yan'zhao'han'wei'wen'zhi	0
阳城人也	yang'cheng'ren'ye	0
杨诚斋诗云	yang'cheng'zhai'shi'yun	0
仰而视之曰	yang'er'shi'zhi'yue	0
阳夏人也	yang'xia'ren'ye	0
腰白玉之环	yao'bai'yu'zhi'huan	0
要离之刺庆忌也	yao'li'zhi'ci'qing'ji'ye	0
遥闻深巷中犬吠	yao'wen'shen'xiang'zhong'quan'fei	0
野芳发而幽香	ye'fang'fa'er'you'xiang	0
夜篝火	ye'gou'huo	0
烨然若神人	ye'ran'ruo'shen'ren	0
曳屋许许声	ye'wu'xu'xu'sheng	0
邑八景之一也	yi'ba'jing'zhi'yi'ye	0
一碧万顷	yi'bi'wan'qing	0
亦毙之	yi'bi'zhi	0
义不杀少而杀众	yi'bu'sha'shao'er'sha'zhong	0
亦不详其姓字	yi'bu'xiang'qi'xing'zi	0
以残年余力	yi'can'nian'yu'li	0
已持臣守圉之器	yi'chi'chen'shou'yu'zhi'qi	0
以虫蚁为兽	yi'chong'yi'wei'shou	0
以此夸能	yi'ci'kua'neng	0
以此自终	yi'ci'zi'zhong	0
以丛草为林	yi'cong'cao'wei'lin	0
一厝朔东	yi'cuo'shuo'dong	0
一厝雍南	yi'cuo'yong'nan	0
以大易小	yi'da'yi'xiao	0
一箪食	yi'dan'shi	0
以刀劈狼首	yi'dao'pi'lang'shou	0
以牒为械	yi'die'wei'xie	0
一豆羹	yi'dou'geng	0
宜多应者	yi'duo'ying'zhe	0
已而夕阳在山	yi'er'xi'yang'zai'shan	0
宜付有司论其刑赏	yi'fu'you'si'lun'qi'xing'shang	0
以告先帝之灵	yi'gao'xian'di'zhi'ling	0
一鼓作气	yi'gu'zuo'qi	0
以光先帝遗德	yi'guang'xian'di'yi'de	0
一行有五点明处	yi'hang'you'wu'dian'ming'chu	0
宜乎众矣	yi'hu'zhong'yi	0
以激怒其众	yi'ji'nu'qi'zhong	0
意将隧入以攻其后也	yi'jiang'sui'ru'yi'gong'qi'hou'ye	0
以君为长者	yi'jun'wei'zhang'zhe	0
以君之力	yi'jun'zhi'li	0
一狼得骨止	yi'lang'de'gu'zhi	0
一狼洞其中	yi'lang'dong'qi'zhong	0
一狼径去	yi'lang'jing'qu	0
一狼仍从	yi'lang'reng'cong	0
以乐其志	yi'le'qi'zhi	0
已历三世	yi'li'san'shi	0
亦免冠徒跣	yi'mian'guan'tu'xian	0
益慕圣贤之道	yi'mu'sheng'xian'zhi'dao	0
以其境过清	yi'qi'jing'guo'qing	0
一切乌有	yi'qie'wu'you	0
以衾拥覆	yi'qin'yong'fu	0
已去	yi'qu	0
佁然不动	yi'ran'bu'dong	0
怡然自得	yi'ran'zi'de	0
邑人奇之	yi'ren'qi'zhi	0
一人一桌一椅一扇一抚尺而已	yi'ren'yi'zhuo'yi'yi'yi'shan'yi'fu'chi'er'yi	0
一日	yi'ri	0
以弱为强者	yi'ruo'wei'qiang'zhe	0
以塞忠谏之路也	yi'sai'zhong'jian'zhi'lu'ye	0
以伤先帝之明	yi'shang'xian'di'zhi'ming	0
一食或尽粟一石	yi'shi'huo'jin'su'yi'dan	0
一时齐发	yi'shi'qi'fa	0
以是人多以书假余	yi'shi'ren'duo'yi'shu'jia'yu	0
亦时时有	yi'shi'shi'you	0
衣食所安	yi'shi'suo'an	0
诣太守	yi'tai'shou	0
以天下之所顺	yi'tian'xia'zhi'suo'shun	0
一童子烧酒炉正沸	yi'tong'zi'shao'jiu'lu'zheng'fei	0
以头抢地耳	yi'tou'qiang'di'er	0
以土砾凸者为丘	yi'tu'li'tu'zhe'wei'qiu	0
一屠晚归	yi'tu'wan'gui	0
一望空阔	yi'wang'kong'kuo	0
以为妙绝	yi'wei'miao'jue	0
亦我所欲也	yi'wo'suo'yu'ye	0
意暇甚	yi'xia'shen	0
抑亦人谋也	yi'yi'ren'mou'ye	0
以亿万计	yi'yi'wan'ji	0
以彰其咎	yi'zhang'qi'jiu	0
以昭陛下平明之理	yi'zhao'bi'xia'ping'ming'zhi'li	0
弈者胜	yi'zhe'sheng	0
以至鸟兽木石	yi'zhi'niao'shou'mu'shi	0
以中有足乐者	yi'zhong'you'zu'le'zhe	0
益州疲弊	yi'zhou'pi'bi	0
益州险塞	yi'zhou'xian'sai	0
一桌一椅一扇一抚尺而已	yi'zhuo'yi'yi'yi'shan'yi'fu'chi'er'yi	0
以咨诹善道	yi'zi'zou'shan'dao	0
阴风怒号	yin'feng'nu'hao	0
因屏人曰	yin'ping'ren'yue	0
饮少辄醉	yin'shao'zhe'zui	0
饮食百物皆倍穹常时	yin'shi'bai'wu'jie'bei'qiong'chang'shi	0
隐天蔽日	yin'tian'bi'ri	0
隐土之北	yin'tu'zhi'bei	0
因以为号焉	yin'yi'wei'hao'yan	0
饮于河渭	yin'yu'he'wei	0
引喻失义	yin'yu'shi'yi	0
影布石上	ying'bu'shi'shang	0
媵人持汤沃灌	ying'ren'chi'tang'wo'guan	0
嘤嘤成韵	ying'ying'cheng'yun	0
拥毳衣炉火	yong'cui'yi'lu'huo	0
勇气也	yong'qi'ye	0
咏雪	yong'xue	0
佣者笑而应曰	yong'zhe'xiao'er'ying'yue	0
右备容臭	you'bei'rong'xiu	0
又不受之人	you'bu'shou'zhi'ren	0
忧谗畏讥	you'chan'wei'ji	0
由此观之	you'ci'guan'zhi	0
又弗如远甚	you'fu'ru'yuan'shen	0
有功	you'gong	0
又何间焉	you'he'jian'yan	0
又患无硕师名人与游	you'huan'wu'shuo'shi'ming'ren'yu'you	0
又夹百千求救声	you'jia'bai'qian'qiu'jiu'sheng	0
又间令吴广之次所旁丛祠中	you'jian'ling'wu'guang'zhi'ci'suo'pang'cong'ci'zhong	0
又渐如常楼	you'jian'ru'chang'lou	0
又渐如高舍	you'jian'ru'gao'she	0
有两人铺毡对坐	you'liang'ren'pu'zhan'dui'zuo	0
有良田美池桑竹之属	you'liang'tian'mei'chi'sang'zhu'zhi'shu	0
优劣得所	you'lie'de'suo	0
又留蚊于素帐中	you'liu'wen'yu'su'zhang'zhong	0
有龙则灵	you'long'ze'ling	0
有朋自远方来	you'peng'zi'yuan'fang'lai	0
又七年	you'qi'nian	0
又其上	you'qi'shang	0
悠然自得	you'ran'zi'de	0
友人便怒	you'ren'bian'nu	0
友人惭	you'ren'can	0
游人去而禽鸟乐也	you'ren'qu'er'qin'niao'le'ye	0
游人虽未盛	you'ren'sui'wei'sheng	0
有时朝发白帝	you'shi'chao'fa'bai'di	0
由是感激	you'shi'gan'ji	0
有时见日	you'shi'jian'ri	0
由是先主遂诣亮	you'shi'xian'zhu'sui'yi'liang	0
由是则可以辟患而有不为也	you'shi'ze'ke'yi'pi'huan'er'you'bu'wei'ye	0
由是则生而有不用也	you'shi'ze'sheng'er'you'bu'yong'ye	0
右手攀右趾	you'shou'pan'you'zhi	0
右手指卷	you'shou'zhi'juan	0
又数刀毙之	you'shu'dao'bi'zhi	0
有所广益	you'suo'guang'yi	0
有亭翼然临于泉上者	you'ting'yi'ran'lin'yu'quan'shang'zhe	0
又闻有早行者	you'wen'you'zao'xing'zhe	0
有仙则名	you'xian'ze'ming	0
又一大儿醒	you'yi'da'er'xing	0
有一言而可以终身行之者乎	you'yi'yan'er'ke'yi'zhong'shen'xing'zhi'zhe'hu	0
又用篆章一	you'yong'zhuan'zhang'yi	0
幼有所长	you'you'suo'chang	0
游鱼细石	you'yu'xi'shi	0
犹鱼之有水也	you'yu'zhi'you'shui'ye	0
有子存焉	you'zi'cun'yan	0
欲报之于陛下也	yu'bao'zhi'yu'bi'xia'ye	0
予尝求古仁人之心	yu'chang'qiu'gu'ren'ren'zhi'xin	0
余常于土墙凹凸处	yu'chang'yu'tu'qiang'ao'tu'chu	0
与臣而将四矣	yu'chen'er'jiang'si'yi	0
欲出不得	yu'chu'bu'de	0
欲代子相	yu'dai'zi'xiang	0
欲得饮	yu'de'yin	0
余弟宗玄	yu'di'zong'xuan	0
予独爱莲之出淤泥而不染	yu'du'ai'lian'zhi'chu'yu'ni'er'bu'ran	0
与儿女讲论文义	yu'er'nv'jiang'lun'wen'yi	0
渔歌互答	yu'ge'hu'da	0
愚公移山	yu'gong'yi'shan	0
予观夫巴陵胜状	yu'guan'fu'ba'ling'sheng'zhuang	0
余寒犹厉	yu'han'you'li	0
于舅家见之	yu'jiu'jia'jian'zhi	0
余立侍左右	yu'li'shi'zuo'you	0
伛偻提携	yu'lv'ti'xie	0
与蒙论议	yu'meng'lun'yi	0
域民不以封疆之界	yu'min'bu'yi'feng'jiang'zhi'jie	0
寓逆旅	yu'ni'lv	0
余年幼	yu'nian'you	0
与朋友交而不信乎	yu'peng'you'jiao'er'bu'xin'hu	0
余强饮三大白而别	yu'qiang'yin'san'da'bai'er'bie	0
欲穷其林	yu'qiong'qi'lin	0
余人各复延至其家	yu'ren'ge'fu'yan'zhi'qi'jia	0
与人期行	yu'ren'qi'xing	0
渔人甚异之	yu'ren'shen'yi'zhi	0
余挐一小舟	yu'ru'yi'xiao'zhou	0
虞山王毅叔远甫刻	yu'shan'wang'yi'shu'yuan'fu'ke	0
逾时	yu'shi	0
于是宾客无不变色离席	yu'shi'bin'ke'wu'bu'bian'se'li'xi	0
于时冰皮始解	yu'shi'bing'pi'shi'jie	0
于是鸱得腐鼠	yu'shi'chi'de'fu'shu	0
于是惠子恐	yu'shi'hui'zi'kong	0
于是见公输盘	yu'shi'jian'gong'shu'pan	0
于是入朝见威王	yu'shi'ru'chao'jian'wei'wang	0
与世无别	yu'shi'wu'bie	0
于是与亮情好日密	yu'shi'yu'liang'qing'hao'ri'mi	0
于厅事之东北角	yu'ting'shi'zhi'dong'bei'jiao	0
予谓菊	yu'wei'ju	0
余闻之也久	yu'wen'zhi'ye'jiu	0
鱼我所欲也	yu'wo'suo'yu'ye	0
欲信大义于天下	yu'xin'da'yi'yu'tian'xia	0
寓言四则	yu'yan'si'ze	0
余忆童稚时	yu'yi'tong'zhi'shi	0
愚以为宫中之事	yu'yi'wei'gong'zhong'zhi'shi	0
愚以为营中之事	yu'yi'wei'ying'zhong'zhi'shi	0
余因得遍观群书	yu'yin'de'bian'guan'qun'shu	0
欲有求于我也	yu'you'qiu'yu'wo'ye	0
余幼时即嗜学	yu'you'shi'ji'shi'xue	0
郁郁青青	yu'yu'qing'qing	0
与余舟一芥	yu'yu'zhou'yi'jie	0
余则缊袍敝衣处其间	yu'ze'yun'pao'bi'yi'chu'qi'jian	0
余之游将自此始	yu'zhi'you'jiang'zi'ci'shi	0
余住西湖	yu'zhu'xi'hu	0
与朱元思书	yu'zhu'yuan'si'shu	0
与坐谈	yu'zuo'tan	0
愿陛下亲之信之	yuan'bi'xia'qin'zhi'xin'zhi	0
愿陛下托臣以讨贼兴复之效	yuan'bi'xia'tuo'chen'yi'tao'zei'xing'fu'zhi'xiao	0
鹓鶵过之	yuan'chu'guo'zhi	0
元方入门不顾	yuan'fang'ru'men'bu'gu	0
元方时年七岁	yuan'fang'shi'nian'qi'sui	0
元方曰	yuan'fang'yue	0
鸢飞戾天者	yuan'fei'li'tian'zhe	0
元丰六年十月十二日夜	yuan'feng'liu'nian'shi'yue'shi'er'ri'ye	0
袁宏道	yuan'hong'dao	0
愿借子杀之	yuan'jie'zi'sha'zhi	0
猿鸣三声泪沾裳	yuan'ming'san'sheng'lei'zhan'shang	0
猿鸟乱鸣	yuan'niao'luan'ming	0
缘溪行	yuan'xi'xing	0
远贤臣	yuan'xian'chen	0
远小人	yuan'xiao'ren	0
援疑质理	yuan'yi'zhi'li	0
猿则百叫无绝	yuan'ze'bai'jiao'wu'jue	0
愿终守之	yuan'zhong'shou'zhi	0
愿诸君勿复言	yuan'zhu'jun'wu'fu'yan	0
曰奉壹	yue'feng'yi	0
阅金经	yue'jin'jing	0
越明年	yue'ming'nian	0
月色入户	yue'se'ru'hu	0
曰恕己	yue'shu'ji	0
岳阳楼记	yue'yang'lou'ji	0
云归而岩穴暝	yun'gui'er'yan'xue'ming	0
杂然而前陈者	za'ran'er'qian'chen'zhe	0
杂然相许	za'ran'xiang'xu	0
杂曰	za'yue	0
再拜	zai'bai	0
在洞庭一湖	zai'dong'ting'yi'hu	0
再而衰	zai'er'shuai	0
在乎山水之间也	zai'hu'shan'shui'zhi'jian'ye	0
在宋城上而待楚寇矣	zai'song'cheng'shang'er'dai'chu'kou'yi	0
在昼犹昏	zai'zhou'you'hun	0
赞曰	zan'yue	0
造饮辄尽	zao'yin'zhe'jin	0
则黯然缥缈	ze'an'ran'piao'miao	0
则霸业可成	ze'ba'ye'ke'cheng	0
则凡可以得生者何不用也	ze'fan'ke'yi'de'sheng'zhe'he'bu'yong'ye	0
则凡可以辟患者何不为也	ze'fan'ke'yi'pi'huan'zhe'he'bu'wei'ye	0
则汉室之隆	ze'han'shi'zhi'long	0
则或千或百	ze'huo'qian'huo'bai	0
则明渐少	ze'ming'jian'shao	0
则名微而众寡	ze'ming'wei'er'zhong'gua	0
则命一上将将荆州之军以向宛洛	ze'ming'yi'shang'jiang'jiang'jing'zhou'zhi'jun'yi'xiang'wan'luo	0
择其善者而从之	ze'qi'shan'zhe'er'cong'zhi	0
则其受于人者不至也	ze'qi'shou'yu'ren'zhe'bu'zhi'ye	0
则是无礼	ze'shi'wu'li	0
则是无信	ze'shi'wu'xin	0
则素湍绿潭	ze'su'tuan'lv'tan	0
则题名其上	ze'ti'ming'qi'shang	0
则一舸无迹	ze'yi'ge'wu'ji	0
则右刻	ze'you'ke	0
则忧其君	ze'you'qi'jun	0
则又请焉	ze'you'qing'yan	0
则有去国怀乡	ze'you'qu'guo'huai'xiang	0
则有心旷神怡	ze'you'xin'kuang'shen'yi	0
则攸之祎允之任也	ze'you'zhi'yi'yun'zhi'ren'ye	0
则玉城雪岭际天而来	ze'yu'cheng'xue'ling'ji'tian'er'lai	0
则责攸之祎允等之慢	ze'ze'you'zhi'yi'yun'deng'zhi'man	0
则治臣之罪	ze'zhi'chen'zhi'zui	0
增其旧制	zeng'qi'jiu'zhi	0
曾子曰	zeng'zi'yue	0
宅边有五柳树	zhai'bian'you'wu'liu'shu	0
战必胜矣	zhan'bi'sheng'yi	0
战国策	zhan'guo'ce	0
战于长勺	zhan'yu'chang'shao	0
战则请从	zhan'ze'qing'cong	0
张岱	zhang'dai	0
张鲁在北	zhang'lu'zai'bei	0
朝晖夕阴	zhao'hui'xi'yin	0
召令徒属曰	zhao'ling'tu'shu'yue	0
浙江之潮	zhe'jiang'zhi'chao	0
者是也	zhe'shi'ye	0
震撼激射	zhen'han'ji'she	0
争而不得	zheng'er'bu'de	0
争高直指	zheng'gao'zhi'zhi	0
政通人和	zheng'tong'ren'he	0
争先鼓勇	zheng'xian'gu'yong	0
征于色发于声而后喻	zheng'yu'se'fa'yu'sheng'er'hou'yu	0
执策而临之	zhi'ce'er'lin'zhi	0
知而不争	zhi'er'bu'zheng	0
陟罚臧否	zhi'fa'zang'pi	0
直接霄汉	zhi'jie'xiao'han	0
止露尻尾	zhi'lu'kao'wei	0
志虑忠纯	zhi'lv'zhong'chun	0
至满井	zhi'man'jing	0
智能之士思得明君	zhi'neng'zhi'shi'si'de'ming'jun	0
置人所罾鱼腹中	zhi'ren'suo'zeng'yu'fu'zhong	0
至若春和景明	zhi'ruo'chun'he'jing'ming	0
至舍	zhi'she	0
直视无碍	zhi'shi'wu'ai	0
指通豫南	zhi'tong'yu'nan	0
止有剩骨	zhi'you'sheng'gu	0
至于负者歌于途	zhi'yu'fu'zhe'ge'yu'tu	0
至于今日	zhi'yu'jin'ri	0
至于夏水襄陵	zhi'yu'xia'shui'xiang'ling	0
至于斟酌损益	zhi'yu'zhen'zhuo'sun'yi	0
止增笑耳	zhi'zeng'xiao'er	0
知之为知之	zhi'zhi'wei'zhi'zhi	0
智子疑邻	zhi'zi'yi'lin	0
众宾欢也	zhong'bin'huan'ye	0
众宾团坐	zhong'bin'tuan'zuo	0
中峨冠而多髯者为东坡	zhong'e'guan'er'duo'ran'zhe'wei'dong'po	0
中间力拉崩倒之声	zhong'jian'li'la'beng'dao'zhi'sheng	0
众妙毕备	zhong'miao'bi'bei	0
中通外直	zhong'tong'wai'zhi	0
中无杂树	zhong'wu'za'shu	0
中轩敞者为舱	zhong'xuan'chang'zhe'wei'cang	0
仲永生五年	zhong'yong'sheng'wu'nian	0
仲永之通悟	zhong'yong'zhi'tong'wu	0
中有楼若者	zhong'you'lou'ruo'zhe	0
忠之属也	zhong'zhi'shu'ye	0
忠志之士忘身于外者	zhong'zhi'zhi'shi'wang'shen'yu'wai'zhe	0
周敦颐	zhou'dun'yi	0
周密	zhou'mi	0
舟首尾长约八分有奇	zhou'shou'wei'chang'yue'ba'fen'you'qi	0
舟尾横卧一楫	zhou'wei'heng'wo'yi'ji	0
舟中人两三粒而已	zhou'zhong'ren'liang'san'li'er'yi	0
舟子喃喃曰	zhou'zi'nan'nan'yue	0
诛暴秦	zhu'bao'qin	0
珠翠罗绮溢目	zhu'cui'luo'qi'yi'mu	0
诸葛孔明者	zhu'ge'kong'ming'zhe	0
诸葛亮	zhu'ge'liang	0
诸郡县苦秦吏者	zhu'jun'xian'ku'qin'li'zhe	0
珠可历历数也	zhu'ke'li'li'shu'ye	0
主人日再食	zhu'ren'ri'zai'shi	0
主上蒙尘	zhu'shang'meng'chen	0
转视积薪后	zhuan'shi'ji'xin'hou	0
壮有所用	zhuang'you'suo'yong	0
庄子	zhuang'zi	0
庄子来	zhuang'zi'lai	0
庄子往见之	zhuang'zi'wang'jian'zhi	0
庄子与惠子游于濠梁	zhuang'zi'yu'hui'zi'you'yu'hao'liang	0
庄子与惠子游于濠梁之上	zhuang'zi'yu'hui'zi'you'yu'hao'liang'zhi'shang	0
庄子曰	zhuang'zi'yue	0
缀行甚远	zhui'xing'shen'yuan	0
捉虾蟆	zhuo'ha'ma	0
浊浪排空	zhuo'lang'pai'kong	0
濯清涟而不妖	zhuo'qing'lian'er'bu'yao	0
咨臣以当世之事	zi'chen'yi'dang'shi'zhi'shi	0
自此	zi'ci	0
自董卓已来	zi'dong'zhuo'yi'lai	0
自非亭午夜分	zi'fei'ting'wu'ye'fen	0
子非我	zi'fei'wo	0
子非鱼	zi'fei'yu	0
自富阳至桐庐一百许里	zi'fu'yang'zhi'tong'lu'yi'bai'xu'li	0
子贡问曰	zi'gong'wen'yue	0
子固非鱼也	zi'gu'fei'yu'ye	0
子罕	zi'han	0
自既望以至十八日为盛	zi'ji'wang'yi'zhi'shi'ba'ri'wei'sheng	0
自康乐以来	zi'kang'le'yi'lai	0
自李唐来	zi'li'tang'lai	0
子墨子见王	zi'mo'zi'jian'wang	0
子墨子解带为城	zi'mo'zi'jie'dai'wei'cheng	0
子墨子九距之	zi'mo'zi'jiu'ju'zhi	0
子墨子起	zi'mo'zi'qi	0
子墨子闻之	zi'mo'zi'wen'zhi	0
子墨子亦曰	zi'mo'zi'yi'yue	0
子墨子曰	zi'mo'zi'yue	0
子墨子之守圉有余	zi'mo'zi'zhi'shou'yu'you'yu	0
自三峡七百里中	zi'san'xia'qi'bai'li'zhong	0
字涉	zi'she	0
自是指物作诗立就	zi'shi'zhi'wu'zuo'shi'li'jiu	0
字叔	zi'shu	0
自以为不如	zi'yi'wei'bu'ru	0
自以为大有所益	zi'yi'wei'da'you'suo'yi	0
子又生孙	zi'you'sheng'sun	0
子又有孙	zi'you'you'sun	0
子又有子	zi'you'you'zi	0
子曰	zi'yue	0
子曰汝安知鱼乐云者	zi'yue'ru'an'zhi'yu'le'yun'zhe	0
自云先世避秦时乱	zi'yun'xian'shi'bi'qin'shi'luan	0
子之不知鱼之乐全矣	zi'zhi'bu'zhi'yu'zhi'le'quan'yi	0
资治通鉴	zi'zhi'tong'jian	0
子知之乎	zi'zhi'zhi'hu	0
子子孙孙无穷匮也	zi'zi'sun'sun'wu'qiong'kui'ye	0
总揽英雄	zong'lan'ying'xiong	0
邹忌讽齐王纳谏	zou'ji'feng'qi'wang'na'jian	0
邹忌修八尺有余	zou'ji'xiu'ba'chi'you'yu	0
走送之	zou'song'zhi	0
足肤皲裂而不知	zu'fu'jun'lie'er'bu'zhi	0
卒获有所闻	zu'huo'you'suo'wen	0
卒皆夜惊恐	zu'jie'ye'jing'kong	0
卒买鱼烹食	zu'mai'yu'peng'shi	0
卒数万人	zu'shu'wan'ren	0
足下事皆成	zu'xia'shi'jie'cheng	0
卒之为众人	zu'zhi'wei'zhong'ren	0
醉能同其乐	zui'neng'tong'qi'le	0
醉翁亭记	zui'weng'ting'ji	0
醉翁亭也	zui'weng'ting'ye	0
醉翁之意不在酒	zui'weng'zhi'yi'bu'zai'jiu	0
尊君在不	zun'jun'zai'bu	0
左臂挂念珠倚之	zuo'bi'gua'nian'zhu'yi'zhi	0
左将军王凝之妻也	zuo'jiang'jun'wang'ning'zhi'qi'ye	0
左刻	zuo'ke	0
左佩刀	zuo'pei'dao	0
作青云白鹤观	zuo'qing'yun'bai'he'guan	0
左手抚炉	zuo'shou'fu'lu	0
左手抚鲁直背	zuo'shou'fu'lu'zhi'bei	0
左手倚一衡木	zuo'shou'yi'yi'heng'mu	0
坐潭上	zuo'tan'shang	0
作亭者谁	zuo'ting'zhe'shui	0
左右各四	zuo'you'ge'si	0
作则飞沙走砾	zuo'ze'fei'sha'zou'li	0
左传	zuo'zhuan	0
