八万天人八万贤圣众同游香水海中	ba'wan'tian'ren'ba'wan'xian'sheng'zhong'tong'you'xiang'shui'hai'zhong	0
白鸟忘饥任林间云去云来云来云去	bai'niao'wang'ji'ren'lin'jian'yun'qu'yun'lai'yun'lai'yun'qu	0
百千日月百千须弥卢不出莲花瓣里	bai'qian'ri'yue'bai'qian'xu'mi'lu'bu'chu'lian'hua'ban'li	0
半满真言参不漏	ban'man'zhen'yan'can'bu'lou	0
宝阁护香云静资礼梵	bao'ge'hu'xiang'yun'jing'zi'li'fan	0
碧水映诸天色即空空即色	bi'shui'ying'zhu'tian'se'ji'kong'kong'ji'se	0
不生不灭不垢净不增减度十方苦是名诸佛	bu'sheng'bu'mie'bu'gou'jing'bu'zeng'jian'du'shi'fang'ku'shi'ming'zhu'fo	0
不用三祗修福慧	bu'yong'san'zhi'xiu'fu'hui	0
阐第一宗风	chan'di'yi'zong'feng	0
潮声著树晚多风	chao'sheng'zhu'shu'wan'duo'feng	0
持名功夫贵在念念无间断	chi'ming'gong'fu'gui'zai'nian'nian'wu'jian'duan	0
持身正大不求佛佑佛自佑	chi'shen'zheng'da'bu'qiu'fo'you'fo'zi'you	0
处处无非菩提海	chu'chu'wu'fei'pu'ti'hai	0
初地总持超梵乘	chu'di'zong'chi'chao'fan'cheng	0
传大千法宝	chuan'da'qian'fa'bao	0
慈悲广大度有缘人	ci'bei'guang'da'du'you'yuan'ren	0
此地能同我坐练定性梧	ci'di'neng'tong'wo'zuo'lian'ding'xing'wu	0
此身不向今生度更向何生度此身	ci'shen'bu'xiang'jin'sheng'du'geng'xiang'he'sheng'du'ci'shen	0
翠翠殷殷处处花花果果	cui'cui'yin'yin'chu'chu'hua'hua'guo'guo	0
大畅如来度生胸怀	da'chang'ru'lai'du'sheng'xiong'huai	0
大大肚能容万物	da'da'du'neng'rong'wan'wu	0
大肚能容容天容地于己何所不容	da'du'neng'rong'rong'tian'rong'di'yu'ji'he'suo'bu'rong	0
大肚皮千人共见何所有何所不有	da'du'pi'qian'ren'gong'jian'he'suo'you'he'suo'bu'you	0
大护法不见僧过	da'hu'fa'bu'jian'seng'guo	0
大叩大鸣小叩小鸣普觉梦中之梦	da'kou'da'ming'xiao'kou'xiao'ming'pu'jue'meng'zhong'zhi'meng	0
但看百年后无论老少俱成灰	dan'kan'bai'nian'hou'wu'lun'lao'shao'ju'cheng'hui	0
但凭六字出乾坤	dan'ping'liu'zi'chu'qian'kun	0
当门等个人来望穿眼孔	dang'men'deng'ge'ren'lai'wang'chuan'yan'kong	0
到头囫囫囵囵活活泼泼便是如来	dao'tou'hu'hu'lun'lun'huo'huo'po'po'bian'shi'ru'lai	0
德行高尚令人频频闻妙香	de'xing'gao'shang'ling'ren'pin'pin'wen'miao'xiang	0
登九品直趋涅槃	deng'jiu'pin'zhi'qu'nie'pan	0
殿宇还雄宝相金容仍赫赫	dian'yu'hai'xiong'bao'xiang'jin'rong'reng'he'he	0
都摄六根净念相继	dou'she'liu'gen'jing'nian'xiang'ji	0
对物共春台幽风入咏	dui'wu'gong'chun'tai'you'feng'ru'yong	0
法华一部佛事百八振大机以警愚顽	fa'hua'yi'bu'fo'shi'bai'ba'zhen'da'ji'yi'jing'yu'wan	0
法界现神威即空即色	fa'jie'xian'shen'wei'ji'kong'ji'se	0
发落齿疏幻形凋谢实未足虑	fa'luo'chi'shu'huan'xing'diao'xie'shi'wei'zu'lv	0
发心为众生缘深入善权菩萨果	fa'xin'wei'zhong'sheng'yuan'shen'ru'shan'quan'pu'sa'guo	0
发一片慈心愿度众生达彼岸	fa'yi'pian'ci'xin'yuan'du'zhong'sheng'da'bi'an	0
法钟撞破麓峰云空空空空色空相空总是空空	fa'zhong'zhuang'po'lu'feng'yun'kong'kong'kong'kong'se'kong'xiang'kong'zong'shi'kong'kong	0
梵天增大力非住非行	fan'tian'zeng'da'li'fei'zhu'fei'xing	0
风风雨雨年年暮暮朝朝	feng'feng'yu'yu'nian'nian'mu'mu'zhao'zhao	0
风声水声钟鼓声声声入妙	feng'sheng'shui'sheng'zhong'gu'sheng'sheng'sheng'ru'miao	0
佛法僧稀世珍宝难遭遇	fo'fa'seng'xi'shi'zhen'bao'nan'zao'yu	0
佛云不可说不可说	fo'yun'bu'ke'shuo'bu'ke'shuo	0
佛在性中莫远求	fo'zai'xing'zhong'mo'yuan'qiu	0
富贵终如草上霜	fu'gui'zhong'ru'cao'shang'shuang	0
福慧庄严成无上道	fu'hui'zhuang'yan'cheng'wu'shang'dao	0
甘露湛湛润炎方	gan'lu'zhan'zhan'run'yan'fang	0
高登九品大愿方成	gao'deng'jiu'pin'da'yuan'fang'cheng	0
更有香风吹左右	geng'you'xiang'feng'chui'zuo'you	0
古刹有真如最庄严七层宝塔	gu'cha'you'zhen'ru'zui'zhuang'yan'qi'ceng'bao'ta	0
挂角何时偶为岭上主人犹想象千秋风度	gua'jiao'he'shi'ou'wei'ling'shang'zhu'ren'you'xiang'xiang'qian'qiu'feng'du	0
光中极尊佛中之王	guang'zhong'ji'zun'fo'zhong'zhi'wang	0
归程未了何能歇路为家	gui'cheng'wei'liao'he'neng'xie'lu'wei'jia	0
归依三宝得闻佛法欢喜无量	gui'yi'san'bao'de'wen'fo'fa'huan'xi'wu'liang	0
果号弥陀慈悲广大九品度众生威德无穷极	guo'hao'mi'tuo'ci'bei'guang'da'jiu'pin'du'zhong'sheng'wei'de'wu'qiong'ji	0
果有因因有果有果有因种甚因结甚果	guo'you'yin'yin'you'guo'you'guo'you'yin'zhong'shen'yin'jie'shen'guo	0
海气侵阶晴亦雨	hai'qi'qin'jie'qing'yi'yu	0
恒沙普演护祥轮	heng'sha'pu'yan'hu'xiang'lun	0
泓寺泓庙泓佛堂世界无二	hong'si'hong'miao'hong'fo'tang'shi'jie'wu'er	0
湖畔显灵大士婆心济拔三途苦	hu'pan'xian'ling'da'shi'po'xin'ji'ba'san'tu'ku	0
慧生于觉觉生于自在生生还是无生	hui'sheng'yu'jiao'jiao'sheng'yu'zi'zai'sheng'sheng'hai'shi'wu'sheng	0
及早作归计求生安养无量寿	ji'zao'zuo'gui'ji'qiu'sheng'an'yang'wu'liang'shou	0
见见见非见非见见非见	jian'jian'jian'fei'jian'fei'jian'jian'fei'jian	0
见了便做做了便放下了了有何不了	jian'le'bian'zuo'zuo'le'bian'fang'xia'le'le'you'he'bu'le	0
见桃犹记旧曾花	jian'tao'you'ji'jiu'ceng'hua	0
将净土教度有缘人	jiang'jing'tu'jiao'du'you'yuan'ren	0
戒定慧三无漏学真善美	jie'ding'hui'san'wu'lou'xue'zhen'shan'mei	0
金刚降魔护三宝	jin'gang'jiang'mo'hu'san'bao	0
金山挂月窥禅径	jin'shan'gua'yue'kui'chan'jing	0
竟能与羲卦麟经并垂宇宙	jing'neng'yu'xi'gua'lin'jing'bing'chui'yu'zhou	0
净土法门带业往生方便至极	jing'tu'fa'men'dai'ye'wang'sheng'fang'bian'zhi'ji	0
净土法门三根普被	jing'tu'fa'men'san'gen'pu'bei	0
净土法门稀有难值往生即成佛道	jing'tu'fa'men'xi'you'nan'zhi'wang'sheng'ji'cheng'fo'dao	0
净土莲开一花一佛一世界	jing'tu'lian'kai'yi'hua'yi'fo'yi'shi'jie	0
净宗即显说之密法	jing'zong'ji'xian'shuo'zhi'mi'fa	0
静坐常思己过	jing'zuo'chang'si'ji'guo	0
九界众生离求生净土上不能圆成佛道	jiu'jie'zhong'sheng'li'qiu'sheng'jing'tu'shang'bu'neng'yuan'cheng'fo'dao	0
九年面壁妙理悟三乘	jiu'nian'mian'bi'miao'li'wu'san'cheng	0
九品威令登彼岸	jiu'pin'wei'ling'deng'bi'an	0
举头欲问何许山中置我试管领乃树梅花	ju'tou'yu'wen'he'xu'shan'zhong'zhi'wo'shi'guan'ling'nai'shu'mei'hua	0
开口便笑笑古笑今凡事付之一笑	kai'kou'bian'xiao'xiao'gu'xiao'jin'fan'shi'fu'zhi'yi'xiao	0
开口笑几时休息无一言无一可言	kai'kou'xiao'ji'shi'xiu'xi'wu'yi'yan'wu'yi'ke'yan	0
看世间苦海无边唯有放下一切信愿持名求往生	kan'shi'jian'ku'hai'wu'bian'wei'you'fang'xia'yi'qie'xin'yuan'chi'ming'qiu'wang'sheng	0
来来如意见如来如见见如来	lai'lai'ru'yi'jian'ru'lai'ru'jian'jian'ru'lai	0
兰乾云护三摩峙	lan'qian'yun'hu'san'mo'zhi	0
老僧无障碍大供养一个庐山	lao'seng'wu'zhang'ai'da'gong'yang'yi'ge'lu'shan	0
礼敬慈尊三身圆现	li'jing'ci'zun'san'shen'yuan'xian	0
里面清清净净安安闲闲无非妙谛	li'mian'qing'qing'jing'jing'an'an'xian'xian'wu'fei'miao'di	0
离欲清净一心念佛	li'yu'qing'jing'yi'xin'nian'fo	0
莲如有脚花	lian'ru'you'jiao'hua	0
莲社独寻千载后	lian'she'du'xun'qian'zai'hou	0
林亭以外无世情	lin'ting'yi'wai'wu'shi'qing	0
灵峰呈寿相妙悦安禅	ling'feng'cheng'shou'xiang'miao'yue'an'chan	0
六波罗蜜施为首	liu'bo'luo'mi'shi'wei'shou	0
六根未净六欲未除听此间暮鼓晨钟说方便法	liu'gen'wei'jing'liu'yu'wei'chu'ting'ci'jian'mu'gu'chen'zhong'shuo'fang'bian'fa	0
六六玄峰翠耸光连万壑云	liu'liu'xuan'feng'cui'song'guang'lian'wan'he'yun	0
龙井茂青松群沾法雨	long'jing'mao'qing'song'qun'zhan'fa'yu	0
茫茫大地真真假假总成空	mang'mang'da'di'zhen'zhen'jia'jia'zong'cheng'kong	0
弥陀慈父建极乐世界何等庄严	mi'tuo'ci'fu'jian'ji'le'shi'jie'he'deng'zhuang'yan	0
弥陀慈光照大千	mi'tuo'ci'guang'zhao'da'qian	0
弥陀弘誓九界全收	mi'tuo'hong'shi'jiu'jie'quan'shou	0
弥陀宏誓九界全收其大无外	mi'tuo'hong'shi'jiu'jie'quan'shou'qi'da'wu'wai	0
迷则不觉觉则不迷好从大圆镜中照出本来面目	mi'ze'bu'jiao'jiao'ze'bu'mi'hao'cong'da'yuan'jing'zhong'zhao'chu'ben'lai'mian'mu	0
妙手空空一弹流水一弹月	miao'shou'kong'kong'yi'tan'liu'shui'yi'tan'yue	0
末法不念佛修行难有成	mo'fa'bu'nian'fo'xiu'xing'nan'you'cheng	0
末法修行净土为归方向正	mo'fa'xiu'xing'jing'tu'wei'gui'fang'xiang'zheng	0
牟尼珠现三摩三藐三菩提	mou'ni'zhu'xian'san'mo'san'miao'san'pu'ti	0
南海慈航渡来北楚	nan'hai'ci'hang'du'lai'bei'chu	0
南海莲花九品香	nan'hai'lian'hua'jiu'pin'xiang	0
内外原一体理交显而弥彰	nei'wai'yuan'yi'ti'li'jiao'xian'er'mi'zhang	0
能见弥陀佛往生才能有把握	neng'jian'mi'tuo'fo'wang'sheng'cai'neng'you'ba'wo	0
念佛可令烦恼无	nian'fo'ke'ling'fan'nao'wu	0
念佛速令登彼岸	nian'fo'su'ling'deng'bi'an	0
念佛为成佛之捷径	nian'fo'wei'cheng'fo'zhi'jie'jing	0
念念弥陀佛佛教观佛观自佛	nian'nian'mi'tuo'fo'fo'jiao'guan'fo'guan'zi'fo	0
平安胜过一切福	ping'an'sheng'guo'yi'qie'fu	0
菩提会菩提具大神通忽现千般千眼	pu'ti'hui'pu'ti'ju'da'shen'tong'hu'xian'qian'ban'qian'yan	0
七宝庄严现香界广轮遍诸吉祥	qi'bao'zhuang'yan'xian'xiang'jie'guang'lun'bian'zhu'ji'xiang	0
岐分相映流乃一	qi'fen'xiang'ying'liu'nai'yi	0
乾隆题承德普乐寺	qian'long'ti'cheng'de'pu'le'si	0
虔诵佛号万德齐彰	qian'song'fo'hao'wan'de'qi'zhang	0
切勿自我常卑视欲转命运多修心	qie'wu'zi'wo'chang'bei'shi'yu'zhuan'ming'yun'duo'xiu'xin	0
且喜身闲不属人	qie'xi'shen'xian'bu'shu'ren	0
切愿往生念念显妙明本心	qie'yuan'wang'sheng'nian'nian'xian'miao'ming'ben'xin	0
清华真佛地	qing'hua'zhen'fo'di	0
请看座上佛亦不过认得田自心来	qing'kan'zuo'shang'fo'yi'bu'guo'ren'de'tian'zi'xin'lai	0
清流潺潺人间胜地	qing'liu'chan'chan'ren'jian'sheng'di	0
青山无语看世上花开花落花落花开	qing'shan'wu'yu'kan'shi'shang'hua'kai'hua'luo'hua'luo'hua'kai	0
求福求慧求生净上	qiu'fu'qiu'hui'qiu'sheng'jing'shang	0
求生安养视信愿有无为决定	qiu'sheng'an'yang'shi'xin'yuan'you'wu'wei'jue'ding	0
求自在不自在知自在自然自在	qiu'zi'zai'bu'zi'zai'zhi'zi'zai'zi'ran'zi'zai	0
泉岩生翠竹普荫慈云	quan'yan'sheng'cui'zhu'pu'yin'ci'yun	0
人道贵道禽道兽道道道相传	ren'dao'gui'dao'qin'dao'shou'dao'dao'dao'xiang'chuan	0
人身难得今已得佛法难闻今已闻	ren'shen'nan'de'jin'yi'de'fo'fa'nan'wen'jin'yi'wen	0
人生无常转眼成空	ren'sheng'wu'chang'zhuan'yan'cheng'kong	0
人生犹似西山日	ren'sheng'you'si'xi'shan'ri	0
人生在世生死事大还不赶快念佛	ren'sheng'zai'shi'sheng'si'shi'da'hai'bu'gan'kuai'nian'fo	0
人生真谛何处寻	ren'sheng'zhen'di'he'chu'xun	0
人天路上作福为先	ren'tian'lu'shang'zuo'fu'wei'xian	0
人有缘度有难有因有果有菩提	ren'you'yuan'du'you'nan'you'yin'you'guo'you'pu'ti	0
如来所以兴出世	ru'lai'suo'yi'xing'chu'shi	0
如露如电如梦幻泡影都作如是现	ru'lu'ru'dian'ru'meng'huan'pao'ying'dou'zuo'ru'shi'xian	0
如能转念何须我大慈大悲	ru'neng'zhuan'nian'he'xu'wo'da'ci'da'bei	0
儒释本同源道并行而不悖	ru'shi'ben'tong'yuan'dao'bing'xing'er'bu'bei	0
如是如是故名如来	ru'shi'ru'shi'gu'ming'ru'lai	0
若不回头谁替你救苦救难	ruo'bu'hui'tou'shui'ti'ni'jiu'ku'jiu'nan	0
三藐三菩提三乘三觉悟生生世世法轮有幸现金身	san'miao'san'pu'ti'san'cheng'san'jue'wu'sheng'sheng'shi'shi'fa'lun'you'xing'xian'jin'shen	0
三摩印证喻恒河人天皆大欢喜	san'mo'yin'zheng'yu'heng'he'ren'tian'jie'da'huan'xi	0
三千界里问谁能安坐须弥	san'qian'jie'li'wen'shui'neng'an'zuo'xu'mi	0
三世三千佛	san'shi'san'qian'fo	0
色即是空空即是色却自真如界里证明无上菩提	se'ji'shi'kong'kong'ji'shi'se'que'zi'zhen'ru'jie'li'zheng'ming'wu'shang'pu'ti	0
色空妙谛证无遮	se'kong'miao'di'zheng'wu'zhe	0
色是空空是色莫教妄起念头	se'shi'kong'kong'shi'se'mo'jiao'wang'qi'nian'tou	0
沙鸟听经恋法门	sha'niao'ting'jing'lian'fa'men	0
山不在高佛有灵	shan'bu'zai'gao'fo'you'ling	0
山静尘清水参如是观	shan'jing'chen'qing'shui'can'ru'shi'guan	0
山前圣景莲瓣九品广渡诸有情	shan'qian'sheng'jing'lian'ban'jiu'pin'guang'du'zhu'you'qing	0
山色霭霭世外洞天	shan'se'ai'ai'shi'wai'dong'tian	0
山色水色烟霞色色色皆空	shan'se'shui'se'yan'xia'se'se'se'jie'kong	0
山山尽是普陀崖	shan'shan'jin'shi'pu'tuo'ya	0
山水之间有清契	shan'shui'zhi'jian'you'qing'qi	0
善心即是天心天心难合善心常在合天心	shan'xin'ji'shi'tian'xin'tian'xin'nan'he'shan'xin'chang'zai'he'tian'xin	0
善缘结缘福缘佛之妙缘	shan'yuan'jie'yuan'fu'yuan'fo'zhi'miao'yuan	0
善哉善哉即非善法	shan'zai'shan'zai'ji'fei'shan'fa	0
善知识常怀惭愧	shan'zhi'shi'chang'huai'can'kui	0
深信念佛句句是金刚般若	shen'xin'nian'fo'ju'ju'shi'jin'gang'bo're	0
生死海中念佛第一	sheng'si'hai'zhong'nian'fo'di'yi	0
十方善十方缘十方结果	shi'fang'shan'shi'fang'yuan'shi'fang'jie'guo	0
十方诸佛舍念佛法门下不能普利群萌	shi'fang'zhu'fo'she'nian'fo'fa'men'xia'bu'neng'pu'li'qun'meng	0
士何称大大经大法大慈悲	shi'he'cheng'da'da'jing'da'fa'da'ci'bei	0
时落钟声下界闻	shi'luo'zhong'sheng'xia'jie'wen	0
石山石洞石佛像天下第一	shi'shan'shi'dong'shi'fo'xiang'tian'xia'di'yi	0
世上虽有千般好	shi'shang'sui'you'qian'ban'hao	0
世外人法无定法然后知非法法也	shi'wai'ren'fa'wu'ding'fa'ran'hou'zhi'fei'fa'fa'ye	0
试问世间人有几个知道饭是米煮	shi'wen'shi'jian'ren'you'ji'ge'zhi'dao'fan'shi'mi'zhu	0
守清规说清话真是清闲	shou'qing'gui'shuo'qing'hua'zhen'shi'qing'xian	0
寿无量法无边无是无非无烦恼	shou'wu'liang'fa'wu'bian'wu'shi'wu'fei'wu'fan'nao	0
双双玉井碧澄冷浸千秋月	shuang'shuang'yu'jing'bi'cheng'leng'jin'qian'qiu'yue	0
水镜喻西来妙观如是	shui'jing'yu'xi'lai'miao'guan'ru'shi	0
水清月现玉盖尊严	shui'qing'yue'xian'yu'gai'zun'yan	0
朔漠风同万里绥	shuo'mo'feng'tong'wan'li'sui	0
似洞非洞适成仙洞	si'dong'fei'dong'shi'cheng'xian'dong	0
寺门深掩岭头云	si'men'shen'yan'ling'tou'yun	0
四十八愿度众生	si'shi'ba'yuan'du'zhong'sheng	0
似闻了义示原因	si'wen'le'yi'shi'yuan'yin	0
四无量心舍最高	si'wu'liang'xin'she'zui'gao	0
松柏犹吞六朝前	song'bai'you'tun'liu'chao'qian	0
松声竹声钟磬声声声自在	song'sheng'zhu'sheng'zhong'qing'sheng'sheng'sheng'zi'zai	0
俗务莫争须救燃眉之急	su'wu'mo'zheng'xu'jiu'ran'mei'zhi'ji	0
岁月不留情百年光阴转眼到	sui'yue'bu'liu'qing'bai'nian'guang'yin'zhuan'yan'dao	0
胎生卵生湿生化生生生不已	tai'sheng'luan'sheng'shi'sheng'hua'sheng'sheng'sheng'bu'yi	0
天道人道圣道谓之大道	tian'dao'ren'dao'sheng'dao'wei'zhi'da'dao	0
天高云浮月喻本来心	tian'gao'yun'fu'yue'yu'ben'lai'xin	0
天外楼台山外寺	tian'wai'lou'tai'shan'wai'si	0
天下事了犹未了何妨以不了了之	tian'xia'shi'liao'you'wei'liao'he'fang'yi'bu'liao'liao'zhi	0
同修道同修德同修成仙	tong'xiu'dao'tong'xiu'de'tong'xiu'cheng'xian	0
万法皆空归性海	wan'fa'jie'kong'gui'xing'hai	0
为人若要超三界	wei'ren'ruo'yao'chao'san'jie	0
为人为法为证菩提	wei'ren'wei'fa'wei'zheng'pu'ti	0
唯说弥陀本愿海	wei'shuo'mi'tuo'ben'yuan'hai	0
微微笑看破群生	wei'wei'xiao'kan'po'qun'sheng	0
唯依念佛得度生死	wei'yi'nian'fo'de'du'sheng'si	0
问君能有几多愁	wen'jun'neng'you'ji'duo'chou	0
闻闻闻不闻不闻闻不闻	wen'wen'wen'bu'wen'bu'wen'wen'bu'wen	0
我佛如来见一切众生皆大欢喜	wo'fo'ru'lai'jian'yi'qie'zhong'sheng'jie'da'huan'xi	0
五百年前我辈是同堂罗汉	wu'bai'nian'qian'wo'bei'shi'tong'tang'luo'han	0
无常就是苦诸法空幻悟者少	wu'chang'jiu'shi'ku'zhu'fa'kong'huan'wu'zhe'shao	0
悟如来想如来非如来如是如来	wu'ru'lai'xiang'ru'lai'fei'ru'lai'ru'shi'ru'lai	0
无我即如来	wu'wo'ji'ru'lai	0
无我无人无众生寿者皆以无为法	wu'wo'wu'ren'wu'zhong'sheng'shou'zhe'jie'yi'wu'wei'fa	0
无我无人无众生无寿者离一切相方见如来	wu'wo'wu'ren'wu'zhong'sheng'wu'shou'zhe'li'yi'qie'xiang'fang'jian'ru'lai	0
悟最澄明处内空外空	wu'zui'cheng'ming'chu'nei'kong'wai'kong	0
洗菜莫教流去叶	xi'cai'mo'jiao'liu'qu'ye	0
西方法雨洒遍东山	xi'fang'fa'yu'sa'bian'dong'shan	0
西方竹叶千年翠	xi'fang'zhu'ye'qian'nian'cui	0
现广长舌说法声震大千	xian'guang'chang'she'shuo'fa'sheng'zhen'da'qian	0
闲谈莫论人非	xian'tan'mo'lun'ren'fei	0
现相如三世佛了分身住曼殊床	xian'xiang'ru'san'shi'fo'le'fen'shen'zhu'man'shu'chuang	0
祥云蔼蔼来南海	xiang'yun'ai'ai'lai'nan'hai	0
消释三幡欲界色界无色界	xiao'shi'san'fan'yu'jie'se'jie'wu'se'jie	0
心存邪恶烧香拜佛有何益	xin'cun'xie'e'shao'xiang'bai'fo'you'he'yi	0
心到虔时佛有眼	xin'dao'qian'shi'fo'you'yan	0
信佛法迷津有岸朝夕勤撑宝筏净心念佛到彼岸	xin'fo'fa'mi'jin'you'an'zhao'xi'qin'cheng'bao'fa'jing'xin'nian'fo'dao'bi'an	0
信佛学佛不可离心心是佛之源	xin'fo'xue'fo'bu'ke'li'xin'xin'shi'fo'zhi'yuan	0
心即佛佛即心即心即佛欲求佛先求心	xin'ji'fo'fo'ji'xin'ji'xin'ji'fo'yu'qiu'fo'xian'qiu'xin	0
心即佛佛即心须要认清脚跟	xin'ji'fo'fo'ji'xin'xu'yao'ren'qing'jiao'gen	0
馨香赖久石钟湖水共悠悠	xin'xiang'lai'jiu'shi'zhong'hu'shui'gong'you'you	0
心心极乐天念佛佛念净性天	xin'xin'ji'le'tian'nian'fo'fo'nian'jing'xing'tian	0
心心极乐天天命酬天酬性天	xin'xin'ji'le'tian'tian'ming'chou'tian'chou'xing'tian	0
心有灵犀一点通	xin'you'ling'xi'yi'dian'tong	0
修道修仙先须修身身为道之本	xiu'dao'xiu'xian'xian'xu'xiu'shen'shen'wei'dao'zhi'ben	0
修德种因法身圆妙	xiu'de'zhong'yin'fa'shen'yuan'miao	0
修净土宝莲正行自度度人	xiu'jing'tu'bao'lian'zheng'xing'zi'du'du'ren	0
修清净养自性果然自在	xiu'qing'jing'yang'zi'xing'guo'ran'zi'zai	0
宣扬诸部大乘上乘最上乘	xuan'yang'zhu'bu'da'cheng'shang'cheng'zui'shang'cheng	0
学佛无般若如同盲者行	xue'fo'wu'bo're'ru'tong'mang'zhe'xing	0
扬般若波罗密多利国利民	yang'bo're'bo'luo'mi'duo'li'guo'li'min	0
也不是真也不是假愿天下痴男怨女作如是观	ye'bu'shi'zhen'ye'bu'shi'jia'yuan'tian'xia'chi'nan'yuan'nv'zuo'ru'shi'guan	0
一尘不染证禅心	yi'chen'bu'ran'zheng'chan'xin	0
一尘一劫波	yi'chen'yi'jie'bo	0
一花一世界一叶一如来色色空空妙相同参成佛国	yi'hua'yi'shi'jie'yi'ye'yi'ru'lai'se'se'kong'kong'miao'xiang'tong'can'cheng'fo'guo	0
以念佛心证无生忍	yi'nian'fo'xin'zheng'wu'sheng'ren	0
一切法门般若为导慧灯明	yi'qie'fa'men'bo're'wei'dao'hui'deng'ming	0
一切遵循因果律自有吉祥常随身	yi'qie'zun'xun'yin'guo'lv'zi'you'ji'xiang'chang'sui'shen	0
以清静果证因护持斯万	yi'qing'jing'guo'zheng'yin'hu'chi'si'wan	0
以深信愿持佛名号	yi'shen'xin'yuan'chi'fo'ming'hao	0
一声一佛千声千佛遥闻天外有天	yi'sheng'yi'fo'qian'sheng'qian'fo'yao'wen'tian'wai'you'tian	0
驿使暂停花下骑	yi'shi'zan'ting'hua'xia'qi	0
一苇渡江达源溯六祖	yi'wei'du'jiang'da'yuan'su'liu'zu	0
以一念而除众念	yi'yi'nian'er'chu'zhong'nian	0
印不即离间是相非相	yin'bu'ji'li'jian'shi'xiang'fei'xiang	0
音即是观观我观人观世界	yin'ji'shi'guan'guan'wo'guan'ren'guan'shi'jie	0
因名法藏誓愿宏深所建极乐国净妙世无双	yin'ming'fa'cang'shi'yuan'hong'shen'suo'jian'ji'le'guo'jing'miao'shi'wu'shuang	0
应不让元亭石室高峙岷峨	ying'bu'rang'yuan'ting'shi'shi'gao'zhi'min'e	0
有门无门是为佛门	you'men'wu'men'shi'wei'fo'men	0
有相皆虚妄	you'xiang'jie'xu'wang	0
有缘入佛门切莫宝山空手回	you'yuan'ru'fo'men'qie'mo'bao'shan'kong'shou'hui	0
余音袅袅半入江风半入云	yu'yin'niao'niao'ban'ru'jiang'feng'ban'ru'yun	0
圆满佛法以五戒十善为基础	yuan'man'fo'fa'yi'wu'jie'shi'shan'wei'ji'chu	0
愿人登福地王会成图	yuan'ren'deng'fu'di'wang'hui'cheng'tu	0
乐境大殊苦境苦境易离乐境早寻离苦境	yue'jing'da'shu'ku'jing'ku'jing'yi'li'yue'jing'zao'xun'li'ku'jing	0
月轮悟南指合相云何	yue'lun'wu'nan'zhi'he'xiang'yun'he	0
月色山色烟霞色色色皆空	yue'se'shan'se'yan'xia'se'se'se'jie'kong	0
云边钟鼓月边僧	yun'bian'zhong'gu'yue'bian'seng	0
运当亨处石能言	yun'dang'heng'chu'shi'neng'yan	0
云龛崇宝地来如见见如来	yun'kan'chong'bao'di'lai'ru'jian'jian'ru'lai	0
云霞西涌人间长见法轮新	yun'xia'xi'yong'ren'jian'chang'jian'fa'lun'xin	0
芸芸众生善善恶恶一杯土	yun'yun'zhong'sheng'shan'shan'wu'e'yi'bei'tu	0
在在自心观自在自观观自在	zai'zai'zi'xin'guan'zi'zai'zi'guan'guan'zi'zai	0
斋鱼敲落碧湖月觉觉觉觉先觉后觉无非觉觉	zhai'yu'qiao'luo'bi'hu'yue'jiao'jiao'jiao'jiao'xian'jue'hou'jue'wu'fei'jiao'jiao	0
照五蕴皆空行深般若观自在	zhao'wu'yun'jie'kong'xing'shen'bo're'guan'zi'zai	0
镇留岚气闲庭贮	zhen'liu'lan'qi'xian'ting'zhu	0
真为生死发菩提心	zhen'wei'sheng'si'fa'pu'ti'xin	0
竹是无心树	zhu'shi'wu'xin'shu	0
庄严古洞天	zhuang'yan'gu'dong'tian	0
紫气东来海上犹传天乐近	zi'qi'dong'lai'hai'shang'you'chuan'tian'le'jin	0
自性三宝即尔心	zi'xing'san'bao'ji'er'xin	0
子曰如之何如之何	zi'yue'ru'zhi'he'ru'zhi'he	0
自在观自在是真佛力总有慈念慈悲	zi'zai'guan'zi'zai'shi'zhen'fo'li'zong'you'ci'nian'ci'bei	0
自知性僻难谐俗	zi'zhi'xing'pi'nan'xie'su	0
宗镜圆照万善同归本教义而续慧命	zong'jing'yuan'zhao'wan'shan'tong'gui'ben'jiao'yi'er'xu'hui'ming	0
