阿坝州大草原旅行社	a'ba'zhou'da'cao'yuan'lv'xing'she	0
阿坝州高原旅行社	a'ba'zhou'gao'yuan'lv'xing'she	0
阿坝州黄龙旅行社	a'ba'zhou'huang'long'lv'xing'she	0
阿坝州交通旅行社	a'ba'zhou'jiao'tong'lv'xing'she	0
阿坝州九寨沟皇冠旅行社	a'ba'zhou'jiu'zhai'gou'huang'guan'lv'xing'she	0
阿坝州九寨沟交通旅行社	a'ba'zhou'jiu'zhai'gou'jiao'tong'lv'xing'she	0
阿坝州卡龙旅行社	a'ba'zhou'ka'long'lv'xing'she	0
阿坝州牟尼沟旅行社	a'ba'zhou'mou'ni'gou'lv'xing'she	0
阿坝州羌林旅行社	a'ba'zhou'qiang'lin'lv'xing'she	0
阿坝州羌寨旅行社	a'ba'zhou'qiang'zhai'lv'xing'she	0
阿坝州桥朕旅行社	a'ba'zhou'qiao'zhen'lv'xing'she	0
阿坝州温泉旅行社	a'ba'zhou'wen'quan'lv'xing'she	0
阿坝州鑫侨旅行社	a'ba'zhou'xin'qiao'lv'xing'she	0
安徽妇女旅行社	an'hui'fu'nv'lv'xing'she	0
安徽光辉旅行社	an'hui'guang'hui'lv'xing'she	0
安徽华夏国际旅行社	an'hui'hua'xia'guo'ji'lv'xing'she	0
安徽黄山职工国际旅行社	an'hui'huang'shan'zhi'gong'guo'ji'lv'xing'she	0
安徽九华山佛光旅行社	an'hui'jiu'hua'shan'fo'guang'lv'xing'she	0
安徽科技旅行社	an'hui'ke'ji'lv'xing'she	0
安徽联通旅行社	an'hui'lian'tong'lv'xing'she	0
安徽庐州旅行社	an'hui'lu'zhou'lv'xing'she	0
安徽潜山县天柱山中国旅行社	an'hui'qian'shan'xian'tian'zhu'shan'zhong'guo'lv'xing'she	0
安徽省池州中国旅行社	an'hui'sheng'chi'zhou'zhong'guo'lv'xing'she	0
安徽省黄山华夏国际旅行社	an'hui'sheng'huang'shan'hua'xia'guo'ji'lv'xing'she	0
安徽省黄山市春雨旅行社	an'hui'sheng'huang'shan'shi'chun'yu'lv'xing'she	0
安徽省九华山气象旅行社	an'hui'sheng'jiu'hua'shan'qi'xiang'lv'xing'she	0
安徽省潜山县洪都旅行社	an'hui'sheng'qian'shan'xian'hong'du'lv'xing'she	0
安徽省潜山县天柱山天龙旅行社	an'hui'sheng'qian'shan'xian'tian'zhu'shan'tian'long'lv'xing'she	0
安徽省外贸国际旅行社	an'hui'sheng'wai'mao'guo'ji'lv'xing'she	0
安徽省新世纪旅行社	an'hui'sheng'xin'shi'ji'lv'xing'she	0
安徽省中国旅行社	an'hui'sheng'zhong'guo'lv'xing'she	0
安徽石台牯牛降旅行社	an'hui'shi'tai'gu'niu'jiang'lv'xing'she	0
安徽舒城万佛湖蓬达旅行社	an'hui'shu'cheng'wan'fo'hu'peng'da'lv'xing'she	0
安徽顺达旅行社	an'hui'shun'da'lv'xing'she	0
安徽四方旅行社	an'hui'si'fang'lv'xing'she	0
安徽天柱山大昌旅行社	an'hui'tian'zhu'shan'da'chang'lv'xing'she	0
安徽天柱山绿色旅行社	an'hui'tian'zhu'shan'lv'se'lv'xing'she	0
安徽铁路旅行社	an'hui'tie'lu'lv'xing'she	0
安徽外贸国际旅行社	an'hui'wai'mao'guo'ji'lv'xing'she	0
安吉旅行社	an'ji'lv'xing'she	0
鞍山报业旅行社	an'shan'bao'ye'lv'xing'she	0
鞍山钢花旅行社	an'shan'gang'hua'lv'xing'she	0
鞍山广视新闻旅行社	an'shan'guang'shi'xin'wen'lv'xing'she	0
鞍山凯维腾旅行社	an'shan'kai'wei'teng'lv'xing'she	0
鞍山青年旅行社	an'shan'qing'nian'lv'xing'she	0
鞍山市慈航旅行社	an'shan'shi'ci'hang'lv'xing'she	0
鞍山市九洲旅行社	an'shan'shi'jiu'zhou'lv'xing'she	0
鞍山市瑞鑫旅行社	an'shan'shi'rui'xin'lv'xing'she	0
鞍山市神洲旅行社	an'shan'shi'shen'zhou'lv'xing'she	0
鞍山市缘圆旅行社	an'shan'shi'yuan'yuan'lv'xing'she	0
鞍山阳光旅行社	an'shan'yang'guang'lv'xing'she	0
鞍山玉佛国际旅行社	an'shan'yu'fo'guo'ji'lv'xing'she	0
鞍山缘圆旅行社	an'shan'yuan'yuan'lv'xing'she	0
安溪县中国旅行社	an'xi'xian'zhong'guo'lv'xing'she	0
巴东县神农溪旅行社	ba'dong'xian'shen'nong'xi'lv'xing'she	0
八方旅行社	ba'fang'lv'xing'she	0
霸州市神舟旅行社	ba'zhou'shi'shen'zhou'lv'xing'she	0
百色飞扬旅行社	bai'se'fei'yang'lv'xing'she	0
百色市百之旅旅行社	bai'se'shi'bai'zhi'lv'lv'xing'she	0
百色铁路旅行社	bai'se'tie'lu'lv'xing'she	0
白塔旅行社	bai'ta'lv'xing'she	0
白云小汽车出租公司康乐旅行社	bai'yun'xiao'qi'che'chu'zu'gong'si'kang'le'lv'xing'she	0
版纳旅行社	ban'na'lv'xing'she	0
宝钢集团国际旅行社	bao'gang'ji'tuan'guo'ji'lv'xing'she	0
宝鸡春晖旅行社	bao'ji'chun'hui'lv'xing'she	0
宝鸡金色假日旅行社	bao'ji'jin'se'jia'ri'lv'xing'she	0
宝鸡旅行社	bao'ji'lv'xing'she	0
宝鸡铁路旅行社	bao'ji'tie'lu'lv'xing'she	0
宝鸡通程旅行社	bao'ji'tong'cheng'lv'xing'she	0
保铁旅行社	bao'tie'lv'xing'she	0
宝应县环球旅行社	bao'ying'xian'huan'qiu'lv'xing'she	0
北奥国际旅行社	bei'ao'guo'ji'lv'xing'she	0
北戴河长城假日旅行社	bei'dai'he'chang'cheng'jia'ri'lv'xing'she	0
北戴河金海旅行社	bei'dai'he'jin'hai'lv'xing'she	0
北戴河新东方旅行社	bei'dai'he'xin'dong'fang'lv'xing'she	0
北戴河中海旅行社	bei'dai'he'zhong'hai'lv'xing'she	0
贝尔集团海拉尔旅行社	bei'er'ji'tuan'hai'la'er'lv'xing'she	0
北方国际旅行社	bei'fang'guo'ji'lv'xing'she	0
北海北云旅行社	bei'hai'bei'yun'lv'xing'she	0
北海城市旅行社	bei'hai'cheng'shi'lv'xing'she	0
北海健力宝国际旅行社	bei'hai'jian'li'bao'guo'ji'lv'xing'she	0
北海利进达旅行社	bei'hai'li'jin'da'lv'xing'she	0
北海南国国际旅行社	bei'hai'nan'guo'guo'ji'lv'xing'she	0
北海赛利曼旅行社	bei'hai'sai'li'man'lv'xing'she	0
北海神州旅行社	bei'hai'shen'zhou'lv'xing'she	0
北海市海珠旅行社	bei'hai'shi'hai'zhu'lv'xing'she	0
北海市健力宝旅行社	bei'hai'shi'jian'li'bao'lv'xing'she	0
北海市金桥旅行社	bei'hai'shi'jin'qiao'lv'xing'she	0
北海石林旅行社	bei'hai'shi'lin'lv'xing'she	0
北海市青年国际旅行社	bei'hai'shi'qing'nian'guo'ji'lv'xing'she	0
北海市中国旅行社	bei'hai'shi'zhong'guo'lv'xing'she	0
北海体育旅行社	bei'hai'ti'yu'lv'xing'she	0
北海天马旅行社	bei'hai'tian'ma'lv'xing'she	0
北海西铁旅行社	bei'hai'xi'tie'lv'xing'she	0
北海银海旅行社	bei'hai'yin'hai'lv'xing'she	0
北海中鼎假期旅行社	bei'hai'zhong'ding'jia'qi'lv'xing'she	0
北海珠峰旅行社	bei'hai'zhu'feng'lv'xing'she	0
北京爱思旅行社	bei'jing'ai'si'lv'xing'she	0
北京奥利富国际旅行社	bei'jing'ao'li'fu'guo'ji'lv'xing'she	0
北京百龙旅行社	bei'jing'bai'long'lv'xing'she	0
北京北分龙旅行社	bei'jing'bei'fen'long'lv'xing'she	0
北京碧峰旅行社	bei'jing'bi'feng'lv'xing'she	0
北京滨河旅行社	bei'jing'bin'he'lv'xing'she	0
北京长城国际旅行社	bei'jing'chang'cheng'guo'ji'lv'xing'she	0
北京朝阳国际旅行社	bei'jing'chao'yang'guo'ji'lv'xing'she	0
北京诚信旅行社	bei'jing'cheng'xin'lv'xing'she	0
北京城苑旅行社	bei'jing'cheng'yuan'lv'xing'she	0
北京春畅旅行社	bei'jing'chun'chang'lv'xing'she	0
北京春秋国际旅行社	bei'jing'chun'qiu'guo'ji'lv'xing'she	0
北京大潮旅行社	bei'jing'da'chao'lv'xing'she	0
北京大公假日旅行社	bei'jing'da'gong'jia'ri'lv'xing'she	0
北京大观园旅行社	bei'jing'da'guan'yuan'lv'xing'she	0
北京德生源旅行社	bei'jing'de'sheng'yuan'lv'xing'she	0
北京东城北华旅行社	bei'jing'dong'cheng'bei'hua'lv'xing'she	0
北京东方人旅行社	bei'jing'dong'fang'ren'lv'xing'she	0
北京东方亚林旅行社	bei'jing'dong'fang'ya'lin'lv'xing'she	0
北京东华国际旅行社	bei'jing'dong'hua'guo'ji'lv'xing'she	0
北京东日旅行社	bei'jing'dong'ri'lv'xing'she	0
北京东卫旅行社	bei'jing'dong'wei'lv'xing'she	0
北京法国中欧旅行社	bei'jing'fa'guo'zhong'ou'lv'xing'she	0
北京飞扬旅行社	bei'jing'fei'yang'lv'xing'she	0
北京风光旅行社	bei'jing'feng'guang'lv'xing'she	0
北京枫林旅行社	bei'jing'feng'lin'lv'xing'she	0
北京风情国际旅行社	bei'jing'feng'qing'guo'ji'lv'xing'she	0
北京富莱菌国际旅行社	bei'jing'fu'lai'jun'guo'ji'lv'xing'she	0
北京福星旅行社	bei'jing'fu'xing'lv'xing'she	0
北京古关旅行社	bei'jing'gu'guan'lv'xing'she	0
北京光正旅行社	bei'jing'guang'zheng'lv'xing'she	0
北京国旅金色假日旅行社	bei'jing'guo'lv'jin'se'jia'ri'lv'xing'she	0
北京海洋国际旅行社	bei'jing'hai'yang'guo'ji'lv'xing'she	0
北京海运旅行社	bei'jing'hai'yun'lv'xing'she	0
北京好时旅行社	bei'jing'hao'shi'lv'xing'she	0
北京好友旅行社	bei'jing'hao'you'lv'xing'she	0
北京好运旅行社	bei'jing'hao'yun'lv'xing'she	0
北京华安国际旅行社	bei'jing'hua'an'guo'ji'lv'xing'she	0
北京华都国际旅行社	bei'jing'hua'dou'guo'ji'lv'xing'she	0
北京华航旅行社	bei'jing'hua'hang'lv'xing'she	0
北京华茂旅行社	bei'jing'hua'mao'lv'xing'she	0
北京华强旅行社	bei'jing'hua'qiang'lv'xing'she	0
北京华仁旅行社	bei'jing'hua'ren'lv'xing'she	0
北京华商国际旅行社	bei'jing'hua'shang'guo'ji'lv'xing'she	0
北京华通旅行社	bei'jing'hua'tong'lv'xing'she	0
北京华闻国际旅行社	bei'jing'hua'wen'guo'ji'lv'xing'she	0
北京环球商务国际旅行社	bei'jing'huan'qiu'shang'wu'guo'ji'lv'xing'she	0
北京环球文化旅行社	bei'jing'huan'qiu'wen'hua'lv'xing'she	0
北京环游旅行社	bei'jing'huan'you'lv'xing'she	0
北京寰宇国际旅行社	bei'jing'huan'yu'guo'ji'lv'xing'she	0
北京皇冠艺苑旅行社	bei'jing'huang'guan'yi'yuan'lv'xing'she	0
北京吉顺旅行社	bei'jing'ji'shun'lv'xing'she	0
北京江河国际旅行社	bei'jing'jiang'he'guo'ji'lv'xing'she	0
北京教工假日旅行社	bei'jing'jiao'gong'jia'ri'lv'xing'she	0
北京教育旅行社	bei'jing'jiao'yu'lv'xing'she	0
北京金帆旅行社	bei'jing'jin'fan'lv'xing'she	0
北京金汇旅行社	bei'jing'jin'hui'lv'xing'she	0
北京金良假日旅行社	bei'jing'jin'liang'jia'ri'lv'xing'she	0
北京金路旅行社	bei'jing'jin'lu'lv'xing'she	0
北京金渠旅行社	bei'jing'jin'qu'lv'xing'she	0
北京金融旅行社	bei'jing'jin'rong'lv'xing'she	0
北京金台国际旅行社	bei'jing'jin'tai'guo'ji'lv'xing'she	0
北京金五联旅行社	bei'jing'jin'wu'lian'lv'xing'she	0
北京金翔旅行社	bei'jing'jin'xiang'lv'xing'she	0
北京京怀旅行社	bei'jing'jing'huai'lv'xing'she	0
北京京龙旅行社	bei'jing'jing'long'lv'xing'she	0
北京九江泰旅行社	bei'jing'jiu'jiang'tai'lv'xing'she	0
北京菊园文化旅行社	bei'jing'ju'yuan'wen'hua'lv'xing'she	0
北京凯立达旅行社	bei'jing'kai'li'da'lv'xing'she	0
北京开鑫旅行社	bei'jing'kai'xin'lv'xing'she	0
北京康复国际旅行社	bei'jing'kang'fu'guo'ji'lv'xing'she	0
北京科学国际旅行社	bei'jing'ke'xue'guo'ji'lv'xing'she	0
北京蓝宝石旅行社	bei'jing'lan'bao'shi'lv'xing'she	0
北京蓝谷旅行社	bei'jing'lan'gu'lv'xing'she	0
北京蓝天国际旅行社	bei'jing'lan'tian'guo'ji'lv'xing'she	0
北京蓝雅信旅行社	bei'jing'lan'ya'xin'lv'xing'she	0
北京老年旅行社	bei'jing'lao'nian'lv'xing'she	0
北京利康旅行社	bei'jing'li'kang'lv'xing'she	0
北京联航旅行社	bei'jing'lian'hang'lv'xing'she	0
北京流芳旅行社	bei'jing'liu'fang'lv'xing'she	0
北京隆福旅行社	bei'jing'long'fu'lv'xing'she	0
北京路易通旅行社	bei'jing'lu'yi'tong'lv'xing'she	0
北京旅游学院国际旅行社	bei'jing'lv'you'xue'yuan'guo'ji'lv'xing'she	0
北京旅游学院旅行社	bei'jing'lv'you'xue'yuan'lv'xing'she	0
北京绿洲旅行社	bei'jing'lv'zhou'lv'xing'she	0
北京漫游旅行社	bei'jing'man'you'lv'xing'she	0
北京茂发国际旅行社	bei'jing'mao'fa'guo'ji'lv'xing'she	0
北京美景凯悦旅行社	bei'jing'mei'jing'kai'yue'lv'xing'she	0
北京梦幻旅行社	bei'jing'meng'huan'lv'xing'she	0
北京名伦旅行社	bei'jing'ming'lun'lv'xing'she	0
北京农民旅行社	bei'jing'nong'min'lv'xing'she	0
北京沛达旅行社	bei'jing'pei'da'lv'xing'she	0
北京七星旅行社	bei'jing'qi'xing'lv'xing'she	0
北京清华园旅行社	bei'jing'qing'hua'yuan'lv'xing'she	0
北京求实旅行社	bei'jing'qiu'shi'lv'xing'she	0
北京瑞驰国际旅行社	bei'jing'rui'chi'guo'ji'lv'xing'she	0
北京赛特国际旅行社	bei'jing'sai'te'guo'ji'lv'xing'she	0
北京商务旅行社	bei'jing'shang'wu'lv'xing'she	0
北京神农国际旅行社	bei'jing'shen'nong'guo'ji'lv'xing'she	0
北京圣发旅行社	bei'jing'sheng'fa'lv'xing'she	0
北京市北达旅行社	bei'jing'shi'bei'da'lv'xing'she	0
北京市昌平温泉保健旅行社	bei'jing'shi'chang'ping'wen'quan'bao'jian'lv'xing'she	0
北京市崇文旅行社	bei'jing'shi'chong'wen'lv'xing'she	0
北京市房山北斗旅行社	bei'jing'shi'fang'shan'bei'dou'lv'xing'she	0
北京市非凡之旅旅行社	bei'jing'shi'fei'fan'zhi'lv'lv'xing'she	0
北京市鸿运旅行社	bei'jing'shi'hong'yun'lv'xing'she	0
北京世纪商务国际旅行社	bei'jing'shi'ji'shang'wu'guo'ji'lv'xing'she	0
北京市京育旅行社	bei'jing'shi'jing'yu'lv'xing'she	0
北京市蓝剑旅行社	bei'jing'shi'lan'jian'lv'xing'she	0
北京市乐平旅行社	bei'jing'shi'le'ping'lv'xing'she	0
北京市良友旅行社	bei'jing'shi'liang'you'lv'xing'she	0
北京市旅行社	bei'jing'shi'lv'xing'she	0
北京市侨丰旅行社	bei'jing'shi'qiao'feng'lv'xing'she	0
北京市三叶旅行社	bei'jing'shi'san'ye'lv'xing'she	0
北京市商友旅行社	bei'jing'shi'shang'you'lv'xing'she	0
北京市首都旅行社	bei'jing'shi'shou'du'lv'xing'she	0
北京市羲和旅行社	bei'jing'shi'xi'he'lv'xing'she	0
北京市香山国际旅行社	bei'jing'shi'xiang'shan'guo'ji'lv'xing'she	0
北京市信泰旅行社	bei'jing'shi'xin'tai'lv'xing'she	0
北京市燕都国际旅行社	bei'jing'shi'yan'dou'guo'ji'lv'xing'she	0
北京市燕京国际旅行社	bei'jing'shi'yan'jing'guo'ji'lv'xing'she	0
北京市燕翔国际旅行社	bei'jing'shi'yan'xiang'guo'ji'lv'xing'she	0
北京市中国旅行社	bei'jing'shi'zhong'guo'lv'xing'she	0
北京市中侨国际旅行社	bei'jing'shi'zhong'qiao'guo'ji'lv'xing'she	0
北京双花园旅行社	bei'jing'shuang'hua'yuan'lv'xing'she	0
北京顺风旅行社	bei'jing'shun'feng'lv'xing'she	0
北京烁舟旅行社	bei'jing'shuo'zhou'lv'xing'she	0
北京四季旅行社	bei'jing'si'ji'lv'xing'she	0
北京太行旅行社	bei'jing'tai'hang'lv'xing'she	0
北京陶然羊城旅行社	bei'jing'tao'ran'yang'cheng'lv'xing'she	0
北京天地通达旅行社	bei'jing'tian'di'tong'da'lv'xing'she	0
北京天和旅行社	bei'jing'tian'he'lv'xing'she	0
北京天虹旅行社	bei'jing'tian'hong'lv'xing'she	0
北京天健旅行社	bei'jing'tian'jian'lv'xing'she	0
北京天伦天乐旅行社	bei'jing'tian'lun'tian'le'lv'xing'she	0
北京天马旅行社	bei'jing'tian'ma'lv'xing'she	0
北京天翔国际旅行社	bei'jing'tian'xiang'guo'ji'lv'xing'she	0
北京天作旅行社	bei'jing'tian'zuo'lv'xing'she	0
北京铁道部华铁龙旅行社	bei'jing'tie'dao'bu'hua'tie'long'lv'xing'she	0
北京铁路国际旅行社	bei'jing'tie'lu'guo'ji'lv'xing'she	0
北京铁路旅行社	bei'jing'tie'lu'lv'xing'she	0
北京铁路椰海国际旅行社	bei'jing'tie'lu'ye'hai'guo'ji'lv'xing'she	0
北京通四方旅行社	bei'jing'tong'si'fang'lv'xing'she	0
北京外航国际旅行社	bei'jing'wai'hang'guo'ji'lv'xing'she	0
北京万里国际旅行社	bei'jing'wan'li'guo'ji'lv'xing'she	0
北京王府国际旅行社	bei'jing'wang'fu'guo'ji'lv'xing'she	0
北京维多利旅行社	bei'jing'wei'duo'li'lv'xing'she	0
北京文化旅行社	bei'jing'wen'hua'lv'xing'she	0
北京五联旅行社	bei'jing'wu'lian'lv'xing'she	0
北京五洲假日旅行社	bei'jing'wu'zhou'jia'ri'lv'xing'she	0
北京西藏神湖旅行社	bei'jing'xi'zang'shen'hu'lv'xing'she	0
北京先科旅行社	bei'jing'xian'ke'lv'xing'she	0
北京新都国际旅行社	bei'jing'xin'du'guo'ji'lv'xing'she	0
北京鑫海国际旅行社	bei'jing'xin'hai'guo'ji'lv'xing'she	0
北京新侨旅行社	bei'jing'xin'qiao'lv'xing'she	0
北京新日国际旅行社	bei'jing'xin'ri'guo'ji'lv'xing'she	0
北京新泰隆旅行社	bei'jing'xin'tai'long'lv'xing'she	0
北京新天地旅行社	bei'jing'xin'tian'di'lv'xing'she	0
北京星辰方舟国际旅行社	bei'jing'xing'chen'fang'zhou'guo'ji'lv'xing'she	0
北京兴起旅行社	bei'jing'xing'qi'lv'xing'she	0
北京亚泰假日旅行社	bei'jing'ya'tai'jia'ri'lv'xing'she	0
北京燕翔国际旅行社	bei'jing'yan'xiang'guo'ji'lv'xing'she	0
北京扬帆旅行社	bei'jing'yang'fan'lv'xing'she	0
北京阳光绿洲旅行社	bei'jing'yang'guang'lv'zhou'lv'xing'she	0
北京怡安国际旅行社	bei'jing'yi'an'guo'ji'lv'xing'she	0
北京怡乐假期旅行社	bei'jing'yi'le'jia'qi'lv'xing'she	0
北京益友旅行社	bei'jing'yi'you'lv'xing'she	0
北京银海旅行社	bei'jing'yin'hai'lv'xing'she	0
北京邮电国际旅行社	bei'jing'you'dian'guo'ji'lv'xing'she	0
北京友朋国际旅行社	bei'jing'you'peng'guo'ji'lv'xing'she	0
北京友商旅行社	bei'jing'you'shang'lv'xing'she	0
北京友协国际旅行社	bei'jing'you'xie'guo'ji'lv'xing'she	0
北京育翔旅行社	bei'jing'yu'xiang'lv'xing'she	0
北京远方假日旅行社	bei'jing'yuan'fang'jia'ri'lv'xing'she	0
北京云龙旅行社	bei'jing'yun'long'lv'xing'she	0
北京职教旅行社	bei'jing'zhi'jiao'lv'xing'she	0
北京中包国际旅行社	bei'jing'zhong'bao'guo'ji'lv'xing'she	0
北京中北国际旅行社	bei'jing'zhong'bei'guo'ji'lv'xing'she	0
北京中电国际旅行社	bei'jing'zhong'dian'guo'ji'lv'xing'she	0
北京中纺旅行社	bei'jing'zhong'fang'lv'xing'she	0
北京中钢国际旅行社	bei'jing'zhong'gang'guo'ji'lv'xing'she	0
北京中国国际旅行社	bei'jing'zhong'guo'guo'ji'lv'xing'she	0
北京中国航空国际旅行社	bei'jing'zhong'guo'hang'kong'guo'ji'lv'xing'she	0
北京中国虹桥旅行社	bei'jing'zhong'guo'hong'qiao'lv'xing'she	0
北京中国华运旅行社	bei'jing'zhong'guo'hua'yun'lv'xing'she	0
北京中国教育国际旅行社	bei'jing'zhong'guo'jiao'yu'guo'ji'lv'xing'she	0
北京中国金叶国际旅行社	bei'jing'zhong'guo'jin'ye'guo'ji'lv'xing'she	0
北京中国旅行社	bei'jing'zhong'guo'lv'xing'she	0
北京中国森林国际旅行社	bei'jing'zhong'guo'sen'lin'guo'ji'lv'xing'she	0
北京中国太和旅行社	bei'jing'zhong'guo'tai'he'lv'xing'she	0
北京中国锡华国际旅行社	bei'jing'zhong'guo'xi'hua'guo'ji'lv'xing'she	0
北京中海国际旅行社	bei'jing'zhong'hai'guo'ji'lv'xing'she	0
北京中环国际旅行社	bei'jing'zhong'huan'guo'ji'lv'xing'she	0
北京中汇国际旅行社	bei'jing'zhong'hui'guo'ji'lv'xing'she	0
北京中佳国际合作旅行社	bei'jing'zhong'jia'guo'ji'he'zuo'lv'xing'she	0
北京中建红蜻蜓国际旅行社	bei'jing'zhong'jian'hong'qing'ting'guo'ji'lv'xing'she	0
北京中旅首都旅行社	bei'jing'zhong'lv'shou'du'lv'xing'she	0
北京中旅现代旅行社	bei'jing'zhong'lv'xian'dai'lv'xing'she	0
北京中汽德宝旅行社	bei'jing'zhong'qi'de'bao'lv'xing'she	0
北京中侨国际旅行社	bei'jing'zhong'qiao'guo'ji'lv'xing'she	0
北京中商国际旅行社	bei'jing'zhong'shang'guo'ji'lv'xing'she	0
北京中食文化旅行社	bei'jing'zhong'shi'wen'hua'lv'xing'she	0
北京中天旅行社	bei'jing'zhong'tian'lv'xing'she	0
北京中通旅行社	bei'jing'zhong'tong'lv'xing'she	0
北京中卫国际旅行社	bei'jing'zhong'wei'guo'ji'lv'xing'she	0
北京中亚旅行社	bei'jing'zhong'ya'lv'xing'she	0
北京中艺国际旅行社	bei'jing'zhong'yi'guo'ji'lv'xing'she	0
北京中谊国际旅行社	bei'jing'zhong'yi'guo'ji'lv'xing'she	0
北京中银燕旅行社	bei'jing'zhong'yin'yan'lv'xing'she	0
北京中远国际旅行社	bei'jing'zhong'yuan'guo'ji'lv'xing'she	0
北京中远华通旅行社	bei'jing'zhong'yuan'hua'tong'lv'xing'she	0
北京洲际假日旅行社	bei'jing'zhou'ji'jia'ri'lv'xing'she	0
北京纵横国际旅行社	bei'jing'zong'heng'guo'ji'lv'xing'she	0
北琴海旅行社	bei'qin'hai'lv'xing'she	0
本溪水洞国际旅行社	ben'xi'shui'dong'guo'ji'lv'xing'she	0
冰玉洞旅行社	bing'yu'dong'lv'xing'she	0
苍南县旅行社	cang'nan'xian'lv'xing'she	0
沧州阳光国际旅行社	cang'zhou'yang'guang'guo'ji'lv'xing'she	0
茶苑旅行社	cha'yuan'lv'xing'she	0
长城旅行社	chang'cheng'lv'xing'she	0
长春市海鸥旅行社	chang'chun'shi'hai'ou'lv'xing'she	0
长春市中国旅行社	chang'chun'shi'zhong'guo'lv'xing'she	0
长春铁路旅行社	chang'chun'tie'lu'lv'xing'she	0
长岛旅行社	chang'dao'lv'xing'she	0
常德风光旅行社	chang'de'feng'guang'lv'xing'she	0
常德假日旅行社	chang'de'jia'ri'lv'xing'she	0
常德市德海旅行社	chang'de'shi'de'hai'lv'xing'she	0
常德市客运旅行社	chang'de'shi'ke'yun'lv'xing'she	0
常德铁道旅行社	chang'de'tie'dao'lv'xing'she	0
常德中国旅行社	chang'de'zhong'guo'lv'xing'she	0
长江口商城服份有限公司旅行社	chang'jiang'kou'shang'cheng'fu'fen'you'xian'gong'si'lv'xing'she	0
长乐市华侨旅行社	chang'le'shi'hua'qiao'lv'xing'she	0
昌南旅行社	chang'nan'lv'xing'she	0
长沙长岛旅行社	chang'sha'chang'dao'lv'xing'she	0
长沙春秋旅行社	chang'sha'chun'qiu'lv'xing'she	0
长沙电信旅行社	chang'sha'dian'xin'lv'xing'she	0
长沙公交天洋旅行社	chang'sha'gong'jiao'tian'yang'lv'xing'she	0
长沙火车站旅行社	chang'sha'huo'che'zhan'lv'xing'she	0
长沙交通旅行社	chang'sha'jiao'tong'lv'xing'she	0
长沙教育经济开发总公司长沙教育旅行社	chang'sha'jiao'yu'jing'ji'kai'fa'zong'gong'si'chang'sha'jiao'yu'lv'xing'she	0
长沙教育旅行社	chang'sha'jiao'yu'lv'xing'she	0
长沙金桥旅行社	chang'sha'jin'qiao'lv'xing'she	0
长沙联运旅行社	chang'sha'lian'yun'lv'xing'she	0
长沙旅行社	chang'sha'lv'xing'she	0
长沙市长岛旅行社	chang'sha'shi'chang'dao'lv'xing'she	0
长沙市风华旅行社	chang'sha'shi'feng'hua'lv'xing'she	0
长沙市和平旅行社	chang'sha'shi'he'ping'lv'xing'she	0
长沙市天洋旅行社	chang'sha'shi'tian'yang'lv'xing'she	0
长沙市通达旅行社	chang'sha'shi'tong'da'lv'xing'she	0
长沙市中国旅行社	chang'sha'shi'zhong'guo'lv'xing'she	0
长沙铁路金沙旅行社	chang'sha'tie'lu'jin'sha'lv'xing'she	0
长沙湘民旅行社	chang'sha'xiang'min'lv'xing'she	0
长沙湘亚旅行社	chang'sha'xiang'ya'lv'xing'she	0
长沙鑫湘旅行社	chang'sha'xin'xiang'lv'xing'she	0
长沙职工旅行社	chang'sha'zhi'gong'lv'xing'she	0
长沙中国青年旅行社	chang'sha'zhong'guo'qing'nian'lv'xing'she	0
常熟春秋旅行社	chang'shu'chun'qiu'lv'xing'she	0
常熟南方旅行社	chang'shu'nan'fang'lv'xing'she	0
常熟琴川国内旅行社	chang'shu'qin'chuan'guo'nei'lv'xing'she	0
常熟市八达岭国内旅行社	chang'shu'shi'ba'da'ling'guo'nei'lv'xing'she	0
常熟市阳光旅行社	chang'shu'shi'yang'guang'lv'xing'she	0
常熟中国国际旅行社	chang'shu'zhong'guo'guo'ji'lv'xing'she	0
常熟中国旅行社	chang'shu'zhong'guo'lv'xing'she	0
长兴县京兴旅行社	chang'xing'xian'jing'xing'lv'xing'she	0
长阳土家族自治县清江旅行社	chang'yang'tu'jia'zu'zi'zhi'xian'qing'jiang'lv'xing'she	0
长运旅行社	chang'yun'lv'xing'she	0
常州爱建旅行社	chang'zhou'ai'jian'lv'xing'she	0
常州春秋旅行社	chang'zhou'chun'qiu'lv'xing'she	0
常州东方旅行社	chang'zhou'dong'fang'lv'xing'she	0
常州光大旅行社	chang'zhou'guang'da'lv'xing'she	0
常州广电旅行社	chang'zhou'guang'dian'lv'xing'she	0
常州国泰旅行社	chang'zhou'guo'tai'lv'xing'she	0
常州华夏旅行社	chang'zhou'hua'xia'lv'xing'she	0
常州假日旅行社	chang'zhou'jia'ri'lv'xing'she	0
常州教育旅行社	chang'zhou'jiao'yu'lv'xing'she	0
常州金陵旅行社	chang'zhou'jin'ling'lv'xing'she	0
常州康辉旅行社	chang'zhou'kang'hui'lv'xing'she	0
常州龙城旅行社	chang'zhou'long'cheng'lv'xing'she	0
常州龙之旅天天游旅行社	chang'zhou'long'zhi'lv'tian'tian'you'lv'xing'she	0
常州旅行社	chang'zhou'lv'xing'she	0
常州民航航空旅行社	chang'zhou'min'hang'hang'kong'lv'xing'she	0
常州明都旅行社	chang'zhou'ming'dou'lv'xing'she	0
常州青年旅行社	chang'zhou'qing'nian'lv'xing'she	0
常州山水旅行社	chang'zhou'shan'shui'lv'xing'she	0
常州市新华旅行社	chang'zhou'shi'xin'hua'lv'xing'she	0
常州新华旅行社	chang'zhou'xin'hua'lv'xing'she	0
常州阳光假期旅行社	chang'zhou'yang'guang'jia'qi'lv'xing'she	0
常州职工旅行社	chang'zhou'zhi'gong'lv'xing'she	0
常州中国国际旅行社	chang'zhou'zhong'guo'guo'ji'lv'xing'she	0
常州中国旅行社	chang'zhou'zhong'guo'lv'xing'she	0
常州中邮旅行社	chang'zhou'zhong'you'lv'xing'she	0
巢湖市银湖旅行社	chao'hu'shi'yin'hu'lv'xing'she	0
潮阳市中国旅行社	chao'yang'shi'zhong'guo'lv'xing'she	0
潮州市海联旅行社	chao'zhou'shi'hai'lian'lv'xing'she	0
潮州市金曼旅行社	chao'zhou'shi'jin'man'lv'xing'she	0
潮州市侨联旅行社	chao'zhou'shi'qiao'lian'lv'xing'she	0
潮州市中国旅行社	chao'zhou'shi'zhong'guo'lv'xing'she	0
潮州中国国际旅行社	chao'zhou'zhong'guo'guo'ji'lv'xing'she	0
潮州中国旅行社	chao'zhou'zhong'guo'lv'xing'she	0
车里旅行社	che'li'lv'xing'she	0
晨晖旅行社	chen'hui'lv'xing'she	0
郴县南岭旅行社	chen'xian'nan'ling'lv'xing'she	0
郴州风景园林旅行社	chen'zhou'feng'jing'yuan'lin'lv'xing'she	0
郴州南岭旅行社	chen'zhou'nan'ling'lv'xing'she	0
郴州青年旅行社	chen'zhou'qing'nian'lv'xing'she	0
郴州市北湖区中国旅行社	chen'zhou'shi'bei'hu'qu'zhong'guo'lv'xing'she	0
郴州市国大旅行社	chen'zhou'shi'guo'da'lv'xing'she	0
郴州天地旅行社	chen'zhou'tian'di'lv'xing'she	0
城步苗族自治县湘城环球苗山旅行社	cheng'bu'miao'zu'zi'zhi'xian'xiang'cheng'huan'qiu'miao'shan'lv'xing'she	0
承德避暑山庄旅行社	cheng'de'bi'shu'shan'zhuang'lv'xing'she	0
承德畅远旅行社	cheng'de'chang'yuan'lv'xing'she	0
承德诚信旅行社	cheng'de'cheng'xin'lv'xing'she	0
承德大地旅行社	cheng'de'da'di'lv'xing'she	0
承德妇女旅行社	cheng'de'fu'nv'lv'xing'she	0
承德华光旅行社	cheng'de'hua'guang'lv'xing'she	0
承德皇家旅行社	cheng'de'huang'jia'lv'xing'she	0
承德黄金旅行社	cheng'de'huang'jin'lv'xing'she	0
承德假日旅行社	cheng'de'jia'ri'lv'xing'she	0
承德教师旅行社	cheng'de'jiao'shi'lv'xing'she	0
承德金桥旅行社	cheng'de'jin'qiao'lv'xing'she	0
承德民族宗教旅行社	cheng'de'min'zu'zong'jiao'lv'xing'she	0
承德能源旅行社	cheng'de'neng'yuan'lv'xing'she	0
承德普宁旅行社	cheng'de'pu'ning'lv'xing'she	0
承德森林旅行社	cheng'de'sen'lin'lv'xing'she	0
承德山庄国际旅行社	cheng'de'shan'zhuang'guo'ji'lv'xing'she	0
承德圣地旅行社	cheng'de'sheng'di'lv'xing'she	0
承德市保险旅行社	cheng'de'shi'bao'xian'lv'xing'she	0
承德市北方旅行社	cheng'de'shi'bei'fang'lv'xing'she	0
承德市畅远旅行社	cheng'de'shi'chang'yuan'lv'xing'she	0
承德市观光旅行社	cheng'de'shi'guan'guang'lv'xing'she	0
承德市鸿雁旅行社	cheng'de'shi'hong'yan'lv'xing'she	0
承德市华泰旅行社	cheng'de'shi'hua'tai'lv'xing'she	0
承德市教育旅行社	cheng'de'shi'jiao'yu'lv'xing'she	0
承德市金华旅行社	cheng'de'shi'jin'hua'lv'xing'she	0
承德市旅行社	cheng'de'shi'lv'xing'she	0
承德市梦圆旅行社	cheng'de'shi'meng'yuan'lv'xing'she	0
承德市热河旅行社	cheng'de'shi're'he'lv'xing'she	0
承德市三源旅行社	cheng'de'shi'san'yuan'lv'xing'she	0
承德市神州旅行社	cheng'de'shi'shen'zhou'lv'xing'she	0
承德市天和国际旅行社	cheng'de'shi'tian'he'guo'ji'lv'xing'she	0
承德市铁道旅行社	cheng'de'shi'tie'dao'lv'xing'she	0
承德市文化旅行社	cheng'de'shi'wen'hua'lv'xing'she	0
承德市文物旅行社	cheng'de'shi'wen'wu'lv'xing'she	0
承德市新华旅行社	cheng'de'shi'xin'hua'lv'xing'she	0
承德市易园旅行社	cheng'de'shi'yi'yuan'lv'xing'she	0
承德市邮电联谊旅行社	cheng'de'shi'you'dian'lian'yi'lv'xing'she	0
承德市中国青年旅行社	cheng'de'shi'zhong'guo'qing'nian'lv'xing'she	0
承德市总后休干部旅行社	cheng'de'shi'zong'hou'xiu'gan'bu'lv'xing'she	0
承德铁路金山旅行社	cheng'de'tie'lu'jin'shan'lv'xing'she	0
承德铁路友好旅行社	cheng'de'tie'lu'you'hao'lv'xing'she	0
承德五洲旅行社	cheng'de'wu'zhou'lv'xing'she	0
承德中国国际旅行社	cheng'de'zhong'guo'guo'ji'lv'xing'she	0
成都川西旅行社	cheng'du'chuan'xi'lv'xing'she	0
成都大运旅行社	cheng'du'da'yun'lv'xing'she	0
成都飞龙旅行社	cheng'du'fei'long'lv'xing'she	0
成都光大国际旅行社	cheng'du'guang'da'guo'ji'lv'xing'she	0
成都华夏旅行社	cheng'du'hua'xia'lv'xing'she	0
成都教育旅行社	cheng'du'jiao'yu'lv'xing'she	0
成都神州国际旅行社	cheng'du'shen'zhou'guo'ji'lv'xing'she	0
成都市中国光大国际旅行社	cheng'du'shi'zhong'guo'guang'da'guo'ji'lv'xing'she	0
成都天府国际旅行社	cheng'du'tian'fu'guo'ji'lv'xing'she	0
成都天马旅行社	cheng'du'tian'ma'lv'xing'she	0
成都万友旅行社	cheng'du'wan'you'lv'xing'she	0
成都文化假日旅行社	cheng'du'wen'hua'jia'ri'lv'xing'she	0
成都兴业旅行社	cheng'du'xing'ye'lv'xing'she	0
成都雪源旅行社	cheng'du'xue'yuan'lv'xing'she	0
成都中北旅行社	cheng'du'zhong'bei'lv'xing'she	0
成都中国康辉国际旅行社	cheng'du'zhong'guo'kang'hui'guo'ji'lv'xing'she	0
澄海市红头船旅行社	cheng'hai'shi'hong'tou'chuan'lv'xing'she	0
澄海市中国旅行社	cheng'hai'shi'zhong'guo'lv'xing'she	0
成吉思汗旅行社	cheng'ji'si'han'lv'xing'she	0
池州春秋旅行社	chi'zhou'chun'qiu'lv'xing'she	0
池州地区长江旅行社	chi'zhou'di'qu'chang'jiang'lv'xing'she	0
池州地区裕达旅行社	chi'zhou'di'qu'yu'da'lv'xing'she	0
池州地区中国旅行社	chi'zhou'di'qu'zhong'guo'lv'xing'she	0
池州国邮鸿雁旅行社	chi'zhou'guo'you'hong'yan'lv'xing'she	0
池州教育旅行社	chi'zhou'jiao'yu'lv'xing'she	0
淳安千岛湖中国旅行社	chun'an'qian'dao'hu'zhong'guo'lv'xing'she	0
淳安县千岛湖妇女旅行社	chun'an'xian'qian'dao'hu'fu'nv'lv'xing'she	0
淳安县千岛湖阳光旅行社	chun'an'xian'qian'dao'hu'yang'guang'lv'xing'she	0
春秋旅行网	chun'qiu'lv'xing'wang	0
慈溪风光旅行社	ci'xi'feng'guang'lv'xing'she	0
慈溪市旅行社	ci'xi'shi'lv'xing'she	0
从化市华夏旅行社	cong'hua'shi'hua'xia'lv'xing'she	0
从化市中国旅行社	cong'hua'shi'zhong'guo'lv'xing'she	0
大地旅行社	da'di'lv'xing'she	0
大丰银都旅行社	da'feng'yin'du'lv'xing'she	0
大理安然旅行社	da'li'an'ran'lv'xing'she	0
大理苍山旅行社	da'li'cang'shan'lv'xing'she	0
大理茶花国际旅行社	da'li'cha'hua'guo'ji'lv'xing'she	0
大理大运旅行社	da'li'da'yun'lv'xing'she	0
大理风情旅行社	da'li'feng'qing'lv'xing'she	0
大理航空旅行社	da'li'hang'kong'lv'xing'she	0
大理金花旅行社	da'li'jin'hua'lv'xing'she	0
大理市旅行社	da'li'shi'lv'xing'she	0
大理西电海星旅行社	da'li'xi'dian'hai'xing'lv'xing'she	0
大理兴安旅行社	da'li'xing'an'lv'xing'she	0
大理中国旅行社	da'li'zhong'guo'lv'xing'she	0
大连棒槌岛旅行社	da'lian'bang'chui'dao'lv'xing'she	0
大连包装进出口公司旅行社	da'lian'bao'zhuang'jin'chu'kou'gong'si'lv'xing'she	0
大连北方旅行社	da'lian'bei'fang'lv'xing'she	0
大连北方星岛旅行社	da'lian'bei'fang'xing'dao'lv'xing'she	0
大连北航旅行社	da'lian'bei'hang'lv'xing'she	0
大连滨城旅行社	da'lian'bin'cheng'lv'xing'she	0
大连滨海旅行社	da'lian'bin'hai'lv'xing'she	0
大连长海百岛旅行社	da'lian'chang'hai'bai'dao'lv'xing'she	0
大连川其旅行社	da'lian'chuan'qi'lv'xing'she	0
大连大地旅行社	da'lian'da'di'lv'xing'she	0
大连当代旅行社	da'lian'dang'dai'lv'xing'she	0
大连电力国际旅行社	da'lian'dian'li'guo'ji'lv'xing'she	0
大连东北旅行社	da'lian'dong'bei'lv'xing'she	0
大连东来旅行社	da'lian'dong'lai'lv'xing'she	0
大连东兴旅行社	da'lian'dong'xing'lv'xing'she	0
大连方舟旅行社	da'lian'fang'zhou'lv'xing'she	0
大连富缘旅行社	da'lian'fu'yuan'lv'xing'she	0
大连港欣旅行社	da'lian'gang'xin'lv'xing'she	0
大连古莲旅行社	da'lian'gu'lian'lv'xing'she	0
大连国发旅行社	da'lian'guo'fa'lv'xing'she	0
大连国凤航空旅行社	da'lian'guo'feng'hang'kong'lv'xing'she	0
大连国泰旅行社	da'lian'guo'tai'lv'xing'she	0
大连海滨旅行社	da'lian'hai'bin'lv'xing'she	0
大连海天旅行社	da'lian'hai'tian'lv'xing'she	0
大连海峡观光旅行社	da'lian'hai'xia'guan'guang'lv'xing'she	0
大连航标区航标旅行社	da'lian'hang'biao'qu'hang'biao'lv'xing'she	0
大连航空国际旅行社	da'lian'hang'kong'guo'ji'lv'xing'she	0
大连和光旅行社	da'lian'he'guang'lv'xing'she	0
大连和平国际旅行社	da'lian'he'ping'guo'ji'lv'xing'she	0
大连虎滩旅行社	da'lian'hu'tan'lv'xing'she	0
大连花卉旅行社	da'lian'hua'hui'lv'xing'she	0
大连华南旅行社	da'lian'hua'nan'lv'xing'she	0
大连华荣旅行社	da'lian'hua'rong'lv'xing'she	0
大连华夏旅行社	da'lian'hua'xia'lv'xing'she	0
大连华阳旅行社	da'lian'hua'yang'lv'xing'she	0
大连华运旅行社	da'lian'hua'yun'lv'xing'she	0
大连环宇旅行社	da'lian'huan'yu'lv'xing'she	0
大连健康旅行社	da'lian'jian'kang'lv'xing'she	0
大连建设旅行社	da'lian'jian'she'lv'xing'she	0
大连交通国际旅行社	da'lian'jiao'tong'guo'ji'lv'xing'she	0
大连金达来旅行社	da'lian'jin'da'lai'lv'xing'she	0
大连金融旅行社	da'lian'jin'rong'lv'xing'she	0
大连九龙旅行社	da'lian'jiu'long'lv'xing'she	0
大连九州旅行社	da'lian'jiu'zhou'lv'xing'she	0
大连来来旅行社	da'lian'lai'lai'lv'xing'she	0
大连浪花旅行社	da'lian'lang'hua'lv'xing'she	0
大连联友旅行社	da'lian'lian'you'lv'xing'she	0
大连凌云旅行社	da'lian'ling'yun'lv'xing'she	0
大连旅顺银帆旅行社	da'lian'lv'shun'yin'fan'lv'xing'she	0
大连旅行社	da'lian'lv'xing'she	0
大连民族学院碧海旅行社	da'lian'min'zu'xue'yuan'bi'hai'lv'xing'she	0
大连七星国际旅行社	da'lian'qi'xing'guo'ji'lv'xing'she	0
大连三泰旅行社	da'lian'san'tai'lv'xing'she	0
大连森林旅行社	da'lian'sen'lin'lv'xing'she	0
大连山水旅行社	da'lian'shan'shui'lv'xing'she	0
大连神龙旅行社	da'lian'shen'long'lv'xing'she	0
大连市川其旅行社	da'lian'shi'chuan'qi'lv'xing'she	0
大连时代旅行社	da'lian'shi'dai'lv'xing'she	0
大连市风景旅行社	da'lian'shi'feng'jing'lv'xing'she	0
大连市工商旅行社	da'lian'shi'gong'shang'lv'xing'she	0
大连市国际妇女旅行社	da'lian'shi'guo'ji'fu'nv'lv'xing'she	0
大连市国际商务旅行社	da'lian'shi'guo'ji'shang'wu'lv'xing'she	0
大连世纪旅行社	da'lian'shi'ji'lv'xing'she	0
大连市新世界旅行社	da'lian'shi'xin'shi'jie'lv'xing'she	0
大连松山旅行社	da'lian'song'shan'lv'xing'she	0
大连太和旅行社	da'lian'tai'he'lv'xing'she	0
大连唐人旅行社	da'lian'tang'ren'lv'xing'she	0
大连体育国际旅行社	da'lian'ti'yu'guo'ji'lv'xing'she	0
大连天虹旅行社	da'lian'tian'hong'lv'xing'she	0
大连天佑旅行社	da'lian'tian'you'lv'xing'she	0
大连铁道旅行社	da'lian'tie'dao'lv'xing'she	0
大连万泰旅行社	da'lian'wan'tai'lv'xing'she	0
大连西岗商务旅行社	da'lian'xi'gang'shang'wu'lv'xing'she	0
大连中包旅行社	da'lian'zhong'bao'lv'xing'she	0
大连中国旅行社	da'lian'zhong'guo'lv'xing'she	0
大连中国青年旅行社	da'lian'zhong'guo'qing'nian'lv'xing'she	0
大连中海海运旅行社	da'lian'zhong'hai'hai'yun'lv'xing'she	0
大连中海旅行社	da'lian'zhong'hai'lv'xing'she	0
大连中海贸旅行社	da'lian'zhong'hai'mao'lv'xing'she	0
大庆花卉旅行社	da'qing'hua'hui'lv'xing'she	0
大庆铁道旅行社	da'qing'tie'dao'lv'xing'she	0
大庆油田报社宝丽旅行社	da'qing'you'tian'bao'she'bao'li'lv'xing'she	0
大庆中国国际旅行社	da'qing'zhong'guo'guo'ji'lv'xing'she	0
大同金桥旅行社	da'tong'jin'qiao'lv'xing'she	0
大同市北岳旅行社	da'tong'shi'bei'yue'lv'xing'she	0
大同市恒兴旅行社	da'tong'shi'heng'xing'lv'xing'she	0
大同市魏都旅行社	da'tong'shi'wei'dou'lv'xing'she	0
大同市职工旅行社	da'tong'shi'zhi'gong'lv'xing'she	0
大同市中国旅行社	da'tong'shi'zhong'guo'lv'xing'she	0
大同铁路通达旅行社	da'tong'tie'lu'tong'da'lv'xing'she	0
大同中国国际旅行社	da'tong'zhong'guo'guo'ji'lv'xing'she	0
大同中国青年旅行社	da'tong'zhong'guo'qing'nian'lv'xing'she	0
大兴安岭中国国际旅行社	da'xing'an'ling'zhong'guo'guo'ji'lv'xing'she	0
大禹旅行社	da'yu'lv'xing'she	0
大余县中国旅行社	da'yu'xian'zhong'guo'lv'xing'she	0
大自然旅行社	da'zi'ran'lv'xing'she	0
丹东春秋旅行社	dan'dong'chun'qiu'lv'xing'she	0
丹东大正旅行社	dan'dong'da'zheng'lv'xing'she	0
丹东电业旅行社	dan'dong'dian'ye'lv'xing'she	0
丹东风景园林旅行社	dan'dong'feng'jing'yuan'lin'lv'xing'she	0
丹东海外旅行社	dan'dong'hai'wai'lv'xing'she	0
丹东金方舟国际旅行社	dan'dong'jin'fang'zhou'guo'ji'lv'xing'she	0
丹东金桥旅行社	dan'dong'jin'qiao'lv'xing'she	0
丹东金湾旅行社	dan'dong'jin'wan'lv'xing'she	0
丹东丽园旅行社	dan'dong'li'yuan'lv'xing'she	0
丹东旅行社	dan'dong'lv'xing'she	0
丹东青年旅行社	dan'dong'qing'nian'lv'xing'she	0
丹东市民族旅行社	dan'dong'shi'min'zu'lv'xing'she	0
丹东市中国旅行社	dan'dong'shi'zhong'guo'lv'xing'she	0
丹东天马旅行社	dan'dong'tian'ma'lv'xing'she	0
丹东铁道国际旅行社	dan'dong'tie'dao'guo'ji'lv'xing'she	0
丹东鸭绿江旅行社	dan'dong'ya'lu'jiang'lv'xing'she	0
丹东沿江开发区白山旅行社	dan'dong'yan'jiang'kai'fa'qu'bai'shan'lv'xing'she	0
丹东中国国际旅行社	dan'dong'zhong'guo'guo'ji'lv'xing'she	0
丹阳大众旅行社	dan'yang'da'zhong'lv'xing'she	0
丹阳凤林旅行社	dan'yang'feng'lin'lv'xing'she	0
丹阳铁路旅行社	dan'yang'tie'lu'lv'xing'she	0
丹阳文化旅行社	dan'yang'wen'hua'lv'xing'she	0
丹阳中国旅行社	dan'yang'zhong'guo'lv'xing'she	0
德宏州芒市风情旅行社	de'hong'zhou'mang'shi'feng'qing'lv'xing'she	0
德化瓷都旅行社	de'hua'ci'du'lv'xing'she	0
德清旅行社	de'qing'lv'xing'she	0
德阳市春秋旅行社	de'yang'shi'chun'qiu'lv'xing'she	0
德阳市九洲旅行社	de'yang'shi'jiu'zhou'lv'xing'she	0
德阳市青年旅行社	de'yang'shi'qing'nian'lv'xing'she	0
德阳市新世纪旅行社	de'yang'shi'xin'shi'ji'lv'xing'she	0
德阳市阳光旅行社	de'yang'shi'yang'guang'lv'xing'she	0
德阳万路旅行社	de'yang'wan'lu'lv'xing'she	0
德州银通旅行社	de'zhou'yin'tong'lv'xing'she	0
登封中国国际旅行社	deng'feng'zhong'guo'guo'ji'lv'xing'she	0
定海区东园为民旅行社	ding'hai'qu'dong'yuan'wei'min'lv'xing'she	0
东方假期国际旅行社	dong'fang'jia'qi'guo'ji'lv'xing'she	0
东方旅行社	dong'fang'lv'xing'she	0
东莞安捷旅行社	dong'guan'an'jie'lv'xing'she	0
东莞市东湖旅行社	dong'guan'shi'dong'hu'lv'xing'she	0
东莞市国安旅行社	dong'guan'shi'guo'an'lv'xing'she	0
东莞市国际旅行社	dong'guan'shi'guo'ji'lv'xing'she	0
东莞市国泰旅行社	dong'guan'shi'guo'tai'lv'xing'she	0
东莞市青年旅行社	dong'guan'shi'qing'nian'lv'xing'she	0
东莞市石龙康辉旅行社	dong'guan'shi'shi'long'kang'hui'lv'xing'she	0
东莞市腾龙旅行社	dong'guan'shi'teng'long'lv'xing'she	0
东莞市新世界旅行社	dong'guan'shi'xin'shi'jie'lv'xing'she	0
东莞市志诚旅行社	dong'guan'shi'zhi'cheng'lv'xing'she	0
东海县中国旅行社	dong'hai'xian'zhong'guo'lv'xing'she	0
东海新华旅行社	dong'hai'xin'hua'lv'xing'she	0
东里旅行社	dong'li'lv'xing'she	0
东宁县吉信旅行社	dong'ning'xian'ji'xin'lv'xing'she	0
东宁县锦华旅行社	dong'ning'xian'jin'hua'lv'xing'she	0
东山中国旅行社	dong'shan'zhong'guo'lv'xing'she	0
东台东方旅行社	dong'tai'dong'fang'lv'xing'she	0
东亚旅行社	dong'ya'lv'xing'she	0
东崖旅行社	dong'ya'lv'xing'she	0
东阳横店集团旅行社	dong'yang'heng'dian'ji'tuan'lv'xing'she	0
东阳市中国旅行社	dong'yang'shi'zhong'guo'lv'xing'she	0
东营市中国国际旅行社	dong'ying'shi'zhong'guo'guo'ji'lv'xing'she	0
东源县万绿湖旅行社	dong'yuan'xian'wan'lv'hu'lv'xing'she	0
东岳假日旅行社	dong'yue'jia'ri'lv'xing'she	0
斗门县江亚旅行社	dou'men'xian'jiang'ya'lv'xing'she	0
斗门县中国旅行社	dou'men'xian'zhong'guo'lv'xing'she	0
端丰旅行社	duan'feng'lv'xing'she	0
敦煌光大国际旅行社	dun'huang'guang'da'guo'ji'lv'xing'she	0
敦煌假日旅行社	dun'huang'jia'ri'lv'xing'she	0
敦煌旅行社	dun'huang'lv'xing'she	0
敦煌沙洲国际旅行社	dun'huang'sha'zhou'guo'ji'lv'xing'she	0
敦煌市交通旅行社	dun'huang'shi'jiao'tong'lv'xing'she	0
敦煌市旅游汽车公司大禹旅行社	dun'huang'shi'lv'you'qi'che'gong'si'da'yu'lv'xing'she	0
敦煌太阳能国际旅行社	dun'huang'tai'yang'neng'guo'ji'lv'xing'she	0
鄂尔多斯旅行社	e'er'duo'si'lv'xing'she	0
峨眉山风景国际旅行社	e'mei'shan'feng'jing'guo'ji'lv'xing'she	0
峨眉山公路交通旅行社	e'mei'shan'gong'lu'jiao'tong'lv'xing'she	0
峨眉山金盾旅行社	e'mei'shan'jin'dun'lv'xing'she	0
峨眉山景区旅行社	e'mei'shan'jing'qu'lv'xing'she	0
峨眉山旅行社	e'mei'shan'lv'xing'she	0
鄂州市天马旅行社	e'zhou'shi'tian'ma'lv'xing'she	0
恩平市中国旅行社	en'ping'shi'zhong'guo'lv'xing'she	0
恩平中国旅行社	en'ping'zhong'guo'lv'xing'she	0
二十四桥旅行社	er'shi'si'qiao'lv'xing'she	0
法门寺光大旅行社	fa'men'si'guang'da'lv'xing'she	0
防城港国际旅行社	fang'cheng'gang'guo'ji'lv'xing'she	0
防城港市防城区旅行社	fang'cheng'gang'shi'fang'cheng'qu'lv'xing'she	0
防城港市旅行社	fang'cheng'gang'shi'lv'xing'she	0
飞雁旅行社	fei'yan'lv'xing'she	0
丰都鬼国神宫旅行社	feng'du'gui'guo'shen'gong'lv'xing'she	0
丰都鬼王石刻旅行社	feng'du'gui'wang'shi'ke'lv'xing'she	0
丰都国际旅行社	feng'du'guo'ji'lv'xing'she	0
丰都青年旅行社	feng'du'qing'nian'lv'xing'she	0
丰都三联旅行社	feng'du'san'lian'lv'xing'she	0
奉化市华侨旅行社	feng'hua'shi'hua'qiao'lv'xing'she	0
奉化市中国旅行社	feng'hua'shi'zhong'guo'lv'xing'she	0
奉化中国旅行社	feng'hua'zhong'guo'lv'xing'she	0
奉节国际旅行社	feng'jie'guo'ji'lv'xing'she	0
风景旅行社	feng'jing'lv'xing'she	0
丰南市中国旅行社	feng'nan'shi'zhong'guo'lv'xing'she	0
丰宁草原旅行社	feng'ning'cao'yuan'lv'xing'she	0
佛山市金马旅行社	fo'shan'shi'jin'ma'lv'xing'she	0
佛山市中国旅行社	fo'shan'shi'zhong'guo'lv'xing'she	0
佛山市中宇旅行社	fo'shan'shi'zhong'yu'lv'xing'she	0
佛山中国国际旅行社	fo'shan'zhong'guo'guo'ji'lv'xing'she	0
佛山中国旅行社	fo'shan'zhong'guo'lv'xing'she	0
富春江潇洒桐庐旅行社	fu'chun'jiang'xiao'sa'tong'lu'lv'xing'she	0
福建东山海之角旅行社	fu'jian'dong'shan'hai'zhi'jiao'lv'xing'she	0
福建东山天马旅行社	fu'jian'dong'shan'tian'ma'lv'xing'she	0
福建国旅武夷山铁路旅行社	fu'jian'guo'lv'wu'yi'shan'tie'lu'lv'xing'she	0
福建华通旅行社	fu'jian'hua'tong'lv'xing'she	0
福建美海旅行社	fu'jian'mei'hai'lv'xing'she	0
福建山水旅行社	fu'jian'shan'shui'lv'xing'she	0
福建省光大国际旅行社	fu'jian'sheng'guang'da'guo'ji'lv'xing'she	0
福建省华福旅行社	fu'jian'sheng'hua'fu'lv'xing'she	0
福建省华迈旅行社	fu'jian'sheng'hua'mai'lv'xing'she	0
福建省惠安天马旅行社	fu'jian'sheng'hui'an'tian'ma'lv'xing'she	0
福建省记者旅行社	fu'jian'sheng'ji'zhe'lv'xing'she	0
福建省假日旅行社	fu'jian'sheng'jia'ri'lv'xing'she	0
福建省将乐县旅行社	fu'jian'sheng'jiang'le'xian'lv'xing'she	0
福建省金福旅行社	fu'jian'sheng'jin'fu'lv'xing'she	0
福建省金山旅行社	fu'jian'sheng'jin'shan'lv'xing'she	0
福建省康辉国际旅行社	fu'jian'sheng'kang'hui'guo'ji'lv'xing'she	0
福建省康辉旅行社	fu'jian'sheng'kang'hui'lv'xing'she	0
福建省龙岩地区中国旅行社	fu'jian'sheng'long'yan'di'qu'zhong'guo'lv'xing'she	0
福建省宁德地区旅行社	fu'jian'sheng'ning'de'di'qu'lv'xing'she	0
福建省榕树王森林旅行社	fu'jian'sheng'rong'shu'wang'sen'lin'lv'xing'she	0
福建省榕铁旅行社	fu'jian'sheng'rong'tie'lv'xing'she	0
福建省泰宁县旅行社	fu'jian'sheng'tai'ning'xian'lv'xing'she	0
福建省武夷山教工旅行社	fu'jian'sheng'wu'yi'shan'jiao'gong'lv'xing'she	0
福建省武夷山旅行社	fu'jian'sheng'wu'yi'shan'lv'xing'she	0
福建省武夷山美海旅行社	fu'jian'sheng'wu'yi'shan'mei'hai'lv'xing'she	0
福建省武夷山市凌云旅行社	fu'jian'sheng'wu'yi'shan'shi'ling'yun'lv'xing'she	0
福建省武夷山市天成旅行社	fu'jian'sheng'wu'yi'shan'shi'tian'cheng'lv'xing'she	0
福建省西湖国际旅行社	fu'jian'sheng'xi'hu'guo'ji'lv'xing'she	0
福建省邮电旅行社	fu'jian'sheng'you'dian'lv'xing'she	0
福建省诏安县华侨旅行社	fu'jian'sheng'zhao'an'xian'hua'qiao'lv'xing'she	0
福建省职工国际旅行社	fu'jian'sheng'zhi'gong'guo'ji'lv'xing'she	0
福建省中国国际旅行社	fu'jian'sheng'zhong'guo'guo'ji'lv'xing'she	0
福建省中国旅行社	fu'jian'sheng'zhong'guo'lv'xing'she	0
福建省中国青年旅行社	fu'jian'sheng'zhong'guo'qing'nian'lv'xing'she	0
福建省中旅假日旅行社	fu'jian'sheng'zhong'lv'jia'ri'lv'xing'she	0
福建省中山旅行社	fu'jian'sheng'zhong'shan'lv'xing'she	0
福建水口电站旅行社	fu'jian'shui'kou'dian'zhan'lv'xing'she	0
福建展望旅行社	fu'jian'zhan'wang'lv'xing'she	0
福建中旅假日旅行社	fu'jian'zhong'lv'jia'ri'lv'xing'she	0
福建中贸旅行社	fu'jian'zhong'mao'lv'xing'she	0
富锦市旅行社	fu'jin'shi'lv'xing'she	0
阜宁县邮政旅行社	fu'ning'xian'you'zheng'lv'xing'she	0
阜宁兴阜旅行社	fu'ning'xing'fu'lv'xing'she	0
抚顺春秋旅行社	fu'shun'chun'qiu'lv'xing'she	0
抚顺煤都旅行社	fu'shun'mei'du'lv'xing'she	0
抚顺青年旅行社	fu'shun'qing'nian'lv'xing'she	0
抚顺市碧云旅行社	fu'shun'shi'bi'yun'lv'xing'she	0
抚顺市春天旅行社	fu'shun'shi'chun'tian'lv'xing'she	0
抚顺市东方旅行社	fu'shun'shi'dong'fang'lv'xing'she	0
抚顺市富仕华旅行社	fu'shun'shi'fu'shi'hua'lv'xing'she	0
抚顺市鸿濡旅行社	fu'shun'shi'hong'ru'lv'xing'she	0
抚顺市华丰旅行社	fu'shun'shi'hua'feng'lv'xing'she	0
抚顺市假日旅行社	fu'shun'shi'jia'ri'lv'xing'she	0
抚顺市九洲旅行社	fu'shun'shi'jiu'zhou'lv'xing'she	0
抚顺市连达旅行社	fu'shun'shi'lian'da'lv'xing'she	0
抚顺市绿珠旅行社	fu'shun'shi'lv'zhu'lv'xing'she	0
抚顺市青年旅行社	fu'shun'shi'qing'nian'lv'xing'she	0
抚顺市萨尔浒旅行社	fu'shun'shi'sa'er'hu'lv'xing'she	0
抚顺市顺城区旅行社	fu'shun'shi'shun'cheng'qu'lv'xing'she	0
抚顺市顺凯旅行社	fu'shun'shi'shun'kai'lv'xing'she	0
抚顺市泰和旅行社	fu'shun'shi'tai'he'lv'xing'she	0
抚顺市铁道旅行社	fu'shun'shi'tie'dao'lv'xing'she	0
抚顺市万通旅行社	fu'shun'shi'wan'tong'lv'xing'she	0
抚顺市兴京旅行社	fu'shun'shi'xing'jing'lv'xing'she	0
抚顺市园林旅行社	fu'shun'shi'yuan'lin'lv'xing'she	0
抚顺市纵横旅行社	fu'shun'shi'zong'heng'lv'xing'she	0
抚顺天马旅行社	fu'shun'tian'ma'lv'xing'she	0
抚顺天艺旅行社	fu'shun'tian'yi'lv'xing'she	0
富阳旅行社	fu'yang'lv'xing'she	0
富阳市东南旅行社	fu'yang'shi'dong'nan'lv'xing'she	0
富阳市富春江旅行社	fu'yang'shi'fu'chun'jiang'lv'xing'she	0
抚远旅行社	fu'yuan'lv'xing'she	0
福州东百旅行社	fu'zhou'dong'bai'lv'xing'she	0
福州国际旅行社	fu'zhou'guo'ji'lv'xing'she	0
福州军友旅行社	fu'zhou'jun'you'lv'xing'she	0
福州康泰旅行社	fu'zhou'kang'tai'lv'xing'she	0
福州旅行社	fu'zhou'lv'xing'she	0
福州闽江旅行社	fu'zhou'min'jiang'lv'xing'she	0
福州市虹桥旅行社	fu'zhou'shi'hong'qiao'lv'xing'she	0
福州市体育旅行社	fu'zhou'shi'ti'yu'lv'xing'she	0
福州市中国旅行社	fu'zhou'shi'zhong'guo'lv'xing'she	0
福州体育旅行社	fu'zhou'ti'yu'lv'xing'she	0
福州新华旅行社	fu'zhou'xin'hua'lv'xing'she	0
甘谷县旅行社	gan'gu'xian'lv'xing'she	0
橄榄枝旅行社	gan'lan'zhi'lv'xing'she	0
甘肃安西旅行社	gan'su'an'xi'lv'xing'she	0
甘肃敦煌大禹旅行社	gan'su'dun'huang'da'yu'lv'xing'she	0
甘肃敦煌飞天国际旅行社	gan'su'dun'huang'fei'tian'guo'ji'lv'xing'she	0
甘肃敦煌金丝路旅行社	gan'su'dun'huang'jin'si'lu'lv'xing'she	0
甘肃敦煌莫高旅行社	gan'su'dun'huang'mo'gao'lv'xing'she	0
甘肃敦煌铁道旅行社	gan'su'dun'huang'tie'dao'lv'xing'she	0
甘肃敦煌文化旅行社	gan'su'dun'huang'wen'hua'lv'xing'she	0
甘肃敦煌阳关旅行社	gan'su'dun'huang'yang'guan'lv'xing'she	0
甘肃敦煌艺术旅行社	gan'su'dun'huang'yi'shu'lv'xing'she	0
甘肃敦煌中油旅行社	gan'su'dun'huang'zhong'you'lv'xing'she	0
甘肃方舟旅行社	gan'su'fang'zhou'lv'xing'she	0
甘肃妇女旅行社	gan'su'fu'nv'lv'xing'she	0
甘肃恒顺交通旅行社	gan'su'heng'shun'jiao'tong'lv'xing'she	0
甘肃华欧旅行社	gan'su'hua'ou'lv'xing'she	0
甘肃华西旅行社	gan'su'hua'xi'lv'xing'she	0
甘肃花雨旅行社	gan'su'hua'yu'lv'xing'she	0
甘肃环球旅行社	gan'su'huan'qiu'lv'xing'she	0
甘肃嘉峪关铁道旅行社	gan'su'jia'yu'guan'tie'dao'lv'xing'she	0
甘肃嘉峪关雄关旅行社	gan'su'jia'yu'guan'xiong'guan'lv'xing'she	0
甘肃交广旅行社	gan'su'jiao'guang'lv'xing'she	0
甘肃金辉旅行社	gan'su'jin'hui'lv'xing'she	0
甘肃金旅旅行社	gan'su'jin'lv'lv'xing'she	0
甘肃金桥旅行社	gan'su'jin'qiao'lv'xing'she	0
甘肃酒泉国际旅行社	gan'su'jiu'quan'guo'ji'lv'xing'she	0
甘肃酒泉龙腾旅行社	gan'su'jiu'quan'long'teng'lv'xing'she	0
甘肃康辉国际旅行社	gan'su'kang'hui'guo'ji'lv'xing'she	0
甘肃快乐之行旅行社	gan'su'kuai'le'zhi'xing'lv'xing'she	0
甘肃兰神旅行社	gan'su'lan'shen'lv'xing'she	0
甘肃兰州休闲旅行社	gan'su'lan'zhou'xiu'xian'lv'xing'she	0
甘肃美桥旅行社	gan'su'mei'qiao'lv'xing'she	0
甘肃民航旅行社	gan'su'min'hang'lv'xing'she	0
甘肃森林沙漠旅行社	gan'su'sen'lin'sha'mo'lv'xing'she	0
甘肃山水旅行社	gan'su'shan'shui'lv'xing'she	0
甘肃省绿野旅行社	gan'su'sheng'lv'ye'lv'xing'she	0
甘肃省职工国际旅行社	gan'su'sheng'zhi'gong'guo'ji'lv'xing'she	0
甘肃省中国旅行社	gan'su'sheng'zhong'guo'lv'xing'she	0
甘肃太阳旅行社	gan'su'tai'yang'lv'xing'she	0
甘肃天水大自然国际旅行社	gan'su'tian'shui'da'zi'ran'guo'ji'lv'xing'she	0
甘肃天水伏羲文化旅行社	gan'su'tian'shui'fu'xi'wen'hua'lv'xing'she	0
甘肃天水连谊旅行社	gan'su'tian'shui'lian'yi'lv'xing'she	0
甘肃天水麦积铁道旅行社	gan'su'tian'shui'mai'ji'tie'dao'lv'xing'she	0
甘肃天水中国国际旅行社	gan'su'tian'shui'zhong'guo'guo'ji'lv'xing'she	0
甘肃万通旅行社	gan'su'wan'tong'lv'xing'she	0
甘肃西部旅行社	gan'su'xi'bu'lv'xing'she	0
甘肃现代旅行社	gan'su'xian'dai'lv'xing'she	0
甘肃新世纪旅行社	gan'su'xin'shi'ji'lv'xing'she	0
甘肃邮电旅行社	gan'su'you'dian'lv'xing'she	0
甘肃中国青年旅行社	gan'su'zhong'guo'qing'nian'lv'xing'she	0
甘肃中兴旅行社	gan'su'zhong'xing'lv'xing'she	0
赣州市赣之旅旅行社	gan'zhou'shi'gan'zhi'lv'lv'xing'she	0
高客康辉旅行社	gao'ke'kang'hui'lv'xing'she	0
高明市中国旅行社	gao'ming'shi'zhong'guo'lv'xing'she	0
高要市中国旅行社	gao'yao'shi'zhong'guo'lv'xing'she	0
高邮市邮驿旅行社	gao'you'shi'you'yi'lv'xing'she	0
供销旅行社	gong'xiao'lv'xing'she	0
谷丰旅行社	gu'feng'lv'xing'she	0
广东发源旅行社	guang'dong'fa'yuan'lv'xing'she	0
广东风光国际旅行社	guang'dong'feng'guang'guo'ji'lv'xing'she	0
广东广信国际旅行社	guang'dong'guang'xin'guo'ji'lv'xing'she	0
广东海洋旅行社	guang'dong'hai'yang'lv'xing'she	0
广东活力旅行社	guang'dong'huo'li'lv'xing'she	0
广东金叶旅行社	guang'dong'jin'ye'lv'xing'she	0
广东经贸旅行社	guang'dong'jing'mao'lv'xing'she	0
广东绿色国际旅行社	guang'dong'lv'se'guo'ji'lv'xing'she	0
广东绿色旅行社	guang'dong'lv'se'lv'xing'she	0
广东南湖国际旅行社	guang'dong'nan'hu'guo'ji'lv'xing'she	0
广东南鹰旅行社	guang'dong'nan'ying'lv'xing'she	0
广东三水市中国旅行社	guang'dong'san'shui'shi'zhong'guo'lv'xing'she	0
广东时尚国际旅行社	guang'dong'shi'shang'guo'ji'lv'xing'she	0
广东永安国际旅行社	guang'dong'yong'an'guo'ji'lv'xing'she	0
广东邮电国际旅行社	guang'dong'you'dian'guo'ji'lv'xing'she	0
广东邮电旅行社	guang'dong'you'dian'lv'xing'she	0
广东粤新国际旅行社	guang'dong'yue'xin'guo'ji'lv'xing'she	0
广东湛江海洋旅行社	guang'dong'zhan'jiang'hai'yang'lv'xing'she	0
广东肇庆市交通旅行社	guang'dong'zhao'qing'shi'jiao'tong'lv'xing'she	0
广东肇庆市职工旅行社	guang'dong'zhao'qing'shi'zhi'gong'lv'xing'she	0
广东肇庆星湖国际旅行社	guang'dong'zhao'qing'xing'hu'guo'ji'lv'xing'she	0
广汉市旅行社	guang'han'shi'lv'xing'she	0
广汉市三星堆旅行社	guang'han'shi'san'xing'dui'lv'xing'she	0
广西八桂国际旅行社	guang'xi'ba'gui'guo'ji'lv'xing'she	0
广西百色铁路旅行社	guang'xi'bai'se'tie'lu'lv'xing'she	0
广西北海青年国际旅行社	guang'xi'bei'hai'qing'nian'guo'ji'lv'xing'she	0
广西北海市东方旅行社	guang'xi'bei'hai'shi'dong'fang'lv'xing'she	0
广西防城港远洋旅行社	guang'xi'fang'cheng'gang'yuan'yang'lv'xing'she	0
广西桂林康佳旅行社	guang'xi'gui'lin'kang'jia'lv'xing'she	0
广西科技旅行社	guang'xi'ke'ji'lv'xing'she	0
广西口岸旅行社	guang'xi'kou'an'lv'xing'she	0
广西柳州市观光旅行社	guang'xi'liu'zhou'shi'guan'guang'lv'xing'she	0
广西民族风情旅行社	guang'xi'min'zu'feng'qing'lv'xing'she	0
广西南宁寰海旅行社	guang'xi'nan'ning'huan'hai'lv'xing'she	0
广西南宁环宇旅行社	guang'xi'nan'ning'huan'yu'lv'xing'she	0
广西南宁金兰国际旅行社	guang'xi'nan'ning'jin'lan'guo'ji'lv'xing'she	0
广西南宁桃源旅行社	guang'xi'nan'ning'tao'yuan'lv'xing'she	0
广西南宁天马旅行社	guang'xi'nan'ning'tian'ma'lv'xing'she	0
广西南宁职工国际旅行社	guang'xi'nan'ning'zhi'gong'guo'ji'lv'xing'she	0
广西凭祥新光旅行社	guang'xi'ping'xiang'xin'guang'lv'xing'she	0
广西青年旅行社	guang'xi'qing'nian'lv'xing'she	0
广西顺达国际旅行社	guang'xi'shun'da'guo'ji'lv'xing'she	0
广西体育国际旅行社	guang'xi'ti'yu'guo'ji'lv'xing'she	0
广西新华旅行社	guang'xi'xin'hua'lv'xing'she	0
广西友好国际旅行社	guang'xi'you'hao'guo'ji'lv'xing'she	0
广西职工国际旅行社	guang'xi'zhi'gong'guo'ji'lv'xing'she	0
广西中国青年旅行社	guang'xi'zhong'guo'qing'nian'lv'xing'she	0
广元风光旅行社	guang'yuan'feng'guang'lv'xing'she	0
广州白云山旅行社	guang'zhou'bai'yun'shan'lv'xing'she	0
广州博览旅行社	guang'zhou'bo'lan'lv'xing'she	0
广州电信通运旅行社	guang'zhou'dian'xin'tong'yun'lv'xing'she	0
广州鹅潭旅行社	guang'zhou'e'tan'lv'xing'she	0
广州工贸旅行社	guang'zhou'gong'mao'lv'xing'she	0
广州华龄老年旅行社	guang'zhou'hua'ling'lao'nian'lv'xing'she	0
广州花园国际旅行社	guang'zhou'hua'yuan'guo'ji'lv'xing'she	0
广州交通旅行社	guang'zhou'jiao'tong'lv'xing'she	0
广州开元国际旅行社	guang'zhou'kai'yuan'guo'ji'lv'xing'she	0
广州康辉国际旅行社	guang'zhou'kang'hui'guo'ji'lv'xing'she	0
广州岭南旅行社	guang'zhou'ling'nan'lv'xing'she	0
广州流花风采旅行社	guang'zhou'liu'hua'feng'cai'lv'xing'she	0
广州南方旅行社	guang'zhou'nan'fang'lv'xing'she	0
广州南山世纪旅行社	guang'zhou'nan'shan'shi'ji'lv'xing'she	0
广州青年旅行社	guang'zhou'qing'nian'lv'xing'she	0
广州市广视旅行社	guang'zhou'shi'guang'shi'lv'xing'she	0
广州市黄金假日旅行社	guang'zhou'shi'huang'jin'jia'ri'lv'xing'she	0
广州市金粤旅行社	guang'zhou'shi'jin'yue'lv'xing'she	0
广州市康乐旅行社	guang'zhou'shi'kang'le'lv'xing'she	0
广州市丽景国际旅行社	guang'zhou'shi'li'jing'guo'ji'lv'xing'she	0
广州市山海天旅行社	guang'zhou'shi'shan'hai'tian'lv'xing'she	0
广州市天马国际旅行社	guang'zhou'shi'tian'ma'guo'ji'lv'xing'she	0
广州市通达旅行社	guang'zhou'shi'tong'da'lv'xing'she	0
广州市五羊旅行社	guang'zhou'shi'wu'yang'lv'xing'she	0
广州市羊城国际旅行社	guang'zhou'shi'yang'cheng'guo'ji'lv'xing'she	0
广州市园林旅行社	guang'zhou'shi'yuan'lin'lv'xing'she	0
广州市中国旅行社	guang'zhou'shi'zhong'guo'lv'xing'she	0
广州天马国际旅行社	guang'zhou'tian'ma'guo'ji'lv'xing'she	0
广州新荔枝湾旅行社	guang'zhou'xin'li'zhi'wan'lv'xing'she	0
广州阳光假日旅行社	guang'zhou'yang'guang'jia'ri'lv'xing'she	0
广州怡华旅行社	guang'zhou'yi'hua'lv'xing'she	0
广州职工旅行社	guang'zhou'zhi'gong'lv'xing'she	0
广州中燃国际旅行社	guang'zhou'zhong'ran'guo'ji'lv'xing'she	0
贵池市九华风光旅行社	gui'chi'shi'jiu'hua'feng'guang'lv'xing'she	0
贵池市杏花村旅行社	gui'chi'shi'xing'hua'cun'lv'xing'she	0
桂林大世界旅行社	gui'lin'da'shi'jie'lv'xing'she	0
桂林东方旅行社	gui'lin'dong'fang'lv'xing'she	0
桂林桂都旅行社	gui'lin'gui'dou'lv'xing'she	0
桂林桂冠国际旅行社	gui'lin'gui'guan'guo'ji'lv'xing'she	0
桂林桂航旅行社	gui'lin'gui'hang'lv'xing'she	0
桂林桂协假日旅行社	gui'lin'gui'xie'jia'ri'lv'xing'she	0
桂林集琦旅行社	gui'lin'ji'qi'lv'xing'she	0
桂林假日旅行社	gui'lin'jia'ri'lv'xing'she	0
桂林江山国际旅行社	gui'lin'jiang'shan'guo'ji'lv'xing'she	0
桂林捷威旅行社	gui'lin'jie'wei'lv'xing'she	0
桂林康迪旅行社	gui'lin'kang'di'lv'xing'she	0
桂林联谊旅行社	gui'lin'lian'yi'lv'xing'she	0
桂林岭南旅行社	gui'lin'ling'nan'lv'xing'she	0
桂林名城旅行社	gui'lin'ming'cheng'lv'xing'she	0
桂林山水国际旅行社	gui'lin'shan'shui'guo'ji'lv'xing'she	0
桂林市长城旅行社	gui'lin'shi'chang'cheng'lv'xing'she	0
桂林市妇女旅行社	gui'lin'shi'fu'nv'lv'xing'she	0
桂林市桂航旅行社	gui'lin'shi'gui'hang'lv'xing'she	0
桂林市和顺旅行社	gui'lin'shi'he'shun'lv'xing'she	0
桂林市华林旅行社	gui'lin'shi'hua'lin'lv'xing'she	0
桂林市环球国际旅行社	gui'lin'shi'huan'qiu'guo'ji'lv'xing'she	0
桂林市教育旅行社	gui'lin'shi'jiao'yu'lv'xing'she	0
桂林市景丽旅行社	gui'lin'shi'jing'li'lv'xing'she	0
桂林市美景旅行社	gui'lin'shi'mei'jing'lv'xing'she	0
桂林市七星旅行社	gui'lin'shi'qi'xing'lv'xing'she	0
桂林市前进旅行社	gui'lin'shi'qian'jin'lv'xing'she	0
桂林市青年旅行社	gui'lin'shi'qing'nian'lv'xing'she	0
桂林市榕湖国际旅行社	gui'lin'shi'rong'hu'guo'ji'lv'xing'she	0
桂林市杉湖国际旅行社	gui'lin'shi'shan'hu'guo'ji'lv'xing'she	0
桂林市神州旅行社	gui'lin'shi'shen'zhou'lv'xing'she	0
桂林市台联国际旅行社	gui'lin'shi'tai'lian'guo'ji'lv'xing'she	0
桂林市天马旅行社	gui'lin'shi'tian'ma'lv'xing'she	0
桂林市新光旅行社	gui'lin'shi'xin'guang'lv'xing'she	0
桂林市新桂旅行社	gui'lin'shi'xin'gui'lv'xing'she	0
桂林市新华旅行社	gui'lin'shi'xin'hua'lv'xing'she	0
桂林市新世纪旅行社	gui'lin'shi'xin'shi'ji'lv'xing'she	0
桂林市中国国际旅行社	gui'lin'shi'zhong'guo'guo'ji'lv'xing'she	0
桂林市中联旅行社	gui'lin'shi'zhong'lian'lv'xing'she	0
桂林台联国际旅行社	gui'lin'tai'lian'guo'ji'lv'xing'she	0
桂林桃源旅行社	gui'lin'tao'yuan'lv'xing'she	0
桂林天天游大自然旅行社	gui'lin'tian'tian'you'da'zi'ran'lv'xing'she	0
桂林阳朔国际旅行社	gui'lin'yang'shuo'guo'ji'lv'xing'she	0
桂林永安旅行社	gui'lin'yong'an'lv'xing'she	0
桂林中国康辉桂林国际旅行社	gui'lin'zhong'guo'kang'hui'gui'lin'guo'ji'lv'xing'she	0
桂林竹叶舟旅行社	gui'lin'zhu'ye'zhou'lv'xing'she	0
贵阳高尔夫旅行社	gui'yang'gao'er'fu'lv'xing'she	0
贵阳公交旅行社	gui'yang'gong'jiao'lv'xing'she	0
贵阳旅行社	gui'yang'lv'xing'she	0
贵阳市花溪国际旅行社	gui'yang'shi'hua'xi'guo'ji'lv'xing'she	0
贵阳市凌云旅行社	gui'yang'shi'ling'yun'lv'xing'she	0
贵阳五环旅行社	gui'yang'wu'huan'lv'xing'she	0
贵州安顺黄果树旅行社	gui'zhou'an'shun'huang'guo'shu'lv'xing'she	0
贵州航空旅行社	gui'zhou'hang'kong'lv'xing'she	0
贵州华贸旅行社	gui'zhou'hua'mao'lv'xing'she	0
贵州教育旅行社	gui'zhou'jiao'yu'lv'xing'she	0
贵州南方航空旅行社	gui'zhou'nan'fang'hang'kong'lv'xing'she	0
贵州润达国际旅行社	gui'zhou'run'da'guo'ji'lv'xing'she	0
贵州省中国青年旅行社	gui'zhou'sheng'zhong'guo'qing'nian'lv'xing'she	0
贵州通达旅行社	gui'zhou'tong'da'lv'xing'she	0
贵州兴义市旅行社	gui'zhou'xing'yi'shi'lv'xing'she	0
贵州中国康辉旅行社	gui'zhou'zhong'guo'kang'hui'lv'xing'she	0
国际旅行社	guo'ji'lv'xing'she	0
国家建材服务中心宁波中兴旅行社	guo'jia'jian'cai'fu'wu'zhong'xin'ning'bo'zhong'xing'lv'xing'she	0
哈尔滨宝岛旅行社	ha'er'bin'bao'dao'lv'xing'she	0
哈尔滨北琴海旅行社	ha'er'bin'bei'qin'hai'lv'xing'she	0
哈尔滨冰城旅行社	ha'er'bin'bing'cheng'lv'xing'she	0
哈尔滨冰灯旅行社	ha'er'bin'bing'deng'lv'xing'she	0
哈尔滨冰雪旅行社	ha'er'bin'bing'xue'lv'xing'she	0
哈尔滨电业旅行社	ha'er'bin'dian'ye'lv'xing'she	0
哈尔滨东北旅行社	ha'er'bin'dong'bei'lv'xing'she	0
哈尔滨东方文化旅行社	ha'er'bin'dong'fang'wen'hua'lv'xing'she	0
哈尔滨风光旅行社	ha'er'bin'feng'guang'lv'xing'she	0
哈尔滨工大新世纪旅行社	ha'er'bin'gong'da'xin'shi'ji'lv'xing'she	0
哈尔滨观光国际旅行社	ha'er'bin'guan'guang'guo'ji'lv'xing'she	0
哈尔滨好时光旅行社	ha'er'bin'hao'shi'guang'lv'xing'she	0
哈尔滨和平旅行社	ha'er'bin'he'ping'lv'xing'she	0
哈尔滨鸿达旅行社	ha'er'bin'hong'da'lv'xing'she	0
哈尔滨红盾旅行社	ha'er'bin'hong'dun'lv'xing'she	0
哈尔滨华运国际旅行社	ha'er'bin'hua'yun'guo'ji'lv'xing'she	0
哈尔滨欢乐北国旅行社	ha'er'bin'huan'le'bei'guo'lv'xing'she	0
哈尔滨环宇旅行社	ha'er'bin'huan'yu'lv'xing'she	0
哈尔滨火车站旅行社	ha'er'bin'huo'che'zhan'lv'xing'she	0
哈尔滨佳威旅行社	ha'er'bin'jia'wei'lv'xing'she	0
哈尔滨交通旅行社	ha'er'bin'jiao'tong'lv'xing'she	0
哈尔滨金信国际旅行社	ha'er'bin'jin'xin'guo'ji'lv'xing'she	0
哈尔滨金阳光旅行社	ha'er'bin'jin'yang'guang'lv'xing'she	0
哈尔滨口岸旅行社	ha'er'bin'kou'an'lv'xing'she	0
哈尔滨蓝太阳商务旅行社	ha'er'bin'lan'tai'yang'shang'wu'lv'xing'she	0
哈尔滨龙腾旅行社	ha'er'bin'long'teng'lv'xing'she	0
哈尔滨三发电力旅行社	ha'er'bin'san'fa'dian'li'lv'xing'she	0
哈尔滨商会旅行社	ha'er'bin'shang'hui'lv'xing'she	0
哈尔滨市江帆旅行社	ha'er'bin'shi'jiang'fan'lv'xing'she	0
哈尔滨太平洋旅行社	ha'er'bin'tai'ping'yang'lv'xing'she	0
哈尔滨天发旅行社	ha'er'bin'tian'fa'lv'xing'she	0
哈尔滨天谊旅行社	ha'er'bin'tian'yi'lv'xing'she	0
哈尔滨天竹旅行社	ha'er'bin'tian'zhu'lv'xing'she	0
哈尔滨外贸旅行社	ha'er'bin'wai'mao'lv'xing'she	0
哈尔滨西苑旅行社	ha'er'bin'xi'yuan'lv'xing'she	0
哈尔滨夏日旅行社	ha'er'bin'xia'ri'lv'xing'she	0
哈尔滨新闻旅行社	ha'er'bin'xin'wen'lv'xing'she	0
哈尔滨雪龙旅行社	ha'er'bin'xue'long'lv'xing'she	0
哈尔滨邮电国际旅行社	ha'er'bin'you'dian'guo'ji'lv'xing'she	0
哈尔滨正大旅行社	ha'er'bin'zheng'da'lv'xing'she	0
哈尔滨职工旅行社	ha'er'bin'zhi'gong'lv'xing'she	0
哈尔滨中福旅行社	ha'er'bin'zhong'fu'lv'xing'she	0
哈尔滨中国国际旅行社	ha'er'bin'zhong'guo'guo'ji'lv'xing'she	0
哈尔滨中国康辉国际旅行社	ha'er'bin'zhong'guo'kang'hui'guo'ji'lv'xing'she	0
哈尔滨中国旅行社	ha'er'bin'zhong'guo'lv'xing'she	0
哈尔滨中隆旅行社	ha'er'bin'zhong'long'lv'xing'she	0
哈尔滨中央商城旅行社	ha'er'bin'zhong'yang'shang'cheng'lv'xing'she	0
海安县交通旅行社	hai'an'xian'jiao'tong'lv'xing'she	0
海大旅行社	hai'da'lv'xing'she	0
海口国际酒店旅游管理学校海口教育旅行社	hai'kou'guo'ji'jiu'dian'lv'you'guan'li'xue'xiao'hai'kou'jiao'yu'lv'xing'she	0
海口中国青年旅行社	hai'kou'zhong'guo'qing'nian'lv'xing'she	0
海门市友谊旅行社	hai'men'shi'you'yi'lv'xing'she	0
海南春华旅行社	hai'nan'chun'hua'lv'xing'she	0
海南春秋旅行社	hai'nan'chun'qiu'lv'xing'she	0
海南第一商务网络旅行社	hai'nan'di'yi'shang'wu'wang'luo'lv'xing'she	0
海南东方国际旅行社	hai'nan'dong'fang'guo'ji'lv'xing'she	0
海南东方生态旅行社	hai'nan'dong'fang'sheng'tai'lv'xing'she	0
海南鹅潭旅行社	hai'nan'e'tan'lv'xing'she	0
海南高速公路旅行社	hai'nan'gao'su'gong'lu'lv'xing'she	0
海南国泰旅行社	hai'nan'guo'tai'lv'xing'she	0
海南海口市中国旅行社	hai'nan'hai'kou'shi'zhong'guo'lv'xing'she	0
海南海王国际旅行社	hai'nan'hai'wang'guo'ji'lv'xing'she	0
海南海韵旅行社	hai'nan'hai'yun'lv'xing'she	0
海南航空国际旅行社	hai'nan'hang'kong'guo'ji'lv'xing'she	0
海南虹桥旅行社	hai'nan'hong'qiao'lv'xing'she	0
海南华能旅行社	hai'nan'hua'neng'lv'xing'she	0
海南佳路达国际旅行社	hai'nan'jia'lu'da'guo'ji'lv'xing'she	0
海南教育旅行社	hai'nan'jiao'yu'lv'xing'she	0
海南金卡旅行社	hai'nan'jin'ka'lv'xing'she	0
海南金融培训中心旅行社	hai'nan'jin'rong'pei'xun'zhong'xin'lv'xing'she	0
海南京润国际旅行社	hai'nan'jing'run'guo'ji'lv'xing'she	0
海南六合旅行社	hai'nan'lu'he'lv'xing'she	0
海南绿岛假日旅行社	hai'nan'lv'dao'jia'ri'lv'xing'she	0
海南民航国际旅行社	hai'nan'min'hang'guo'ji'lv'xing'she	0
海南平和旅行社	hai'nan'ping'he'lv'xing'she	0
海南七仙岭旅行社	hai'nan'qi'xian'ling'lv'xing'she	0
海南汽运国际旅行社	hai'nan'qi'yun'guo'ji'lv'xing'she	0
海南琼州旅行社	hai'nan'qiong'zhou'lv'xing'she	0
海南省府机关旅行社	hai'nan'sheng'fu'ji'guan'lv'xing'she	0
海南省高速公路旅行社	hai'nan'sheng'gao'su'gong'lu'lv'xing'she	0
海南省海运旅行社	hai'nan'sheng'hai'yun'lv'xing'she	0
海南省金马旅行社	hai'nan'sheng'jin'ma'lv'xing'she	0
海南省路路通旅行社	hai'nan'sheng'lu'lu'tong'lv'xing'she	0
海南省民族旅行社	hai'nan'sheng'min'zu'lv'xing'she	0
海南省南天旅行社	hai'nan'sheng'nan'tian'lv'xing'she	0
海南省农垦旅行社	hai'nan'sheng'nong'ken'lv'xing'she	0
海南省三亚中国旅行社	hai'nan'sheng'san'ya'zhong'guo'lv'xing'she	0
海南省霞客旅行社	hai'nan'sheng'xia'ke'lv'xing'she	0
海南省阳光假日旅行社	hai'nan'sheng'yang'guang'jia'ri'lv'xing'she	0
海南省远东旅行社	hai'nan'sheng'yuan'dong'lv'xing'she	0
海南省职工国际旅行社	hai'nan'sheng'zhi'gong'guo'ji'lv'xing'she	0
海南省中国国际旅行社	hai'nan'sheng'zhong'guo'guo'ji'lv'xing'she	0
海南省中国旅行社	hai'nan'sheng'zhong'guo'lv'xing'she	0
海南省中旅假日旅行社	hai'nan'sheng'zhong'lv'jia'ri'lv'xing'she	0
海南台海旅行社	hai'nan'tai'hai'lv'xing'she	0
海南泰华旅行社	hai'nan'tai'hua'lv'xing'she	0
海南太平洋国际旅行社	hai'nan'tai'ping'yang'guo'ji'lv'xing'she	0
海南太阳石国际旅行社	hai'nan'tai'yang'shi'guo'ji'lv'xing'she	0
海南特区青年旅行社	hai'nan'te'qu'qing'nian'lv'xing'she	0
海南天鹰旅行社	hai'nan'tian'ying'lv'xing'she	0
海南铁路旅行社	hai'nan'tie'lu'lv'xing'she	0
海南新华旅行社	hai'nan'xin'hua'lv'xing'she	0
海南兴邦旅行社	hai'nan'xing'bang'lv'xing'she	0
海南烟草金龙旅行社	hai'nan'yan'cao'jin'long'lv'xing'she	0
海南燕山国际旅行社	hai'nan'yan'shan'guo'ji'lv'xing'she	0
海南燕山旅行社	hai'nan'yan'shan'lv'xing'she	0
海南椰林国际旅行社	hai'nan'ye'lin'guo'ji'lv'xing'she	0
海南中皇旅行社	hai'nan'zhong'huang'lv'xing'she	0
海南珠江国际旅行社	hai'nan'zhu'jiang'guo'ji'lv'xing'she	0
海曙文化旅行社	hai'shu'wen'hua'lv'xing'she	0
海燕国际旅行社	hai'yan'guo'ji'lv'xing'she	0
海员旅行社	hai'yuan'lv'xing'she	0
海运旅行社	hai'yun'lv'xing'she	0
邯郸安逸旅行社	han'dan'an'yi'lv'xing'she	0
邯郸旅行社	han'dan'lv'xing'she	0
邯郸市欣甸旅行社	han'dan'shi'xin'dian'lv'xing'she	0
邯郸四通旅行社	han'dan'si'tong'lv'xing'she	0
邯郸中国国际旅行社	han'dan'zhong'guo'guo'ji'lv'xing'she	0
邯郸中国旅行社	han'dan'zhong'guo'lv'xing'she	0
汉中职工旅行社	han'zhong'zhi'gong'lv'xing'she	0
汉中中国国际旅行社	han'zhong'zhong'guo'guo'ji'lv'xing'she	0
航天国际旅行社	hang'tian'guo'ji'lv'xing'she	0
杭州长客旅行社	hang'zhou'chang'ke'lv'xing'she	0
杭州大厦旅行社	hang'zhou'da'sha'lv'xing'she	0
杭州大学国际文化旅行社	hang'zhou'da'xue'guo'ji'wen'hua'lv'xing'she	0
杭州德胜旅行社	hang'zhou'de'sheng'lv'xing'she	0
杭州迪佛旅行社	hang'zhou'di'fo'lv'xing'she	0
杭州东南旅行社	hang'zhou'dong'nan'lv'xing'she	0
杭州飞达航空旅行社	hang'zhou'fei'da'hang'kong'lv'xing'she	0
杭州公交旅行社	hang'zhou'gong'jiao'lv'xing'she	0
杭州国大旅行社	hang'zhou'guo'da'lv'xing'she	0
杭州国美旅行社	hang'zhou'guo'mei'lv'xing'she	0
杭州海外海旅行社	hang'zhou'hai'wai'hai'lv'xing'she	0
杭州红海旅行社	hang'zhou'hong'hai'lv'xing'she	0
杭州花园旅行社	hang'zhou'hua'yuan'lv'xing'she	0
杭州江潮旅行社	hang'zhou'jiang'chao'lv'xing'she	0
杭州教苑旅行社	hang'zhou'jiao'yuan'lv'xing'she	0
杭州金秋旅行社	hang'zhou'jin'qiu'lv'xing'she	0
杭州康康旅行社	hang'zhou'kang'kang'lv'xing'she	0
杭州科技旅行社	hang'zhou'ke'ji'lv'xing'she	0
杭州快乐旅行社	hang'zhou'kuai'le'lv'xing'she	0
杭州联谊旅行社	hang'zhou'lian'yi'lv'xing'she	0
杭州联宜旅行社	hang'zhou'lian'yi'lv'xing'she	0
杭州梅苑国际旅行社	hang'zhou'mei'yuan'guo'ji'lv'xing'she	0
杭州明珠旅行社	hang'zhou'ming'zhu'lv'xing'she	0
杭州南方旅行社	hang'zhou'nan'fang'lv'xing'she	0
杭州汽车出租公司旅行社	hang'zhou'qi'che'chu'zu'gong'si'lv'xing'she	0
杭州千岛湖青年旅行社	hang'zhou'qian'dao'hu'qing'nian'lv'xing'she	0
杭州千岛湖职工旅行社	hang'zhou'qian'dao'hu'zhi'gong'lv'xing'she	0
杭州山水旅行社	hang'zhou'shan'shui'lv'xing'she	0
杭州石化旅行社	hang'zhou'shi'hua'lv'xing'she	0
杭州市侨谊旅行社	hang'zhou'shi'qiao'yi'lv'xing'she	0
杭州市天城旅行社	hang'zhou'shi'tian'cheng'lv'xing'she	0
杭州市职工旅行社	hang'zhou'shi'zhi'gong'lv'xing'she	0
杭州市中国旅行社	hang'zhou'shi'zhong'guo'lv'xing'she	0
杭州泰康旅行社	hang'zhou'tai'kang'lv'xing'she	0
杭州太阳雨旅行社	hang'zhou'tai'yang'yu'lv'xing'she	0
杭州天城旅行社	hang'zhou'tian'cheng'lv'xing'she	0
杭州天丽旅行社	hang'zhou'tian'li'lv'xing'she	0
杭州天马旅行社	hang'zhou'tian'ma'lv'xing'she	0
杭州天堂旅行社	hang'zhou'tian'tang'lv'xing'she	0
杭州天缘旅行社	hang'zhou'tian'yuan'lv'xing'she	0
杭州外经贸旅行社	hang'zhou'wai'jing'mao'lv'xing'she	0
杭州望湖旅行社	hang'zhou'wang'hu'lv'xing'she	0
杭州文化旅行社	hang'zhou'wen'hua'lv'xing'she	0
杭州西湖旅行社	hang'zhou'xi'hu'lv'xing'she	0
杭州新华旅行社	hang'zhou'xin'hua'lv'xing'she	0
杭州旋风旅行社	hang'zhou'xuan'feng'lv'xing'she	0
杭州亚光旅行社	hang'zhou'ya'guang'lv'xing'she	0
杭州远东旅行社	hang'zhou'yuan'dong'lv'xing'she	0
杭州正大旅行社	hang'zhou'zheng'da'lv'xing'she	0
杭州中侨旅行社	hang'zhou'zhong'qiao'lv'xing'she	0
好时光旅行社	hao'shi'guang'lv'xing'she	0
河北沧州华夏旅行社	he'bei'cang'zhou'hua'xia'lv'xing'she	0
河北承德北方旅行社	he'bei'cheng'de'bei'fang'lv'xing'she	0
河北承德假日旅行社	he'bei'cheng'de'jia'ri'lv'xing'she	0
河北春秋旅行社	he'bei'chun'qiu'lv'xing'she	0
河北风光旅行社	he'bei'feng'guang'lv'xing'she	0
河北航空旅行社	he'bei'hang'kong'lv'xing'she	0
河北虹桥国际旅行社	he'bei'hong'qiao'guo'ji'lv'xing'she	0
河北汇源旅行社	he'bei'hui'yuan'lv'xing'she	0
河北省安新县白洋淀旅行社	he'bei'sheng'an'xin'xian'bai'yang'dian'lv'xing'she	0
河北省长城假日旅行社	he'bei'sheng'chang'cheng'jia'ri'lv'xing'she	0
河北省承德市教师旅行社	he'bei'sheng'cheng'de'shi'jiao'shi'lv'xing'she	0
河北省丹霞旅行社	he'bei'sheng'dan'xia'lv'xing'she	0
河北省东方国际旅行社	he'bei'sheng'dong'fang'guo'ji'lv'xing'she	0
河北省联运旅行社	he'bei'sheng'lian'yun'lv'xing'she	0
河北省森林旅行社	he'bei'sheng'sen'lin'lv'xing'she	0
河北省商务旅行社	he'bei'sheng'shang'wu'lv'xing'she	0
河北省天马旅行社	he'bei'sheng'tian'ma'lv'xing'she	0
河北省友好国际旅行社	he'bei'sheng'you'hao'guo'ji'lv'xing'she	0
河北省中国青年旅行社	he'bei'sheng'zhong'guo'qing'nian'lv'xing'she	0
河北熙苑旅行社	he'bei'xi'yuan'lv'xing'she	0
河北新世纪旅行社	he'bei'xin'shi'ji'lv'xing'she	0
河北邢台白云旅行社	he'bei'xing'tai'bai'yun'lv'xing'she	0
河北邮电旅行社	he'bei'you'dian'lv'xing'she	0
合肥都市旅行社	he'fei'du'shi'lv'xing'she	0
合肥公交总公司旅行社	he'fei'gong'jiao'zong'gong'si'lv'xing'she	0
合肥海联旅行社	he'fei'hai'lian'lv'xing'she	0
合肥火车站旅行社	he'fei'huo'che'zhan'lv'xing'she	0
合肥金良旅行社	he'fei'jin'liang'lv'xing'she	0
合肥旅行社	he'fei'lv'xing'she	0
合肥天涯旅行社	he'fei'tian'ya'lv'xing'she	0
合肥铁路东方旅行社	he'fei'tie'lu'dong'fang'lv'xing'she	0
合肥五联旅行社	he'fei'wu'lian'lv'xing'she	0
合肥新华旅行社	he'fei'xin'hua'lv'xing'she	0
合肥园林旅行社	he'fei'yuan'lin'lv'xing'she	0
鹤岗青年旅行社	he'gang'qing'nian'lv'xing'she	0
河口国际旅行社	he'kou'guo'ji'lv'xing'she	0
河南东方旅行社	he'nan'dong'fang'lv'xing'she	0
河南海峡旅行社	he'nan'hai'xia'lv'xing'she	0
河南航天旅行社	he'nan'hang'tian'lv'xing'she	0
河南建业旅行社	he'nan'jian'ye'lv'xing'she	0
河南省海峡旅行社	he'nan'sheng'hai'xia'lv'xing'she	0
河南省环球旅行社	he'nan'sheng'huan'qiu'lv'xing'she	0
河南省江河旅行社	he'nan'sheng'jiang'he'lv'xing'she	0
河南省老年旅行社	he'nan'sheng'lao'nian'lv'xing'she	0
河南省民族旅行社	he'nan'sheng'min'zu'lv'xing'she	0
河南省天马旅行社	he'nan'sheng'tian'ma'lv'xing'she	0
河南省信阳市教育旅行社	he'nan'sheng'xin'yang'shi'jiao'yu'lv'xing'she	0
河南省中国旅行社	he'nan'sheng'zhong'guo'lv'xing'she	0
河南石化旅行社	he'nan'shi'hua'lv'xing'she	0
河南嵩山少林武术旅行社	he'nan'song'shan'shao'lin'wu'shu'lv'xing'she	0
河南外运旅行社	he'nan'wai'yun'lv'xing'she	0
河南物华旅行社	he'nan'wu'hua'lv'xing'she	0
河南五洲旅行社	he'nan'wu'zhou'lv'xing'she	0
河南小浪底大河旅行社	he'nan'xiao'lang'di'da'he'lv'xing'she	0
河南协辉旅行社	he'nan'xie'hui'lv'xing'she	0
河南亚神旅行社	he'nan'ya'shen'lv'xing'she	0
河南怡人假期旅行社	he'nan'yi'ren'jia'qi'lv'xing'she	0
河南远东旅行社	he'nan'yuan'dong'lv'xing'she	0
和平旅行社	he'ping'lv'xing'she	0
鹤山市中国旅行社	he'shan'shi'zhong'guo'lv'xing'she	0
河源市东江中国旅行社	he'yuan'shi'dong'jiang'zhong'guo'lv'xing'she	0
黑河北方旅行社	hei'he'bei'fang'lv'xing'she	0
黑河旅行社	hei'he'lv'xing'she	0
黑河市远东旅行社	hei'he'shi'yuan'dong'lv'xing'she	0
黑河铁道旅行社	hei'he'tie'dao'lv'xing'she	0
黑河职工国际旅行社	hei'he'zhi'gong'guo'ji'lv'xing'she	0
黑河中国国际旅行社	hei'he'zhong'guo'guo'ji'lv'xing'she	0
黑河中国旅行社	hei'he'zhong'guo'lv'xing'she	0
黑龙江春秋旅行社	hei'long'jiang'chun'qiu'lv'xing'she	0
黑龙江电力旅行社	hei'long'jiang'dian'li'lv'xing'she	0
黑龙江妇女旅行社	hei'long'jiang'fu'nv'lv'xing'she	0
黑龙江广联旅行社	hei'long'jiang'guang'lian'lv'xing'she	0
黑龙江海峡旅行社	hei'long'jiang'hai'xia'lv'xing'she	0
黑龙江航空国际旅行社	hei'long'jiang'hang'kong'guo'ji'lv'xing'she	0
黑龙江虹桥旅行社	hei'long'jiang'hong'qiao'lv'xing'she	0
黑龙江交通旅行社	hei'long'jiang'jiao'tong'lv'xing'she	0
黑龙江摩拜尔旅行社	hei'long'jiang'mo'bai'er'lv'xing'she	0
黑龙江三和旅行社	hei'long'jiang'san'he'lv'xing'she	0
黑龙江省北疆国际旅行社	hei'long'jiang'sheng'bei'jiang'guo'ji'lv'xing'she	0
黑龙江省电力旅行社	hei'long'jiang'sheng'dian'li'lv'xing'she	0
黑龙江省花园村旅行社	hei'long'jiang'sheng'hua'yuan'cun'lv'xing'she	0
黑龙江省教育旅行社	hei'long'jiang'sheng'jiao'yu'lv'xing'she	0
黑龙江省金叶旅行社	hei'long'jiang'sheng'jin'ye'lv'xing'she	0
黑龙江省经合旅行社	hei'long'jiang'sheng'jing'he'lv'xing'she	0
黑龙江省漠河县漠河旅行社	hei'long'jiang'sheng'mo'he'xian'mo'he'lv'xing'she	0
黑龙江省绥芬河市吉信旅行社	hei'long'jiang'sheng'sui'fen'he'shi'ji'xin'lv'xing'she	0
黑龙江省绥芬河市银河旅行社	hei'long'jiang'sheng'sui'fen'he'shi'yin'he'lv'xing'she	0
黑龙江省体育国际旅行社	hei'long'jiang'sheng'ti'yu'guo'ji'lv'xing'she	0
黑龙江省物贸中心旅行社	hei'long'jiang'sheng'wu'mao'zhong'xin'lv'xing'she	0
黑龙江省中国国际旅行社	hei'long'jiang'sheng'zhong'guo'guo'ji'lv'xing'she	0
黑龙江统计旅行社	hei'long'jiang'tong'ji'lv'xing'she	0
黑龙江万达国际旅行社	hei'long'jiang'wan'da'guo'ji'lv'xing'she	0
黑龙江新天地旅行社	hei'long'jiang'xin'tian'di'lv'xing'she	0
恒山中国旅行社	heng'shan'zhong'guo'lv'xing'she	0
恒通旅行社	heng'tong'lv'xing'she	0
衡阳交通旅行社	heng'yang'jiao'tong'lv'xing'she	0
衡阳青年旅行社	heng'yang'qing'nian'lv'xing'she	0
衡阳市南岳中国国际旅行社	heng'yang'shi'nan'yue'zhong'guo'guo'ji'lv'xing'she	0
衡阳市中国国际旅行社	heng'yang'shi'zhong'guo'guo'ji'lv'xing'she	0
衡阳中国国际旅行社	heng'yang'zhong'guo'guo'ji'lv'xing'she	0
衡岳旅行社	heng'yue'lv'xing'she	0
红河电力旅行社	hong'he'dian'li'lv'xing'she	0
红河谷旅行社	hong'he'gu'lv'xing'she	0
红河州金湖旅行社	hong'he'zhou'jin'hu'lv'xing'she	0
红河州民族旅行社	hong'he'zhou'min'zu'lv'xing'she	0
鸿雁旅行社	hong'yan'lv'xing'she	0
红叶旅行社	hong'ye'lv'xing'she	0
洪泽湖旅行社	hong'ze'hu'lv'xing'she	0
湖北长江旅行社	hu'bei'chang'jiang'lv'xing'she	0
湖北鄂州康福国际旅行社	hu'bei'e'zhou'kang'fu'guo'ji'lv'xing'she	0
湖北海峡旅行社	hu'bei'hai'xia'lv'xing'she	0
湖北航空假日旅行社	hu'bei'hang'kong'jia'ri'lv'xing'she	0
湖北江河旅行社	hu'bei'jiang'he'lv'xing'she	0
湖北民间旅行社	hu'bei'min'jian'lv'xing'she	0
湖北神农架林业旅行社	hu'bei'shen'nong'jia'lin'ye'lv'xing'she	0
湖北神之旅旅行社	hu'bei'shen'zhi'lv'lv'xing'she	0
湖北省虹桥旅行社	hu'bei'sheng'hong'qiao'lv'xing'she	0
湖北省华中电力旅行社	hu'bei'sheng'hua'zhong'dian'li'lv'xing'she	0
湖北省旅行社	hu'bei'sheng'lv'xing'she	0
湖北省炎黄旅行社	hu'bei'sheng'yan'huang'lv'xing'she	0
湖北省宜昌龙盘湖旅行社	hu'bei'sheng'yi'chang'long'pan'hu'lv'xing'she	0
湖北省宜昌市三峡风情旅行社	hu'bei'sheng'yi'chang'shi'san'xia'feng'qing'lv'xing'she	0
湖北省宜昌中国青年旅行社	hu'bei'sheng'yi'chang'zhong'guo'qing'nian'lv'xing'she	0
湖北省中国国际旅行社	hu'bei'sheng'zhong'guo'guo'ji'lv'xing'she	0
湖北省中国旅行社	hu'bei'sheng'zhong'guo'lv'xing'she	0
湖北省中国青年旅行社	hu'bei'sheng'zhong'guo'qing'nian'lv'xing'she	0
湖北省中佳旅行社	hu'bei'sheng'zhong'jia'lv'xing'she	0
湖北新闻国际旅行社	hu'bei'xin'wen'guo'ji'lv'xing'she	0
湖北星桥旅行社	hu'bei'xing'qiao'lv'xing'she	0
湖北扬子江国际旅行社	hu'bei'yang'zi'jiang'guo'ji'lv'xing'she	0
湖北宜昌长阳国泰旅行社	hu'bei'yi'chang'chang'yang'guo'tai'lv'xing'she	0
湖北宜昌东方世纪旅行社	hu'bei'yi'chang'dong'fang'shi'ji'lv'xing'she	0
湖北宜昌平湖旅行社	hu'bei'yi'chang'ping'hu'lv'xing'she	0
湖北宜昌桃花村旅行社	hu'bei'yi'chang'tao'hua'cun'lv'xing'she	0
湖北宜昌文化旅行社	hu'bei'yi'chang'wen'hua'lv'xing'she	0
葫芦岛黄金假日旅行社	hu'lu'dao'huang'jin'jia'ri'lv'xing'she	0
葫芦岛市青年旅行社	hu'lu'dao'shi'qing'nian'lv'xing'she	0
呼伦贝尔根河旅行社	hu'lun'bei'er'gen'he'lv'xing'she	0
呼伦贝尔航空旅行社	hu'lun'bei'er'hang'kong'lv'xing'she	0
湖南北方旅行社	hu'nan'bei'fang'lv'xing'she	0
湖南电力旅行社	hu'nan'dian'li'lv'xing'she	0
湖南富丽华旅行社	hu'nan'fu'li'hua'lv'xing'she	0
湖南光大旅行社	hu'nan'guang'da'lv'xing'she	0
湖南海峡旅行社	hu'nan'hai'xia'lv'xing'she	0
湖南环球旅行社	hu'nan'huan'qiu'lv'xing'she	0
湖南零陵旅行社	hu'nan'ling'ling'lv'xing'she	0
湖南陋园旅行社	hu'nan'lou'yuan'lv'xing'she	0
湖南南岳衡山旅行社	hu'nan'nan'yue'heng'shan'lv'xing'she	0
湖南神驰国际旅行社	hu'nan'shen'chi'guo'ji'lv'xing'she	0
湖南神驰旅行社	hu'nan'shen'chi'lv'xing'she	0
湖南神龙国际旅行社	hu'nan'shen'long'guo'ji'lv'xing'she	0
湖南神州旅行社	hu'nan'shen'zhou'lv'xing'she	0
湖南省郴州旅行社	hu'nan'sheng'chen'zhou'lv'xing'she	0
湖南省郴州资兴旅行社	hu'nan'sheng'chen'zhou'zi'xing'lv'xing'she	0
湖南省妇女国际旅行社	hu'nan'sheng'fu'nv'guo'ji'lv'xing'she	0
湖南省金辉旅行社	hu'nan'sheng'jin'hui'lv'xing'she	0
湖南省南岳衡山旅行社	hu'nan'sheng'nan'yue'heng'shan'lv'xing'she	0
湖南省山水旅行社	hu'nan'sheng'shan'shui'lv'xing'she	0
湖南省湘西春秋旅行社	hu'nan'sheng'xiang'xi'chun'qiu'lv'xing'she	0
湖南省信达旅行社	hu'nan'sheng'xin'da'lv'xing'she	0
湖南省新世纪旅行社	hu'nan'sheng'xin'shi'ji'lv'xing'she	0
湖南省职业教育旅行社	hu'nan'sheng'zhi'ye'jiao'yu'lv'xing'she	0
湖南省中国国际旅行社	hu'nan'sheng'zhong'guo'guo'ji'lv'xing'she	0
湖南省中国旅行社	hu'nan'sheng'zhong'guo'lv'xing'she	0
湖南师大旅行社	hu'nan'shi'da'lv'xing'she	0
湖南天马国际旅行社	hu'nan'tian'ma'guo'ji'lv'xing'she	0
湖南天心旅行社	hu'nan'tian'xin'lv'xing'she	0
湖南西部张家界中国国际旅行社	hu'nan'xi'bu'zhang'jia'jie'zhong'guo'guo'ji'lv'xing'she	0
湖南潇湘国际旅行社	hu'nan'xiao'xiang'guo'ji'lv'xing'she	0
湖南潇湘旅行社	hu'nan'xiao'xiang'lv'xing'she	0
湖南新华旅行社	hu'nan'xin'hua'lv'xing'she	0
湖南永大旅行社	hu'nan'yong'da'lv'xing'she	0
湖南邮电国际旅行社	hu'nan'you'dian'guo'ji'lv'xing'she	0
湖南招商旅行社	hu'nan'zhao'shang'lv'xing'she	0
湖南职工国际旅行社	hu'nan'zhi'gong'guo'ji'lv'xing'she	0
湖州安吉县禾田旅行社	hu'zhou'an'ji'xian'he'tian'lv'xing'she	0
湖州安吉竹乡森林旅行社	hu'zhou'an'ji'zhu'xiang'sen'lin'lv'xing'she	0
湖州宝马旅行社	hu'zhou'bao'ma'lv'xing'she	0
湖州长兴交通旅行社	hu'zhou'chang'xing'jiao'tong'lv'xing'she	0
湖州长兴县旅行社	hu'zhou'chang'xing'xian'lv'xing'she	0
湖州长兴县铁路旅行社	hu'zhou'chang'xing'xian'tie'lu'lv'xing'she	0
湖州德清旅行社	hu'zhou'de'qing'lv'xing'she	0
湖州国际旅行社	hu'zhou'guo'ji'lv'xing'she	0
湖州国谊旅行社	hu'zhou'guo'yi'lv'xing'she	0
湖州交通旅行社	hu'zhou'jiao'tong'lv'xing'she	0
湖州莫干山风景区旅行社	hu'zhou'mo'gan'shan'feng'jing'qu'lv'xing'she	0
湖州生力集团公司南浔旅行社	hu'zhou'sheng'li'ji'tuan'gong'si'nan'xun'lv'xing'she	0
湖州市天涯旅行社	hu'zhou'shi'tian'ya'lv'xing'she	0
湖州市浙北旅行社	hu'zhou'shi'zhe'bei'lv'xing'she	0
湖州天涯旅行社	hu'zhou'tian'ya'lv'xing'she	0
湖州万通旅行社	hu'zhou'wan'tong'lv'xing'she	0
湖州一洲旅行社	hu'zhou'yi'zhou'lv'xing'she	0
湖州远洋旅行社	hu'zhou'yuan'yang'lv'xing'she	0
湖州中国国际旅行社	hu'zhou'zhong'guo'guo'ji'lv'xing'she	0
湖州中国旅行社	hu'zhou'zhong'guo'lv'xing'she	0
华安县华侨旅行社	hua'an'xian'hua'qiao'lv'xing'she	0
华林旅行社	hua'lin'lv'xing'she	0
华美旅行社	hua'mei'lv'xing'she	0
华商国际旅行社	hua'shang'guo'ji'lv'xing'she	0
华堂国际旅行社	hua'tang'guo'ji'lv'xing'she	0
华西旅行社	hua'xi'lv'xing'she	0
华夏旅行社	hua'xia'lv'xing'she	0
华鑫旅行社	hua'xin'lv'xing'she	0
华阳国际商务旅行社	hua'yang'guo'ji'shang'wu'lv'xing'she	0
华运旅行社	hua'yun'lv'xing'she	0
华中科技大学旅行社	hua'zhong'ke'ji'da'xue'lv'xing'she	0
化州市中国旅行社	hua'zhou'shi'zhong'guo'lv'xing'she	0
淮安楚天旅行社	huai'an'chu'tian'lv'xing'she	0
淮安第一洲旅行社	huai'an'di'yi'zhou'lv'xing'she	0
淮安东方旅行社	huai'an'dong'fang'lv'xing'she	0
淮安交通旅行社	huai'an'jiao'tong'lv'xing'she	0
淮安旅行社	huai'an'lv'xing'she	0
淮安市京杭旅行社	huai'an'shi'jing'hang'lv'xing'she	0
淮安市天马旅行社	huai'an'shi'tian'ma'lv'xing'she	0
淮安市翔宇旅行社	huai'an'shi'xiang'yu'lv'xing'she	0
淮安市职工旅行社	huai'an'shi'zhi'gong'lv'xing'she	0
淮安翔宇旅行社	huai'an'xiang'yu'lv'xing'she	0
怀化铁道旅行社	huai'hua'tie'dao'lv'xing'she	0
怀化铁路国际旅行社	huai'hua'tie'lu'guo'ji'lv'xing'she	0
怀化西南旅行社	huai'hua'xi'nan'lv'xing'she	0
怀化先行旅行社	huai'hua'xian'xing'lv'xing'she	0
环球国际旅行社	huan'qiu'guo'ji'lv'xing'she	0
环球旅行社	huan'qiu'lv'xing'she	0
黄山安港旅行社	huang'shan'an'gang'lv'xing'she	0
黄山北京钟声旅行社	huang'shan'bei'jing'zhong'sheng'lv'xing'she	0
黄山东华国际旅行社	huang'shan'dong'hua'guo'ji'lv'xing'she	0
黄山风景区东方旅行社	huang'shan'feng'jing'qu'dong'fang'lv'xing'she	0
黄山风景区交通旅行社	huang'shan'feng'jing'qu'jiao'tong'lv'xing'she	0
黄山福缘旅行社	huang'shan'fu'yuan'lv'xing'she	0
黄山广视旅行社	huang'shan'guang'shi'lv'xing'she	0
黄山海外旅行社	huang'shan'hai'wai'lv'xing'she	0
黄山海燕旅行社	huang'shan'hai'yan'lv'xing'she	0
黄山鸿雁旅行社	huang'shan'hong'yan'lv'xing'she	0
黄山华能旅行社	huang'shan'hua'neng'lv'xing'she	0
黄山徽州国际旅行社	huang'shan'hui'zhou'guo'ji'lv'xing'she	0
黄山徽州协和旅行社	huang'shan'hui'zhou'xie'he'lv'xing'she	0
黄山假日旅行社	huang'shan'jia'ri'lv'xing'she	0
黄山金良旅行社	huang'shan'jin'liang'lv'xing'she	0
黄山金融国际旅行社	huang'shan'jin'rong'guo'ji'lv'xing'she	0
黄山南方旅行社	huang'shan'nan'fang'lv'xing'she	0
黄山平安旅行社	huang'shan'ping'an'lv'xing'she	0
黄山区中国旅行社	huang'shan'qu'zhong'guo'lv'xing'she	0
黄山山水国际旅行社	huang'shan'shan'shui'guo'ji'lv'xing'she	0
黄山商务旅行社	huang'shan'shang'wu'lv'xing'she	0
黄山市白鸽旅行社	huang'shan'shi'bai'ge'lv'xing'she	0
黄山市春雨旅行社	huang'shan'shi'chun'yu'lv'xing'she	0
黄山市度假旅行社	huang'shan'shi'du'jia'lv'xing'she	0
黄山市光大旅行社	huang'shan'shi'guang'da'lv'xing'she	0
黄山市国脉邮电旅行社	huang'shan'shi'guo'mai'you'dian'lv'xing'she	0
黄山市国贸旅行社	huang'shan'shi'guo'mao'lv'xing'she	0
黄山市海谊旅行社	huang'shan'shi'hai'yi'lv'xing'she	0
黄山市和平旅行社	huang'shan'shi'he'ping'lv'xing'she	0
黄山市黄山东方旅行社	huang'shan'shi'huang'shan'dong'fang'lv'xing'she	0
黄山市徽州教育旅行社	huang'shan'shi'hui'zhou'jiao'yu'lv'xing'she	0
黄山市徽州金谷旅行社	huang'shan'shi'hui'zhou'jin'gu'lv'xing'she	0
黄山市徽州旅行社	huang'shan'shi'hui'zhou'lv'xing'she	0
黄山市徽州协和旅行社	huang'shan'shi'hui'zhou'xie'he'lv'xing'she	0
黄山市金龙旅行社	huang'shan'shi'jin'long'lv'xing'she	0
黄山市京达旅行社	huang'shan'shi'jing'da'lv'xing'she	0
黄山市山水国际旅行社	huang'shan'shi'shan'shui'guo'ji'lv'xing'she	0
黄山市深渡旅行社	huang'shan'shi'shen'du'lv'xing'she	0
黄山市天马旅行社	huang'shan'shi'tian'ma'lv'xing'she	0
黄山市屯溪假日观光旅行社	huang'shan'shi'tun'xi'jia'ri'guan'guang'lv'xing'she	0
黄山市外贸旅行社	huang'shan'shi'wai'mao'lv'xing'she	0
黄山市冶金旅行社	huang'shan'shi'ye'jin'lv'xing'she	0
黄山市银鹰旅行社	huang'shan'shi'yin'ying'lv'xing'she	0
黄山市中国旅行社	huang'shan'shi'zhong'guo'lv'xing'she	0
黄山市中兴旅行社	huang'shan'shi'zhong'xing'lv'xing'she	0
黄山顺达旅行社	huang'shan'shun'da'lv'xing'she	0
黄山汤口旅行社	huang'shan'tang'kou'lv'xing'she	0
黄山铁路旅行社	huang'shan'tie'lu'lv'xing'she	0
黄山铁四局旅行社	huang'shan'tie'si'ju'lv'xing'she	0
黄山五府旅行社	huang'shan'wu'fu'lv'xing'she	0
黄山仙境旅行社	huang'shan'xian'jing'lv'xing'she	0
黄山新安旅行社	huang'shan'xin'an'lv'xing'she	0
黄山星火旅行社	huang'shan'xing'huo'lv'xing'she	0
黄山艺苑旅行社	huang'shan'yi'yuan'lv'xing'she	0
黄山邮电旅行社	huang'shan'you'dian'lv'xing'she	0
黄山原野旅行社	huang'shan'yuan'ye'lv'xing'she	0
黄山招商国际旅行社	huang'shan'zhao'shang'guo'ji'lv'xing'she	0
黄土地旅行社	huang'tu'di'lv'xing'she	0
黄岩交通旅行社	huang'yan'jiao'tong'lv'xing'she	0
黄岩旅行社	huang'yan'lv'xing'she	0
黄岩天马旅行社	huang'yan'tian'ma'lv'xing'she	0
惠安天马旅行社	hui'an'tian'ma'lv'xing'she	0
惠安县中国旅行社	hui'an'xian'zhong'guo'lv'xing'she	0
惠安中国旅行社	hui'an'zhong'guo'lv'xing'she	0
惠东县中国旅行社	hui'dong'xian'zhong'guo'lv'xing'she	0
惠阳市中国旅行社	hui'yang'shi'zhong'guo'lv'xing'she	0
徽州金谷旅行社	hui'zhou'jin'gu'lv'xing'she	0
惠州市飞马旅行社	hui'zhou'shi'fei'ma'lv'xing'she	0
惠州市环宇国际旅行社	hui'zhou'shi'huan'yu'guo'ji'lv'xing'she	0
惠州市中国旅行社	hui'zhou'shi'zhong'guo'lv'xing'she	0
珲春市大正旅行社	hun'chun'shi'da'zheng'lv'xing'she	0
伙伴旅行社	huo'ban'lv'xing'she	0
吉安地区井冈山海外旅行社	ji'an'di'qu'jing'gang'shan'hai'wai'lv'xing'she	0
吉安地区井冈山旅行社	ji'an'di'qu'jing'gang'shan'lv'xing'she	0
吉安地区良友旅行社	ji'an'di'qu'liang'you'lv'xing'she	0
吉安地区中国国际旅行社	ji'an'di'qu'zhong'guo'guo'ji'lv'xing'she	0
吉安井冈山旅行社	ji'an'jing'gang'shan'lv'xing'she	0
吉安市华侨旅行社	ji'an'shi'hua'qiao'lv'xing'she	0
吉安市黄洋界旅行社	ji'an'shi'huang'yang'jie'lv'xing'she	0
吉安市井冈山春秋旅行社	ji'an'shi'jing'gang'shan'chun'qiu'lv'xing'she	0
吉安铁路旅行社	ji'an'tie'lu'lv'xing'she	0
吉安文山旅行社	ji'an'wen'shan'lv'xing'she	0
吉林省长春长白山国际旅行社	ji'lin'sheng'chang'chun'chang'bai'shan'guo'ji'lv'xing'she	0
吉林省长春东北亚铁港旅行社	ji'lin'sheng'chang'chun'dong'bei'ya'tie'gang'lv'xing'she	0
吉林省长春妇女国际旅行社	ji'lin'sheng'chang'chun'fu'nv'guo'ji'lv'xing'she	0
吉林省长春和平旅行社	ji'lin'sheng'chang'chun'he'ping'lv'xing'she	0
吉林省长春教育旅行社	ji'lin'sheng'chang'chun'jiao'yu'lv'xing'she	0
吉林省长春天马国际旅行社	ji'lin'sheng'chang'chun'tian'ma'guo'ji'lv'xing'she	0
吉林省长春邮电旅行社	ji'lin'sheng'chang'chun'you'dian'lv'xing'she	0
吉林省长春职工旅行社	ji'lin'sheng'chang'chun'zhi'gong'lv'xing'she	0
吉林省长春中国国际旅行社	ji'lin'sheng'chang'chun'zhong'guo'guo'ji'lv'xing'she	0
吉林省长春中国青年旅行社	ji'lin'sheng'chang'chun'zhong'guo'qing'nian'lv'xing'she	0
吉林省海峡旅行社	ji'lin'sheng'hai'xia'lv'xing'she	0
吉林省珲春国际旅行社	ji'lin'sheng'hun'chun'guo'ji'lv'xing'she	0
吉林省名门国际旅行社	ji'lin'sheng'ming'men'guo'ji'lv'xing'she	0
吉林市沪东旅行社	ji'lin'shi'hu'dong'lv'xing'she	0
吉林市假日旅行社	ji'lin'shi'jia'ri'lv'xing'she	0
吉林市商务旅行社	ji'lin'shi'shang'wu'lv'xing'she	0
吉林市铁路旅行社	ji'lin'shi'tie'lu'lv'xing'she	0
吉林市雾凇旅行社	ji'lin'shi'wu'song'lv'xing'she	0
吉林市银通国际旅行社	ji'lin'shi'yin'tong'guo'ji'lv'xing'she	0
吉林市职工旅行社	ji'lin'shi'zhi'gong'lv'xing'she	0
吉林市中国国际旅行社	ji'lin'shi'zhong'guo'guo'ji'lv'xing'she	0
吉林市中国旅行社	ji'lin'shi'zhong'guo'lv'xing'she	0
吉林市中山旅行社	ji'lin'shi'zhong'shan'lv'xing'she	0
吉林铁道旅行社	ji'lin'tie'dao'lv'xing'she	0
吉林铁路分局铁道旅行社	ji'lin'tie'lu'fen'ju'tie'dao'lv'xing'she	0
济南旅行社	ji'nan'lv'xing'she	0
济南市联运旅行社	ji'nan'shi'lian'yun'lv'xing'she	0
济南市中国旅行社	ji'nan'shi'zhong'guo'lv'xing'she	0
济南舜耕旅行社	ji'nan'shun'geng'lv'xing'she	0
济南天马旅行社	ji'nan'tian'ma'lv'xing'she	0
济南铁路天龙旅行社	ji'nan'tie'lu'tian'long'lv'xing'she	0
济南银河旅行社	ji'nan'yin'he'lv'xing'she	0
济南友朋旅行社	ji'nan'you'peng'lv'xing'she	0
济宁国际旅行社	ji'ning'guo'ji'lv'xing'she	0
吉首市中国旅行社	ji'shou'shi'zhong'guo'lv'xing'she	0
鸡西站旅行社	ji'xi'zhan'lv'xing'she	0
济源市九里沟旅行社	ji'yuan'shi'jiu'li'gou'lv'xing'she	0
济源市天坛旅行社	ji'yuan'shi'tian'tan'lv'xing'she	0
济源市王屋山旅行社	ji'yuan'shi'wang'wu'shan'lv'xing'she	0
济源市五龙旅行社	ji'yuan'shi'wu'long'lv'xing'she	0
济源市小浪底旅行社	ji'yuan'shi'xiao'lang'di'lv'xing'she	0
济源市阳光旅行社	ji'yuan'shi'yang'guang'lv'xing'she	0
假日旅行社	jia'ri'lv'xing'she	0
加善旅行社	jia'shan'lv'xing'she	0
嘉善西塘旅行社	jia'shan'xi'tang'lv'xing'she	0
嘉兴嘉善旅行社	jia'xing'jia'shan'lv'xing'she	0
嘉兴南湖旅行社	jia'xing'nan'hu'lv'xing'she	0
嘉兴市白云旅行社	jia'xing'shi'bai'yun'lv'xing'she	0
嘉兴市城区旅行社	jia'xing'shi'cheng'qu'lv'xing'she	0
嘉兴市大地旅行社	jia'xing'shi'da'di'lv'xing'she	0
嘉兴市港澳联谊旅行社	jia'xing'shi'gang'ao'lian'yi'lv'xing'she	0
嘉兴市航运总公司南湖旅行社	jia'xing'shi'hang'yun'zong'gong'si'nan'hu'lv'xing'she	0
嘉兴市教育旅行社	jia'xing'shi'jiao'yu'lv'xing'she	0
嘉兴市旅行社	jia'xing'shi'lv'xing'she	0
嘉兴市南方旅行社	jia'xing'shi'nan'fang'lv'xing'she	0
嘉兴市新世纪教育旅行社	jia'xing'shi'xin'shi'ji'jiao'yu'lv'xing'she	0
嘉兴市秀城区旅行社	jia'xing'shi'xiu'cheng'qu'lv'xing'she	0
嘉兴市中山旅行社	jia'xing'shi'zhong'shan'lv'xing'she	0
嘉兴铁龙旅行社	jia'xing'tie'long'lv'xing'she	0
嘉峪关长城旅行社	jia'yu'guan'chang'cheng'lv'xing'she	0
嘉峪关国际旅行社	jia'yu'guan'guo'ji'lv'xing'she	0
嘉峪关金龙旅行社	jia'yu'guan'jin'long'lv'xing'she	0
嘉峪关新丝路旅行社	jia'yu'guan'xin'si'lu'lv'xing'she	0
建德金茂旅行社	jian'de'jin'mao'lv'xing'she	0
建德市东方物产旅行社	jian'de'shi'dong'fang'wu'chan'lv'xing'she	0
建德市交通旅行社	jian'de'shi'jiao'tong'lv'xing'she	0
建德市千岛湖教育旅行社	jian'de'shi'qian'dao'hu'jiao'yu'lv'xing'she	0
建德市三友旅行社	jian'de'shi'san'you'lv'xing'she	0
建德市雾朦胧旅行社	jian'de'shi'wu'meng'long'lv'xing'she	0
建德市新安江桔园旅行社	jian'de'shi'xin'an'jiang'jie'yuan'lv'xing'she	0
建德市新安江旅行社	jian'de'shi'xin'an'jiang'lv'xing'she	0
建德市职工旅行社	jian'de'shi'zhi'gong'lv'xing'she	0
建德新安江地质旅行社	jian'de'xin'an'jiang'di'zhi'lv'xing'she	0
建德中国旅行社	jian'de'zhong'guo'lv'xing'she	0
建湖长城旅行社	jian'hu'chang'cheng'lv'xing'she	0
建水旅行社	jian'shui'lv'xing'she	0
江都市环球旅行社	jiang'du'shi'huan'qiu'lv'xing'she	0
江都市中国旅行社	jiang'du'shi'zhong'guo'lv'xing'she	0
江都雄都旅行社	jiang'du'xiong'dou'lv'xing'she	0
江郎山旅行社	jiang'lang'shan'lv'xing'she	0
将乐三华旅行社	jiang'le'san'hua'lv'xing'she	0
将乐县芳华旅行社	jiang'le'xian'fang'hua'lv'xing'she	0
江苏东方航空国际旅行社	jiang'su'dong'fang'hang'kong'guo'ji'lv'xing'she	0
江苏海达国际旅行社	jiang'su'hai'da'guo'ji'lv'xing'she	0
江苏河海汽车出租服务公司河海旅行社	jiang'su'he'hai'qi'che'chu'zu'fu'wu'gong'si'he'hai'lv'xing'she	0
江苏华夏航空服务有限公司华夏旅行社	jiang'su'hua'xia'hang'kong'fu'wu'you'xian'gong'si'hua'xia'lv'xing'she	0
江苏淮州旅行社	jiang'su'huai'zhou'lv'xing'she	0
江苏江隆外贸旅行社	jiang'su'jiang'long'wai'mao'lv'xing'she	0
江苏交通民展公司交通旅行社	jiang'su'jiao'tong'min'zhan'gong'si'jiao'tong'lv'xing'she	0
江苏教育国际旅行社	jiang'su'jiao'yu'guo'ji'lv'xing'she	0
江苏民族国际旅行社	jiang'su'min'zu'guo'ji'lv'xing'she	0
江苏南方旅行社	jiang'su'nan'fang'lv'xing'she	0
江苏山水旅行社	jiang'su'shan'shui'lv'xing'she	0
江苏省华侨旅行社	jiang'su'sheng'hua'qiao'lv'xing'she	0
江苏省金阳光旅行社	jiang'su'sheng'jin'yang'guang'lv'xing'she	0
江苏省句容旅行社	jiang'su'sheng'ju'rong'lv'xing'she	0
江苏省连云港市中联旅行社	jiang'su'sheng'lian'yun'gang'shi'zhong'lian'lv'xing'she	0
江苏省民族国际旅行社	jiang'su'sheng'min'zu'guo'ji'lv'xing'she	0
江苏省农垦旅行社	jiang'su'sheng'nong'ken'lv'xing'she	0
江苏省泰兴市春秋旅行社	jiang'su'sheng'tai'xing'shi'chun'qiu'lv'xing'she	0
江苏省体育国际旅行社	jiang'su'sheng'ti'yu'guo'ji'lv'xing'she	0
江苏省天马旅行社	jiang'su'sheng'tian'ma'lv'xing'she	0
江苏省外贸旅行社	jiang'su'sheng'wai'mao'lv'xing'she	0
江苏省中国旅行社	jiang'su'sheng'zhong'guo'lv'xing'she	0
江苏舜天国际旅行社	jiang'su'shun'tian'guo'ji'lv'xing'she	0
江苏同源国际旅行社	jiang'su'tong'yuan'guo'ji'lv'xing'she	0
江苏通远旅行社	jiang'su'tong'yuan'lv'xing'she	0
江苏文物旅行社	jiang'su'wen'wu'lv'xing'she	0
江苏西康旅行社	jiang'su'xi'kang'lv'xing'she	0
江苏行政学院培训中心旅行社	jiang'su'xing'zheng'xue'yuan'pei'xun'zhong'xin'lv'xing'she	0
江苏盱眙金谷园旅行社	jiang'su'xu'yi'jin'gu'yuan'lv'xing'she	0
江苏油龙旅行社	jiang'su'you'long'lv'xing'she	0
江苏油田中友旅行社	jiang'su'you'tian'zhong'you'lv'xing'she	0
江苏友谊国际旅行社	jiang'su'you'yi'guo'ji'lv'xing'she	0
江苏远东金色假日旅行社	jiang'su'yuan'dong'jin'se'jia'ri'lv'xing'she	0
江苏职工国际旅行社	jiang'su'zhi'gong'guo'ji'lv'xing'she	0
江苏中国青年旅行社	jiang'su'zhong'guo'qing'nian'lv'xing'she	0
江苏中心商务旅行社	jiang'su'zhong'xin'shang'wu'lv'xing'she	0
江西长运旅行社	jiang'xi'chang'yun'lv'xing'she	0
江西风光旅行社	jiang'xi'feng'guang'lv'xing'she	0
江西和平旅行社	jiang'xi'he'ping'lv'xing'she	0
江西华夏旅行社	jiang'xi'hua'xia'lv'xing'she	0
江西教育旅行社	jiang'xi'jiao'yu'lv'xing'she	0
江西教苑旅行社	jiang'xi'jiao'yuan'lv'xing'she	0
江西经贸旅行社	jiang'xi'jing'mao'lv'xing'she	0
江西九江康辉旅行社	jiang'xi'jiu'jiang'kang'hui'lv'xing'she	0
江西九江庐山华侨旅行社	jiang'xi'jiu'jiang'lu'shan'hua'qiao'lv'xing'she	0
江西九江庐山青年旅行社	jiang'xi'jiu'jiang'lu'shan'qing'nian'lv'xing'she	0
江西庐山庐之旅旅行社	jiang'xi'lu'shan'lu'zhi'lv'lv'xing'she	0
江西民航国际旅行社	jiang'xi'min'hang'guo'ji'lv'xing'she	0
江西山水旅行社	jiang'xi'shan'shui'lv'xing'she	0
江西省黑天鹅旅行社	jiang'xi'sheng'hei'tian'e'lv'xing'she	0
江西省华谊旅行社	jiang'xi'sheng'hua'yi'lv'xing'she	0
江西省煌之旅旅行社	jiang'xi'sheng'huang'zhi'lv'lv'xing'she	0
江西省吉安井冈山海峡旅行社	jiang'xi'sheng'ji'an'jing'gang'shan'hai'xia'lv'xing'she	0
江西省金翔旅行社	jiang'xi'sheng'jin'xiang'lv'xing'she	0
江西省九江市蓝天旅行社	jiang'xi'sheng'jiu'jiang'shi'lan'tian'lv'xing'she	0
江西省南昌泰康旅行社	jiang'xi'sheng'nan'chang'tai'kang'lv'xing'she	0
江西省新康辉旅行社	jiang'xi'sheng'xin'kang'hui'lv'xing'she	0
江西省玉山教育旅行社	jiang'xi'sheng'yu'shan'jiao'yu'lv'xing'she	0
江西省玉山县三清湖旅行社	jiang'xi'sheng'yu'shan'xian'san'qing'hu'lv'xing'she	0
江西省职工旅行社	jiang'xi'sheng'zhi'gong'lv'xing'she	0
江西省中国旅行社	jiang'xi'sheng'zhong'guo'lv'xing'she	0
江西台胞海峡旅行社	jiang'xi'tai'bao'hai'xia'lv'xing'she	0
江西太和旅行社	jiang'xi'tai'he'lv'xing'she	0
江西天马旅行社	jiang'xi'tian'ma'lv'xing'she	0
江西天缘旅行社	jiang'xi'tian'yuan'lv'xing'she	0
江西铁路青年旅行社	jiang'xi'tie'lu'qing'nian'lv'xing'she	0
江西新光旅行社	jiang'xi'xin'guang'lv'xing'she	0
江西邮电旅行社	jiang'xi'you'dian'lv'xing'she	0
江西中山旅行社	jiang'xi'zhong'shan'lv'xing'she	0
江阴市大桥旅行社	jiang'yin'shi'da'qiao'lv'xing'she	0
江阴市华西旅行社	jiang'yin'shi'hua'xi'lv'xing'she	0
江阴市友好旅行社	jiang'yin'shi'you'hao'lv'xing'she	0
江阴市职工旅行社	jiang'yin'shi'zhi'gong'lv'xing'she	0
江阴市中国旅行社	jiang'yin'shi'zhong'guo'lv'xing'she	0
江油市阳光旅行社	jiang'you'shi'yang'guang'lv'xing'she	0
江油铁路旅行社	jiang'you'tie'lu'lv'xing'she	0
椒江中国国际旅行社	jiao'jiang'zhong'guo'guo'ji'lv'xing'she	0
蕉岭县中国旅行社	jiao'ling'xian'zhong'guo'lv'xing'she	0
交运旅行社	jiao'yun'lv'xing'she	0
捷达旅行社	jie'da'lv'xing'she	0
揭东县中国旅行社	jie'dong'xian'zhong'guo'lv'xing'she	0
揭西县中国旅行社	jie'xi'xian'zhong'guo'lv'xing'she	0
揭阳市中国旅行社	jie'yang'shi'zhong'guo'lv'xing'she	0
金版纳旅行社	jin'ban'na'lv'xing'she	0
晋城康辉旅行社	jin'cheng'kang'hui'lv'xing'she	0
晋城市友好国际旅行社	jin'cheng'shi'you'hao'guo'ji'lv'xing'she	0
晋城铁道旅行社	jin'cheng'tie'dao'lv'xing'she	0
金凤旅行社	jin'feng'lv'xing'she	0
金海湾旅行社	jin'hai'wan'lv'xing'she	0
金华白云旅行社	jin'hua'bai'yun'lv'xing'she	0
金华假日旅行社	jin'hua'jia'ri'lv'xing'she	0
金华交通旅行社	jin'hua'jiao'tong'lv'xing'she	0
金华兰江大厦银辉旅行社	jin'hua'lan'jiang'da'xia'yin'hui'lv'xing'she	0
金华南国旅行社	jin'hua'nan'guo'lv'xing'she	0
金华磐安三江旅行社	jin'hua'pan'an'san'jiang'lv'xing'she	0
金华浦江仙华旅行社	jin'hua'pu'jiang'xian'hua'lv'xing'she	0
金华市国际旅行社	jin'hua'shi'guo'ji'lv'xing'she	0
金华市黄大仙旅行社	jin'hua'shi'huang'da'xian'lv'xing'she	0
金华市鹿湖旅行社	jin'hua'shi'lu'hu'lv'xing'she	0
金华武义县旅行社	jin'hua'wu'yi'xian'lv'xing'she	0
金华中国国际旅行社	jin'hua'zhong'guo'guo'ji'lv'xing'she	0
金华中国旅行社	jin'hua'zhong'guo'lv'xing'she	0
晋江侨联旅行社	jin'jiang'qiao'lian'lv'xing'she	0
晋江青年旅行社	jin'jiang'qing'nian'lv'xing'she	0
晋江顺达旅行社	jin'jiang'shun'da'lv'xing'she	0
晋江运通旅行社	jin'jiang'yun'tong'lv'xing'she	0
金九华旅行社	jin'jiu'hua'lv'xing'she	0
金路旅行社	jin'lu'lv'xing'she	0
金坛市交通旅行社	jin'tan'shi'jiao'tong'lv'xing'she	0
金坛市旅行社	jin'tan'shi'lv'xing'she	0
金坛市天乐旅行社	jin'tan'shi'tian'le'lv'xing'she	0
金象旅行社	jin'xiang'lv'xing'she	0
金叶国际旅行社	jin'ye'guo'ji'lv'xing'she	0
金园旅行社	jin'yuan'lv'xing'she	0
锦州老年旅行社	jin'zhou'lao'nian'lv'xing'she	0
锦州市中国旅行社	jin'zhou'shi'zhong'guo'lv'xing'she	0
景德镇市瓷都旅行社	jing'de'zhen'shi'ci'du'lv'xing'she	0
景德镇中国国际旅行社	jing'de'zhen'zhong'guo'guo'ji'lv'xing'she	0
景峨旅行社	jing'e'lv'xing'she	0
经发旅行社	jing'fa'lv'xing'she	0
井冈山红杜鹃旅行社	jing'gang'shan'hong'du'juan'lv'xing'she	0
井冈山康辉旅行社	jing'gang'shan'kang'hui'lv'xing'she	0
井冈山旅行社	jing'gang'shan'lv'xing'she	0
井冈山青年旅行社	jing'gang'shan'qing'nian'lv'xing'she	0
井冈山市中旅假日旅行社	jing'gang'shan'shi'zhong'lv'jia'ri'lv'xing'she	0
井冈山心连心旅行社	jing'gang'shan'xin'lian'xin'lv'xing'she	0
井冈山中心旅行社	jing'gang'shan'zhong'xin'lv'xing'she	0
景洪商业旅行社	jing'hong'shang'ye'lv'xing'she	0
景兰旅行社	jing'lan'lv'xing'she	0
景宁畲乡旅行社	jing'ning'she'xiang'lv'xing'she	0
景宁畲族自治县旅行社	jing'ning'she'zu'zi'zhi'xian'lv'xing'she	0
景泰旅行社	jing'tai'lv'xing'she	0
经协旅行社	jing'xie'lv'xing'she	0
京信来旅行社	jing'xin'lai'lv'xing'she	0
荆州市中国青年旅行社	jing'zhou'shi'zhong'guo'qing'nian'lv'xing'she	0
荆州中国国际旅行社	jing'zhou'zhong'guo'guo'ji'lv'xing'she	0
九华风光旅行社	jiu'hua'feng'guang'lv'xing'she	0
九华山春秋旅行社	jiu'hua'shan'chun'qiu'lv'xing'she	0
九华山佛国旅行社	jiu'hua'shan'fo'guo'lv'xing'she	0
九华山国际旅行社	jiu'hua'shan'guo'ji'lv'xing'she	0
九华山灵山旅行社	jiu'hua'shan'ling'shan'lv'xing'she	0
九华山森林旅行社	jiu'hua'shan'sen'lin'lv'xing'she	0
九华山山水旅行社	jiu'hua'shan'shan'shui'lv'xing'she	0
九华山太华旅行社	jiu'hua'shan'tai'hua'lv'xing'she	0
九江春秋旅行社	jiu'jiang'chun'qiu'lv'xing'she	0
九江大地旅行社	jiu'jiang'da'di'lv'xing'she	0
九江飞达旅行社	jiu'jiang'fei'da'lv'xing'she	0
九江工会职工旅行社	jiu'jiang'gong'hui'zhi'gong'lv'xing'she	0
九江环球国际旅行社	jiu'jiang'huan'qiu'guo'ji'lv'xing'she	0
九江环宇旅行社	jiu'jiang'huan'yu'lv'xing'she	0
九江假日旅行社	jiu'jiang'jia'ri'lv'xing'she	0
九江交通旅行社	jiu'jiang'jiao'tong'lv'xing'she	0
九江教育旅行社	jiu'jiang'jiao'yu'lv'xing'she	0
九江金达旅行社	jiu'jiang'jin'da'lv'xing'she	0
九江庐山东南旅行社	jiu'jiang'lu'shan'dong'nan'lv'xing'she	0
九江庐山风光旅行社	jiu'jiang'lu'shan'feng'guang'lv'xing'she	0
九江庐山好时光旅行社	jiu'jiang'lu'shan'hao'shi'guang'lv'xing'she	0
九江庐山江南旅行社	jiu'jiang'lu'shan'jiang'nan'lv'xing'she	0
九江庐山金山角旅行社	jiu'jiang'lu'shan'jin'shan'jiao'lv'xing'she	0
九江庐山石松旅行社	jiu'jiang'lu'shan'shi'song'lv'xing'she	0
九江庐山友好旅行社	jiu'jiang'lu'shan'you'hao'lv'xing'she	0
九江庐山招商旅行社	jiu'jiang'lu'shan'zhao'shang'lv'xing'she	0
九江南湖旅行社	jiu'jiang'nan'hu'lv'xing'she	0
九江山水旅行社	jiu'jiang'shan'shui'lv'xing'she	0
九江神州行旅行社	jiu'jiang'shen'zhou'xing'lv'xing'she	0
九江市东方旅行社	jiu'jiang'shi'dong'fang'lv'xing'she	0
九江市交通旅行社	jiu'jiang'shi'jiao'tong'lv'xing'she	0
九江市蓝天旅行社	jiu'jiang'shi'lan'tian'lv'xing'she	0
九江市阳光旅行社	jiu'jiang'shi'yang'guang'lv'xing'she	0
九江市职工旅行社	jiu'jiang'shi'zhi'gong'lv'xing'she	0
九江天马旅行社	jiu'jiang'tian'ma'lv'xing'she	0
九江邮电旅行社	jiu'jiang'you'dian'lv'xing'she	0
九江中国国际旅行社	jiu'jiang'zhong'guo'guo'ji'lv'xing'she	0
九江中国旅行社	jiu'jiang'zhong'guo'lv'xing'she	0
九江中青旅行社	jiu'jiang'zhong'qing'lv'xing'she	0
九江中远旅行社	jiu'jiang'zhong'yuan'lv'xing'she	0
九寨沟国际旅行社	jiu'zhai'gou'guo'ji'lv'xing'she	0
九寨沟青年旅行社	jiu'zhai'gou'qing'nian'lv'xing'she	0
九州旅行社	jiu'zhou'lv'xing'she	0
句容假日旅行社	ju'rong'jia'ri'lv'xing'she	0
君悦旅行社	jun'yue'lv'xing'she	0
喀什中国国际旅行社	ka'shi'zhong'guo'guo'ji'lv'xing'she	0
开封东京旅行社	kai'feng'dong'jing'lv'xing'she	0
开封东苑旅行社	kai'feng'dong'yuan'lv'xing'she	0
开封光明旅行社	kai'feng'guang'ming'lv'xing'she	0
开封市华光旅行社	kai'feng'shi'hua'guang'lv'xing'she	0
开封市友谊旅行社	kai'feng'shi'you'yi'lv'xing'she	0
开封天鹅旅行社	kai'feng'tian'e'lv'xing'she	0
开封天马旅行社	kai'feng'tian'ma'lv'xing'she	0
开封新闻旅行社	kai'feng'xin'wen'lv'xing'she	0
开封友好旅行社	kai'feng'you'hao'lv'xing'she	0
开封中州旅行社	kai'feng'zhong'zhou'lv'xing'she	0
开化县花山旅行社	kai'hua'xian'hua'shan'lv'xing'she	0
开远交通旅行社	kai'yuan'jiao'tong'lv'xing'she	0
开远旅行社	kai'yuan'lv'xing'she	0
康泰旅行社	kang'tai'lv'xing'she	0
科达旅行社	ke'da'lv'xing'she	0
科学国际旅行社	ke'xue'guo'ji'lv'xing'she	0
昆明春秋旅行社	kun'ming'chun'qiu'lv'xing'she	0
昆明发展旅行社	kun'ming'fa'zhan'lv'xing'she	0
昆明国际旅行社	kun'ming'guo'ji'lv'xing'she	0
昆明海棠旅行社	kun'ming'hai'tang'lv'xing'she	0
昆明华夏旅行社	kun'ming'hua'xia'lv'xing'she	0
昆明金湖旅行社	kun'ming'jin'hu'lv'xing'she	0
昆明金山旅行社	kun'ming'jin'shan'lv'xing'she	0
昆明科翔旅行社	kun'ming'ke'xiang'lv'xing'she	0
昆明龙门假日国际旅行社	kun'ming'long'men'jia'ri'guo'ji'lv'xing'she	0
昆明南疆旅行社	kun'ming'nan'jiang'lv'xing'she	0
昆明盘龙江旅行社	kun'ming'pan'long'jiang'lv'xing'she	0
昆明市海鸥旅行社	kun'ming'shi'hai'ou'lv'xing'she	0
昆明市金马旅行社	kun'ming'shi'jin'ma'lv'xing'she	0
昆明市志诚旅行社	kun'ming'shi'zhi'cheng'lv'xing'she	0
昆明太阳州国际旅行社	kun'ming'tai'yang'zhou'guo'ji'lv'xing'she	0
昆明中北旅行社	kun'ming'zhong'bei'lv'xing'she	0
昆明中国青年旅行社	kun'ming'zhong'guo'qing'nian'lv'xing'she	0
昆明中友旅行社	kun'ming'zhong'you'lv'xing'she	0
昆山春秋国内旅行社	kun'shan'chun'qiu'guo'nei'lv'xing'she	0
昆山交通国内旅行社	kun'shan'jiao'tong'guo'nei'lv'xing'she	0
昆山旅行社	kun'shan'lv'xing'she	0
拉萨电信旅行社	la'sa'dian'xin'lv'xing'she	0
拉萨市商贸旅行社	la'sa'shi'shang'mao'lv'xing'she	0
涞水县野三坡旅行社	lai'shui'xian'ye'san'po'lv'xing'she	0
涞源县凉城旅行社	lai'yuan'xian'liang'cheng'lv'xing'she	0
蓝天旅行社	lan'tian'lv'xing'she	0
兰溪青年旅行社	lan'xi'qing'nian'lv'xing'she	0
兰溪市旅行社	lan'xi'shi'lv'xing'she	0
兰溪市铁路旅行社	lan'xi'shi'tie'lu'lv'xing'she	0
兰州春秋旅行社	lan'zhou'chun'qiu'lv'xing'she	0
兰州好时光旅行社	lan'zhou'hao'shi'guang'lv'xing'she	0
兰州华联旅行社	lan'zhou'hua'lian'lv'xing'she	0
兰州假日旅行社	lan'zhou'jia'ri'lv'xing'she	0
兰州交通旅行社	lan'zhou'jiao'tong'lv'xing'she	0
兰州金鹿铁道旅行社	lan'zhou'jin'lu'tie'dao'lv'xing'she	0
兰州千禧之旅旅行社	lan'zhou'qian'xi'zhi'lv'lv'xing'she	0
兰州石化旅行社	lan'zhou'shi'hua'lv'xing'she	0
兰州丝路旅行社	lan'zhou'si'lu'lv'xing'she	0
兰州天马旅行社	lan'zhou'tian'ma'lv'xing'she	0
兰州天涯旅行社	lan'zhou'tian'ya'lv'xing'she	0
兰州铁路友好旅行社	lan'zhou'tie'lu'you'hao'lv'xing'she	0
兰州文化旅行社	lan'zhou'wen'hua'lv'xing'she	0
兰州新闻旅行社	lan'zhou'xin'wen'lv'xing'she	0
兰州休闲旅行社	lan'zhou'xiu'xian'lv'xing'she	0
兰州银河旅行社	lan'zhou'yin'he'lv'xing'she	0
兰州迎宾旅行社	lan'zhou'ying'bin'lv'xing'she	0
兰州友谊旅行社	lan'zhou'you'yi'lv'xing'she	0
老城隍庙旅行社	lao'cheng'huang'miao'lv'xing'she	0
乐昌市中国旅行社	le'chang'shi'zhong'guo'lv'xing'she	0
乐山东方佛都旅行社	le'shan'dong'fang'fo'dou'lv'xing'she	0
乐山风光旅行社	le'shan'feng'guang'lv'xing'she	0
乐山红航旅行社	le'shan'hong'hang'lv'xing'she	0
乐山虹桥旅行社	le'shan'hong'qiao'lv'xing'she	0
乐山巨龙旅行社	le'shan'ju'long'lv'xing'she	0
乐山康辉旅行社	le'shan'kang'hui'lv'xing'she	0
乐山三江大佛旅行社	le'shan'san'jiang'da'fo'lv'xing'she	0
乐山市华侨旅行社	le'shan'shi'hua'qiao'lv'xing'she	0
乐山泰和旅行社	le'shan'tai'he'lv'xing'she	0
乐山夕阳红旅行社	le'shan'xi'yang'hong'lv'xing'she	0
丽江白鹿国际旅行社	li'jiang'bai'lu'guo'ji'lv'xing'she	0
丽江金太阳旅行社	li'jiang'jin'tai'yang'lv'xing'she	0
丽江老君山旅行社	li'jiang'lao'jun'shan'lv'xing'she	0
丽江黎明国际旅行社	li'jiang'li'ming'guo'ji'lv'xing'she	0
丽江绿雪风光国际旅行社	li'jiang'lv'xue'feng'guang'guo'ji'lv'xing'she	0
丽江民航蓝天经营开发总公司旅行社	li'jiang'min'hang'lan'tian'jing'ying'kai'fa'zong'gong'si'lv'xing'she	0
丽江森龙旅行社	li'jiang'sen'long'lv'xing'she	0
丽江县玉龙山旅行社	li'jiang'xian'yu'long'shan'lv'xing'she	0
丽江香格里拉国际旅行社	li'jiang'xiang'ge'li'la'guo'ji'lv'xing'she	0
丽江云杉旅行社	li'jiang'yun'shan'lv'xing'she	0
丽江中国国际旅行社	li'jiang'zhong'guo'guo'ji'lv'xing'she	0
利进达旅行社	li'jin'da'lv'xing'she	0
醴陵中信旅行社	li'ling'zhong'xin'lv'xing'she	0
丽水莲城旅行社	li'shui'lian'cheng'lv'xing'she	0
丽水南明旅行社	li'shui'nan'ming'lv'xing'she	0
丽水山水旅行社	li'shui'shan'shui'lv'xing'she	0
丽水市电力旅行社	li'shui'shi'dian'li'lv'xing'she	0
丽水市阳光之旅旅行社	li'shui'shi'yang'guang'zhi'lv'lv'xing'she	0
溧阳春秋旅行社	li'yang'chun'qiu'lv'xing'she	0
溧阳市华天假日旅行社	li'yang'shi'hua'tian'jia'ri'lv'xing'she	0
溧阳市交通旅行社	li'yang'shi'jiao'tong'lv'xing'she	0
溧阳市蓝天旅行社	li'yang'shi'lan'tian'lv'xing'she	0
溧阳市旅行社	li'yang'shi'lv'xing'she	0
溧阳天目湖旅行社	li'yang'tian'mu'hu'lv'xing'she	0
溧阳走四方旅行社	li'yang'zou'si'fang'lv'xing'she	0
连城县教育旅行社	lian'cheng'xian'jiao'yu'lv'xing'she	0
联信旅游发展有限公司通联旅行社	lian'xin'lv'you'fa'zhan'you'xian'gong'si'tong'lian'lv'xing'she	0
连云港东海温泉旅行社	lian'yun'gang'dong'hai'wen'quan'lv'xing'she	0
连云港风光旅行社	lian'yun'gang'feng'guang'lv'xing'she	0
连云港港城旅行社	lian'yun'gang'gang'cheng'lv'xing'she	0
连云港海川旅行社	lian'yun'gang'hai'chuan'lv'xing'she	0
连云港海景旅行社	lian'yun'gang'hai'jing'lv'xing'she	0
连云港海天旅行社	lian'yun'gang'hai'tian'lv'xing'she	0
连云港海洲湾旅行社	lian'yun'gang'hai'zhou'wan'lv'xing'she	0
连云港航空旅行社	lian'yun'gang'hang'kong'lv'xing'she	0
连云港花果山春秋旅行社	lian'yun'gang'hua'guo'shan'chun'qiu'lv'xing'she	0
连云港蓝天旅行社	lian'yun'gang'lan'tian'lv'xing'she	0
连云港力达旅行社	lian'yun'gang'li'da'lv'xing'she	0
连云港陇海旅行社	lian'yun'gang'long'hai'lv'xing'she	0
连云港南方旅行社	lian'yun'gang'nan'fang'lv'xing'she	0
连云港彭港经贸发展公司华新旅行社	lian'yun'gang'peng'gang'jing'mao'fa'zhan'gong'si'hua'xin'lv'xing'she	0
连云港神州旅行社	lian'yun'gang'shen'zhou'lv'xing'she	0
连云港市北崮山庄旅行社	lian'yun'gang'shi'bei'gu'shan'zhuang'lv'xing'she	0
连云港市大陆桥旅行社	lian'yun'gang'shi'da'lu'qiao'lv'xing'she	0
连云港市海天旅行社	lian'yun'gang'shi'hai'tian'lv'xing'she	0
连云港市花果山春秋旅行社	lian'yun'gang'shi'hua'guo'shan'chun'qiu'lv'xing'she	0
连云港市华夏旅行社	lian'yun'gang'shi'hua'xia'lv'xing'she	0
连云港市环球旅行社	lian'yun'gang'shi'huan'qiu'lv'xing'she	0
连云港市金都旅行社	lian'yun'gang'shi'jin'du'lv'xing'she	0
连云港市康平旅行社	lian'yun'gang'shi'kang'ping'lv'xing'she	0
连云港市连岛旅行社	lian'yun'gang'shi'lian'dao'lv'xing'she	0
连云港市连云区春海旅行社	lian'yun'gang'shi'lian'yun'qu'chun'hai'lv'xing'she	0
连云港市连云区慧丰旅行社	lian'yun'gang'shi'lian'yun'qu'hui'feng'lv'xing'she	0
连云港市南西旅行社	lian'yun'gang'shi'nan'xi'lv'xing'she	0
连云港市如意行旅行社	lian'yun'gang'shi'ru'yi'xing'lv'xing'she	0
连云港市神州旅行社	lian'yun'gang'shi'shen'zhou'lv'xing'she	0
连云港市天马旅行社	lian'yun'gang'shi'tian'ma'lv'xing'she	0
连云港市通达旅行社	lian'yun'gang'shi'tong'da'lv'xing'she	0
连云港市中国旅行社	lian'yun'gang'shi'zhong'guo'lv'xing'she	0
连云港天成旅行社	lian'yun'gang'tian'cheng'lv'xing'she	0
连云港天然居旅行社	lian'yun'gang'tian'ran'ju'lv'xing'she	0
连云港铁路旅行社	lian'yun'gang'tie'lu'lv'xing'she	0
连云港新闻旅行社	lian'yun'gang'xin'wen'lv'xing'she	0
连云港永泰旅行社	lian'yun'gang'yong'tai'lv'xing'she	0
连云港园林旅行社	lian'yun'gang'yuan'lin'lv'xing'she	0
连云港中国国际旅行社	lian'yun'gang'zhong'guo'guo'ji'lv'xing'she	0
连云港中国旅行社	lian'yun'gang'zhong'guo'lv'xing'she	0
连云港中国青年旅行社	lian'yun'gang'zhong'guo'qing'nian'lv'xing'she	0
辽宁北方海峡旅行社	liao'ning'bei'fang'hai'xia'lv'xing'she	0
辽宁金途旅行社	liao'ning'jin'tu'lv'xing'she	0
辽宁老年旅行社	liao'ning'lao'nian'lv'xing'she	0
辽宁森林旅行社	liao'ning'sen'lin'lv'xing'she	0
辽宁省国际体育旅行社	liao'ning'sheng'guo'ji'ti'yu'lv'xing'she	0
辽宁省中国旅行社	liao'ning'sheng'zhong'guo'lv'xing'she	0
辽宁省中国青年旅行社	liao'ning'sheng'zhong'guo'qing'nian'lv'xing'she	0
辽宁新华旅行社	liao'ning'xin'hua'lv'xing'she	0
辽宁新力旅行社	liao'ning'xin'li'lv'xing'she	0
辽宁邮电国际旅行社	liao'ning'you'dian'guo'ji'lv'xing'she	0
临安佛光旅行社	lin'an'fo'guang'lv'xing'she	0
临安钱王旅行社	lin'an'qian'wang'lv'xing'she	0
临安天目旅行社	lin'an'tian'mu'lv'xing'she	0
临安天目山旅行社	lin'an'tian'mu'shan'lv'xing'she	0
临海春秋旅行社	lin'hai'chun'qiu'lv'xing'she	0
临沂大自然旅行社	lin'yi'da'zi'ran'lv'xing'she	0
临沂方元旅行社	lin'yi'fang'yuan'lv'xing'she	0
临沂金桥旅行社	lin'yi'jin'qiao'lv'xing'she	0
临沂荣华旅行社	lin'yi'rong'hua'lv'xing'she	0
临沂陶然居旅行社	lin'yi'tao'ran'ju'lv'xing'she	0
灵宝旅行社	ling'bao'lv'xing'she	0
零陵中国旅行社	ling'ling'zhong'guo'lv'xing'she	0
岭南旅行社	ling'nan'lv'xing'she	0
浏阳市旅行社	liu'yang'shi'lv'xing'she	0
柳州火车站旅行社	liu'zhou'huo'che'zhan'lv'xing'she	0
柳州客运段顺达旅行社	liu'zhou'ke'yun'duan'shun'da'lv'xing'she	0
柳州市观光国际旅行社	liu'zhou'shi'guan'guang'guo'ji'lv'xing'she	0
柳州市柳航旅行社	liu'zhou'shi'liu'hang'lv'xing'she	0
柳州市青年旅行社	liu'zhou'shi'qing'nian'lv'xing'she	0
柳州市田园旅行社	liu'zhou'shi'tian'yuan'lv'xing'she	0
柳州市中国国际旅行社	liu'zhou'shi'zhong'guo'guo'ji'lv'xing'she	0
柳州天马旅行社	liu'zhou'tian'ma'lv'xing'she	0
柳州铁路国际旅行社	liu'zhou'tie'lu'guo'ji'lv'xing'she	0
柳州中国国际旅行社	liu'zhou'zhong'guo'guo'ji'lv'xing'she	0
龙虎山虹桥旅行社	long'hu'shan'hong'qiao'lv'xing'she	0
龙虎山康辉旅行社	long'hu'shan'kang'hui'lv'xing'she	0
龙门国际旅行社	long'men'guo'ji'lv'xing'she	0
龙门康辉国际旅行社	long'men'kang'hui'guo'ji'lv'xing'she	0
龙门县中国旅行社	long'men'xian'zhong'guo'lv'xing'she	0
龙岩中国国际旅行社	long'yan'zhong'guo'guo'ji'lv'xing'she	0
龙游县南海旅行社	long'you'xian'nan'hai'lv'xing'she	0
龙游县衢江旅行社	long'you'xian'qu'jiang'lv'xing'she	0
泸沽湖女儿国旅行社	lu'gu'hu'nv'er'guo'lv'xing'she	0
陆河县中国旅行社	lu'he'xian'zhong'guo'lv'xing'she	0
鲁能国际旅行社	lu'neng'guo'ji'lv'xing'she	0
庐山光大旅行社	lu'shan'guang'da'lv'xing'she	0
庐山航空旅行社	lu'shan'hang'kong'lv'xing'she	0
庐山火车站旅行社	lu'shan'huo'che'zhan'lv'xing'she	0
庐山假日旅行社	lu'shan'jia'ri'lv'xing'she	0
庐山九九旅行社	lu'shan'jiu'jiu'lv'xing'she	0
庐山康辉旅行社	lu'shan'kang'hui'lv'xing'she	0
庐山山南青年旅行社	lu'shan'shan'nan'qing'nian'lv'xing'she	0
庐山山水旅行社	lu'shan'shan'shui'lv'xing'she	0
庐山天马旅行社	lu'shan'tian'ma'lv'xing'she	0
庐山铁路旅行社	lu'shan'tie'lu'lv'xing'she	0
庐山中国青年旅行社	lu'shan'zhong'guo'qing'nian'lv'xing'she	0
卢湾旅行社	lu'wan'lv'xing'she	0
泸州华侨旅行社	lu'zhou'hua'qiao'lv'xing'she	0
漯河市樱花旅行社	luo'he'shi'ying'hua'lv'xing'she	0
洛神旅行社	luo'shen'lv'xing'she	0
洛阳大厦旅行社	luo'yang'da'sha'lv'xing'she	0
洛阳和平国际旅行社	luo'yang'he'ping'guo'ji'lv'xing'she	0
洛阳老年旅行社	luo'yang'lao'nian'lv'xing'she	0
洛阳列车段旅行社	luo'yang'lie'che'duan'lv'xing'she	0
洛阳洛浦旅行社	luo'yang'luo'pu'lv'xing'she	0
洛阳时代华纳旅行社	luo'yang'shi'dai'hua'na'lv'xing'she	0
洛阳市河洛旅行社	luo'yang'shi'he'luo'lv'xing'she	0
洛阳市职工旅行社	luo'yang'shi'zhi'gong'lv'xing'she	0
洛阳市中国旅行社	luo'yang'shi'zhong'guo'lv'xing'she	0
洛阳天星旅行社	luo'yang'tian'xing'lv'xing'she	0
洛阳通翔旅行社	luo'yang'tong'xiang'lv'xing'she	0
洛阳文物旅行社	luo'yang'wen'wu'lv'xing'she	0
洛阳旋宫旅行社	luo'yang'xuan'gong'lv'xing'she	0
洛阳银桥旅行社	luo'yang'yin'qiao'lv'xing'she	0
洛阳邮电国际旅行社	luo'yang'you'dian'guo'ji'lv'xing'she	0
洛阳友好旅行社	luo'yang'you'hao'lv'xing'she	0
洛阳招商旅行社	luo'yang'zhao'shang'lv'xing'she	0
洛阳中国青年旅行社	luo'yang'zhong'guo'qing'nian'lv'xing'she	0
绿桥旅行社	lv'qiao'lv'xing'she	0
马鞍山皇嘉旅行社	ma'an'shan'huang'jia'lv'xing'she	0
满城县长信旅行社	man'cheng'xian'chang'xin'lv'xing'she	0
满洲里绿洲国际旅行社	man'zhou'li'lv'zhou'guo'ji'lv'xing'she	0
满洲里天鹅国际旅行社	man'zhou'li'tian'e'guo'ji'lv'xing'she	0
满洲里外运国际旅行社	man'zhou'li'wai'yun'guo'ji'lv'xing'she	0
满洲里中国旅行社	man'zhou'li'zhong'guo'lv'xing'she	0
茂名市平安国际旅行社	mao'ming'shi'ping'an'guo'ji'lv'xing'she	0
茂盛旅行社	mao'sheng'lv'xing'she	0
茂业旅行社	mao'ye'lv'xing'she	0
湄公河旅行社	mei'gong'he'lv'xing'she	0
眉山市青年旅行社	mei'shan'shi'qing'nian'lv'xing'she	0
梅州市中国旅行社	mei'zhou'shi'zhong'guo'lv'xing'she	0
勐海交通旅行社	meng'hai'jiao'tong'lv'xing'she	0
勐海科技旅行社	meng'hai'ke'ji'lv'xing'she	0
勐海旅行社	meng'hai'lv'xing'she	0
勐海职工旅行社	meng'hai'zhi'gong'lv'xing'she	0
勐腊旅行社	meng'la'lv'xing'she	0
蒙阴县蒙山旅行社	meng'yin'xian'meng'shan'lv'xing'she	0
蒙阴中国旅行社	meng'yin'zhong'guo'lv'xing'she	0
绵阳春秋旅行社	mian'yang'chun'qiu'lv'xing'she	0
绵阳国际旅行社	mian'yang'guo'ji'lv'xing'she	0
绵阳红叶旅行社	mian'yang'hong'ye'lv'xing'she	0
绵阳假日旅行社	mian'yang'jia'ri'lv'xing'she	0
绵阳康辉旅行社	mian'yang'kang'hui'lv'xing'she	0
绵阳联运旅行社	mian'yang'lian'yun'lv'xing'she	0
绵阳三国旅行社	mian'yang'san'guo'lv'xing'she	0
绵阳市绵州旅行社	mian'yang'shi'mian'zhou'lv'xing'she	0
绵阳市青年旅行社	mian'yang'shi'qing'nian'lv'xing'she	0
绵阳铁路旅行社	mian'yang'tie'lu'lv'xing'she	0
绵竹剑南春旅行社	mian'zhu'jian'nan'chun'lv'xing'she	0
闵行区闵联旅行社	min'hang'qu'min'lian'lv'xing'she	0
民航烟台金鹰旅行社	min'hang'yan'tai'jin'ying'lv'xing'she	0
闽清县中国旅行社	min'qing'xian'zhong'guo'lv'xing'she	0
牡丹江符林国际客运服务有限公司符林旅行社	mu'dan'jiang'fu'lin'guo'ji'ke'yun'fu'wu'you'xian'gong'si'fu'lin'lv'xing'she	0
牡丹江观光旅行社	mu'dan'jiang'guan'guang'lv'xing'she	0
牡丹江康辉旅行社	mu'dan'jiang'kang'hui'lv'xing'she	0
牡丹江青年旅行社	mu'dan'jiang'qing'nian'lv'xing'she	0
牡丹江市春秋旅行社	mu'dan'jiang'shi'chun'qiu'lv'xing'she	0
牡丹江市观光旅行社	mu'dan'jiang'shi'guan'guang'lv'xing'she	0
牡丹江市新东方旅行社	mu'dan'jiang'shi'xin'dong'fang'lv'xing'she	0
牡丹江天马旅行社	mu'dan'jiang'tian'ma'lv'xing'she	0
牡丹江新世纪旅行社	mu'dan'jiang'xin'shi'ji'lv'xing'she	0
牡丹江运输集团旅行社	mu'dan'jiang'yun'shu'ji'tuan'lv'xing'she	0
牡丹江运输旅行社	mu'dan'jiang'yun'shu'lv'xing'she	0
牡丹江中国国际旅行社	mu'dan'jiang'zhong'guo'guo'ji'lv'xing'she	0
牡丹江中国旅行社	mu'dan'jiang'zhong'guo'lv'xing'she	0
牡丹旅行社	mu'dan'lv'xing'she	0
南安青年旅行社	nan'an'qing'nian'lv'xing'she	0
南安中国旅行社	nan'an'zhong'guo'lv'xing'she	0
南昌车站旅行社	nan'chang'che'zhan'lv'xing'she	0
南昌海城旅行社	nan'chang'hai'cheng'lv'xing'she	0
南昌好时运旅行社	nan'chang'hao'shi'yun'lv'xing'she	0
南昌康达旅行社	nan'chang'kang'da'lv'xing'she	0
南昌旅行社	nan'chang'lv'xing'she	0
南昌市亚细亚旅行社	nan'chang'shi'ya'xi'ya'lv'xing'she	0
南昌市职工旅行社	nan'chang'shi'zhi'gong'lv'xing'she	0
南昌铁路国际旅行社	nan'chang'tie'lu'guo'ji'lv'xing'she	0
南昌西湖教育旅行社	nan'chang'xi'hu'jiao'yu'lv'xing'she	0
南昌亚细亚旅行社	nan'chang'ya'xi'ya'lv'xing'she	0
南充北湖旅行社	nan'chong'bei'hu'lv'xing'she	0
南充虹桥旅行社	nan'chong'hong'qiao'lv'xing'she	0
南充旅行社	nan'chong'lv'xing'she	0
南充五星旅行社	nan'chong'wu'xing'lv'xing'she	0
南海金都旅行社	nan'hai'jin'du'lv'xing'she	0
南海市华银国际旅行社	nan'hai'shi'hua'yin'guo'ji'lv'xing'she	0
南海市金都旅行社	nan'hai'shi'jin'du'lv'xing'she	0
南海市中国旅行社	nan'hai'shi'zhong'guo'lv'xing'she	0
南京长途汽车客运总公司太平洋旅行社	nan'jing'chang'tu'qi'che'ke'yun'zong'gong'si'tai'ping'yang'lv'xing'she	0
南京春秋旅行社	nan'jing'chun'qiu'lv'xing'she	0
南京电信虹飞旅行社	nan'jing'dian'xin'hong'fei'lv'xing'she	0
南京东方国际旅行社	nan'jing'dong'fang'guo'ji'lv'xing'she	0
南京东南大学旅行社	nan'jing'dong'nan'da'xue'lv'xing'she	0
南京方正旅行社	nan'jing'fang'zheng'lv'xing'she	0
南京风采旅行社	nan'jing'feng'cai'lv'xing'she	0
南京夫子庙旅行社	nan'jing'fu'zi'miao'lv'xing'she	0
南京国土旅行社	nan'jing'guo'tu'lv'xing'she	0
南京海熙旅行社	nan'jing'hai'xi'lv'xing'she	0
南京航空旅行社	nan'jing'hang'kong'lv'xing'she	0
南京红楼旅行社	nan'jing'hong'lou'lv'xing'she	0
南京环球旅行社	nan'jing'huan'qiu'lv'xing'she	0
南京江宁旅行社	nan'jing'jiang'ning'lv'xing'she	0
南京教师旅行社	nan'jing'jiao'shi'lv'xing'she	0
南京教育旅行社	nan'jing'jiao'yu'lv'xing'she	0
南京金陵石化华益旅行社	nan'jing'jin'ling'shi'hua'hua'yi'lv'xing'she	0
南京蓝天旅行社	nan'jing'lan'tian'lv'xing'she	0
南京劳动旅行社	nan'jing'lao'dong'lv'xing'she	0
南京绿色旅行社	nan'jing'lv'se'lv'xing'she	0
南京商务旅行社	nan'jing'shang'wu'lv'xing'she	0
南京神州旅行社	nan'jing'shen'zhou'lv'xing'she	0
南京市华昌旅行社	nan'jing'shi'hua'chang'lv'xing'she	0
南京四海旅行社	nan'jing'si'hai'lv'xing'she	0
南京天地旅行社	nan'jing'tian'di'lv'xing'she	0
南京天使旅行社	nan'jing'tian'shi'lv'xing'she	0
南京通达旅行社	nan'jing'tong'da'lv'xing'she	0
南京希望旅行社	nan'jing'xi'wang'lv'xing'she	0
南京友好国际旅行社	nan'jing'you'hao'guo'ji'lv'xing'she	0
南京裕国旅行社	nan'jing'yu'guo'lv'xing'she	0
南京站铁龙旅行社	nan'jing'zhan'tie'long'lv'xing'she	0
南京中北友好国际旅行社	nan'jing'zhong'bei'you'hao'guo'ji'lv'xing'she	0
南京中恒旅行社	nan'jing'zhong'heng'lv'xing'she	0
南京中山陵旅行社	nan'jing'zhong'shan'ling'lv'xing'she	0
南京珠江旅行社	nan'jing'zhu'jiang'lv'xing'she	0
南京紫金旅行社	nan'jing'zi'jin'lv'xing'she	0
南宁广明旅行社	nan'ning'guang'ming'lv'xing'she	0
南宁海峡旅行社	nan'ning'hai'xia'lv'xing'she	0
南宁华泰旅行社	nan'ning'hua'tai'lv'xing'she	0
南宁教育旅行社	nan'ning'jiao'yu'lv'xing'she	0
南宁交运旅行社	nan'ning'jiao'yun'lv'xing'she	0
南宁金达旅行社	nan'ning'jin'da'lv'xing'she	0
南宁金悦旅行社	nan'ning'jin'yue'lv'xing'she	0
南宁美航旅行社	nan'ning'mei'hang'lv'xing'she	0
南宁民航航发旅行社	nan'ning'min'hang'hang'fa'lv'xing'she	0
南宁南方电力旅行社	nan'ning'nan'fang'dian'li'lv'xing'she	0
南宁南方旅行社	nan'ning'nan'fang'lv'xing'she	0
南宁凭祥东方旅行社	nan'ning'ping'xiang'dong'fang'lv'xing'she	0
南宁凭祥中国国际旅行社	nan'ning'ping'xiang'zhong'guo'guo'ji'lv'xing'she	0
南宁山水旅行社	nan'ning'shan'shui'lv'xing'she	0
南宁市富达旅行社	nan'ning'shi'fu'da'lv'xing'she	0
南宁市邕江旅行社	nan'ning'shi'yong'jiang'lv'xing'she	0
南宁西南旅行社	nan'ning'xi'nan'lv'xing'she	0
南宁亚太旅行社	nan'ning'ya'tai'lv'xing'she	0
南宁阳光假期旅行社	nan'ning'yang'guang'jia'qi'lv'xing'she	0
南宁邕之旅旅行社	nan'ning'yong'zhi'lv'lv'xing'she	0
南宁中福旅行社	nan'ning'zhong'fu'lv'xing'she	0
南宁中国旅行社	nan'ning'zhong'guo'lv'xing'she	0
南宁中国青年旅行社	nan'ning'zhong'guo'qing'nian'lv'xing'she	0
南宁中兴旅行社	nan'ning'zhong'xing'lv'xing'she	0
南塔旅行社	nan'ta'lv'xing'she	0
南通城市旅行社	nan'tong'cheng'shi'lv'xing'she	0
南通电力旅行社	nan'tong'dian'li'lv'xing'she	0
南通度假旅行社	nan'tong'du'jia'lv'xing'she	0
南通海梦旅行社	nan'tong'hai'meng'lv'xing'she	0
南通海峡旅行社	nan'tong'hai'xia'lv'xing'she	0
南通商务旅行社	nan'tong'shang'wu'lv'xing'she	0
南通市海安九洲旅行社	nan'tong'shi'hai'an'jiu'zhou'lv'xing'she	0
南通市中国旅行社	nan'tong'shi'zhong'guo'lv'xing'she	0
南通天地旅行社	nan'tong'tian'di'lv'xing'she	0
南通天南旅行社	nan'tong'tian'nan'lv'xing'she	0
南通新天马旅行社	nan'tong'xin'tian'ma'lv'xing'she	0
南通阳光旅行社	nan'tong'yang'guang'lv'xing'she	0
南通招商国际旅行社	nan'tong'zhao'shang'guo'ji'lv'xing'she	0
南阳旅行社	nan'yang'lv'xing'she	0
南阳青年旅行社	nan'yang'qing'nian'lv'xing'she	0
南阳市职工旅行社	nan'yang'shi'zhi'gong'lv'xing'she	0
南阳铁路旅行社	nan'yang'tie'lu'lv'xing'she	0
南岳衡山中国旅行社	nan'yue'heng'shan'zhong'guo'lv'xing'she	0
南岳中国国际旅行社	nan'yue'zhong'guo'guo'ji'lv'xing'she	0
南岳宗教文化旅行社	nan'yue'zong'jiao'wen'hua'lv'xing'she	0
内江国际旅行社	nei'jiang'guo'ji'lv'xing'she	0
内蒙古成吉思汗旅行社	nei'meng'gu'cheng'ji'si'han'lv'xing'she	0
内蒙古春秋旅行社	nei'meng'gu'chun'qiu'lv'xing'she	0
内蒙古风情旅行社	nei'meng'gu'feng'qing'lv'xing'she	0
内蒙古海霞旅行社	nei'meng'gu'hai'xia'lv'xing'she	0
内蒙古金辉旅行社	nei'meng'gu'jin'hui'lv'xing'she	0
内蒙古金锣生态旅行社	nei'meng'gu'jin'luo'sheng'tai'lv'xing'she	0
内蒙古日报闻都旅行社	nei'meng'gu'ri'bao'wen'dou'lv'xing'she	0
内蒙古天原旅行社	nei'meng'gu'tian'yuan'lv'xing'she	0
内蒙古铁道国际旅行社	nei'meng'gu'tie'dao'guo'ji'lv'xing'she	0
内蒙古铁运旅行社	nei'meng'gu'tie'yun'lv'xing'she	0
内蒙古五洲国际旅行社	nei'meng'gu'wu'zhou'guo'ji'lv'xing'she	0
内蒙古协力旅行社	nei'meng'gu'xie'li'lv'xing'she	0
内蒙古伊泰国际旅行社	nei'meng'gu'yi'tai'guo'ji'lv'xing'she	0
内蒙古中国旅行社	nei'meng'gu'zhong'guo'lv'xing'she	0
宁波东海旅行社	ning'bo'dong'hai'lv'xing'she	0
宁波航空旅行社	ning'bo'hang'kong'lv'xing'she	0
宁波假日旅行社	ning'bo'jia'ri'lv'xing'she	0
宁波江南旅行社	ning'bo'jiang'nan'lv'xing'she	0
宁波开发区花港旅行社	ning'bo'kai'fa'qu'hua'gang'lv'xing'she	0
宁波农经旅行社	ning'bo'nong'jing'lv'xing'she	0
宁波日月旅行社	ning'bo'ri'yue'lv'xing'she	0
宁波市农经旅行社	ning'bo'shi'nong'jing'lv'xing'she	0
宁波市汽车出租公司旅行社	ning'bo'shi'qi'che'chu'zu'gong'si'lv'xing'she	0
宁波市夕阳红旅行社	ning'bo'shi'xi'yang'hong'lv'xing'she	0
宁波市月湖旅行社	ning'bo'shi'yue'hu'lv'xing'she	0
宁波市镇海旅行社	ning'bo'shi'zhen'hai'lv'xing'she	0
宁波市中兴大酒店旅行社	ning'bo'shi'zhong'xing'da'jiu'dian'lv'xing'she	0
宁波天一阁旅行社	ning'bo'tian'yi'ge'lv'xing'she	0
宁波英特教育旅行社	ning'bo'ying'te'jiao'yu'lv'xing'she	0
宁波友谊旅行社	ning'bo'you'yi'lv'xing'she	0
宁波云海旅行社	ning'bo'yun'hai'lv'xing'she	0
宁波镇海旅行社	ning'bo'zhen'hai'lv'xing'she	0
宁波中国国际旅行社	ning'bo'zhong'guo'guo'ji'lv'xing'she	0
宁波中国旅行社	ning'bo'zhong'guo'lv'xing'she	0
宁波中国青年旅行社	ning'bo'zhong'guo'qing'nian'lv'xing'she	0
宁波中元旅行社	ning'bo'zhong'yuan'lv'xing'she	0
宁德地区汽车运输总公司交通旅行社	ning'de'di'qu'qi'che'yun'shu'zong'gong'si'jiao'tong'lv'xing'she	0
宁海旅行社	ning'hai'lv'xing'she	0
宁海跃龙旅行社	ning'hai'yue'long'lv'xing'she	0
宁蒗女儿国旅行社	ning'lang'nv'er'guo'lv'xing'she	0
宁夏春秋旅行社	ning'xia'chun'qiu'lv'xing'she	0
宁夏春之旅旅行社	ning'xia'chun'zhi'lv'lv'xing'she	0
宁夏大自然旅行社	ning'xia'da'zi'ran'lv'xing'she	0
宁夏国娱假日旅行社	ning'xia'guo'yu'jia'ri'lv'xing'she	0
宁夏华西旅行社	ning'xia'hua'xi'lv'xing'she	0
宁夏交通凯达旅行社	ning'xia'jiao'tong'kai'da'lv'xing'she	0
宁夏交通旅行社	ning'xia'jiao'tong'lv'xing'she	0
宁夏教育旅行社	ning'xia'jiao'yu'lv'xing'she	0
宁夏金桥旅行社	ning'xia'jin'qiao'lv'xing'she	0
宁夏沙湖旅行社	ning'xia'sha'hu'lv'xing'she	0
宁夏沙坡头旅行社	ning'xia'sha'po'tou'lv'xing'she	0
宁夏山水旅行社	ning'xia'shan'shui'lv'xing'she	0
宁夏天桥旅行社	ning'xia'tian'qiao'lv'xing'she	0
宁夏文化国际旅行社	ning'xia'wen'hua'guo'ji'lv'xing'she	0
宁夏银川蓝色峡光旅行社	ning'xia'yin'chuan'lan'se'xia'guang'lv'xing'she	0
宁夏中国国际旅行社	ning'xia'zhong'guo'guo'ji'lv'xing'she	0
帕米尔旅行社	pa'mi'er'lv'xing'she	0
盘锦市鹤翔旅行社	pan'jin'shi'he'xiang'lv'xing'she	0
盘锦市辽河虹桥旅行社	pan'jin'shi'liao'he'hong'qiao'lv'xing'she	0
盘锦市盘山邮政旅行社	pan'jin'shi'pan'shan'you'zheng'lv'xing'she	0
盘锦市天喜旅行社	pan'jin'shi'tian'xi'lv'xing'she	0
盘锦市万通旅行社	pan'jin'shi'wan'tong'lv'xing'she	0
跑马山旅行社	pao'ma'shan'lv'xing'she	0
蓬莱八仙旅行社	peng'lai'ba'xian'lv'xing'she	0
蓬莱丰雅旅行社	peng'lai'feng'ya'lv'xing'she	0
蓬莱国际旅行社	peng'lai'guo'ji'lv'xing'she	0
蓬莱市金龙旅行社	peng'lai'shi'jin'long'lv'xing'she	0
蓬莱天龙旅行社	peng'lai'tian'long'lv'xing'she	0
平湖市浙江航海旅行社	ping'hu'shi'zhe'jiang'hang'hai'lv'xing'she	0
萍乡市华侨旅行社	ping'xiang'shi'hua'qiao'lv'xing'she	0
萍乡市教工旅行社	ping'xiang'shi'jiao'gong'lv'xing'she	0
萍乡市青年旅行社	ping'xiang'shi'qing'nian'lv'xing'she	0
萍乡市顺达旅行社	ping'xiang'shi'shun'da'lv'xing'she	0
萍乡市星球国际旅行社	ping'xiang'shi'xing'qiu'guo'ji'lv'xing'she	0
凭祥友谊旅行社	ping'xiang'you'yi'lv'xing'she	0
浦东新区爱侨旅行社	pu'dong'xin'qu'ai'qiao'lv'xing'she	0
浦东新区东上海旅行社	pu'dong'xin'qu'dong'shang'hai'lv'xing'she	0
浦江旅行社	pu'jiang'lv'xing'she	0
普宁市金叶旅行社	pu'ning'shi'jin'ye'lv'xing'she	0
普宁市中国旅行社	pu'ning'shi'zhong'guo'lv'xing'she	0
莆田市海神旅行社	pu'tian'shi'hai'shen'lv'xing'she	0
莆田县中国旅行社	pu'tian'xian'zhong'guo'lv'xing'she	0
普陀海中洲旅行社	pu'tuo'hai'zhong'zhou'lv'xing'she	0
普陀山观光旅行社	pu'tuo'shan'guan'guang'lv'xing'she	0
普陀山锦屏旅行社	pu'tuo'shan'jin'ping'lv'xing'she	0
普陀山旅行社	pu'tuo'shan'lv'xing'she	0
普陀山旅游开发总公司洛迦旅行社	pu'tuo'shan'lv'you'kai'fa'zong'gong'si'luo'jia'lv'xing'she	0
普陀中国国际旅行社	pu'tuo'zhong'guo'guo'ji'lv'xing'she	0
启东亨达旅行社	qi'dong'heng'da'lv'xing'she	0
启东市新世纪旅行社	qi'dong'shi'xin'shi'ji'lv'xing'she	0
齐鲁美好旅行社	qi'lu'mei'hao'lv'xing'she	0
齐齐哈尔东方旅行社	qi'qi'ha'er'dong'fang'lv'xing'she	0
齐齐哈尔观光旅行社	qi'qi'ha'er'guan'guang'lv'xing'she	0
齐齐哈尔职工旅行社	qi'qi'ha'er'zhi'gong'lv'xing'she	0
齐齐哈尔中国国际旅行社	qi'qi'ha'er'zhong'guo'guo'ji'lv'xing'she	0
齐齐哈尔中国旅行社	qi'qi'ha'er'zhong'guo'lv'xing'she	0
齐齐哈尔中国青年旅行社	qi'qi'ha'er'zhong'guo'qing'nian'lv'xing'she	0
汽运总公司苏仙旅行社	qi'yun'zong'gong'si'su'xian'lv'xing'she	0
迁安市百顺达旅行社	qian'an'shi'bai'shun'da'lv'xing'she	0
千岛湖国际旅行社	qian'dao'hu'guo'ji'lv'xing'she	0
千岛湖海峡旅行社	qian'dao'hu'hai'xia'lv'xing'she	0
千岛湖航运旅行社	qian'dao'hu'hang'yun'lv'xing'she	0
千岛湖科技旅行社	qian'dao'hu'ke'ji'lv'xing'she	0
千岛湖岭南旅行社	qian'dao'hu'ling'nan'lv'xing'she	0
千岛湖旅行社	qian'dao'hu'lv'xing'she	0
千岛湖梦之岛旅行社	qian'dao'hu'meng'zhi'dao'lv'xing'she	0
千岛湖山水旅行社	qian'dao'hu'shan'shui'lv'xing'she	0
千岛湖阳光旅行社	qian'dao'hu'yang'guang'lv'xing'she	0
黔东南中国国际旅行社	qian'dong'nan'zhong'guo'guo'ji'lv'xing'she	0
秦皇岛长城国际旅行社	qin'huang'dao'chang'cheng'guo'ji'lv'xing'she	0
秦皇岛昌黎黄金海岸蓝天旅行社	qin'huang'dao'chang'li'huang'jin'hai'an'lan'tian'lv'xing'she	0
秦皇岛大河旅行社	qin'huang'dao'da'he'lv'xing'she	0
秦皇岛风光旅行社	qin'huang'dao'feng'guang'lv'xing'she	0
秦皇岛风情旅行社	qin'huang'dao'feng'qing'lv'xing'she	0
秦皇岛国际招商旅行社	qin'huang'dao'guo'ji'zhao'shang'lv'xing'she	0
秦皇岛航空旅行社	qin'huang'dao'hang'kong'lv'xing'she	0
秦皇岛和平国际旅行社	qin'huang'dao'he'ping'guo'ji'lv'xing'she	0
秦皇岛鸿洋旅行社	qin'huang'dao'hong'yang'lv'xing'she	0
秦皇岛华联旅行社	qin'huang'dao'hua'lian'lv'xing'she	0
秦皇岛环球旅行社	qin'huang'dao'huan'qiu'lv'xing'she	0
秦皇岛假日旅行社	qin'huang'dao'jia'ri'lv'xing'she	0
秦皇岛教育旅行社	qin'huang'dao'jiao'yu'lv'xing'she	0
秦皇岛联峰旅行社	qin'huang'dao'lian'feng'lv'xing'she	0
秦皇岛山水旅行社	qin'huang'dao'shan'shui'lv'xing'she	0
秦皇岛神州旅行社	qin'huang'dao'shen'zhou'lv'xing'she	0
秦皇岛市南戴河旅行社	qin'huang'dao'shi'nan'dai'he'lv'xing'she	0
秦皇岛市圆梦旅行社	qin'huang'dao'shi'yuan'meng'lv'xing'she	0
秦皇岛市中国旅行社	qin'huang'dao'shi'zhong'guo'lv'xing'she	0
秦皇岛太和商务旅行社	qin'huang'dao'tai'he'shang'wu'lv'xing'she	0
秦皇岛天马旅行社	qin'huang'dao'tian'ma'lv'xing'she	0
秦皇岛铁路旅行社	qin'huang'dao'tie'lu'lv'xing'she	0
秦皇岛铁路平安旅行社	qin'huang'dao'tie'lu'ping'an'lv'xing'she	0
秦皇岛站铁道旅行社	qin'huang'dao'zhan'tie'dao'lv'xing'she	0
秦皇岛中远旅行社	qin'huang'dao'zhong'yuan'lv'xing'she	0
秦皇岛祖龙旅行社	qin'huang'dao'zu'long'lv'xing'she	0
青岛北海旅行社	qing'dao'bei'hai'lv'xing'she	0
青岛超群旅行社	qing'dao'chao'qun'lv'xing'she	0
青岛东方旅行社	qing'dao'dong'fang'lv'xing'she	0
青岛东航旅行社	qing'dao'dong'hang'lv'xing'she	0
青岛泛海旅行社	qing'dao'fan'hai'lv'xing'she	0
青岛方通旅行社	qing'dao'fang'tong'lv'xing'she	0
青岛方圆旅行社	qing'dao'fang'yuan'lv'xing'she	0
青岛风情假期旅行社	qing'dao'feng'qing'jia'qi'lv'xing'she	0
青岛工贸旅行社	qing'dao'gong'mao'lv'xing'she	0
青岛广辰旅行社	qing'dao'guang'chen'lv'xing'she	0
青岛海滨旅行社	qing'dao'hai'bin'lv'xing'she	0
青岛海大旅行社	qing'dao'hai'da'lv'xing'she	0
青岛海华旅行社	qing'dao'hai'hua'lv'xing'she	0
青岛海龙旅行社	qing'dao'hai'long'lv'xing'she	0
青岛海马旅行社	qing'dao'hai'ma'lv'xing'she	0
青岛海鸥旅行社	qing'dao'hai'ou'lv'xing'she	0
青岛海青旅行社	qing'dao'hai'qing'lv'xing'she	0
青岛海外旅行社	qing'dao'hai'wai'lv'xing'she	0
青岛海洋旅行社	qing'dao'hai'yang'lv'xing'she	0
青岛和平假期旅行社	qing'dao'he'ping'jia'qi'lv'xing'she	0
青岛华天旅行社	qing'dao'hua'tian'lv'xing'she	0
青岛华威旅行社	qing'dao'hua'wei'lv'xing'she	0
青岛惠和旅行社	qing'dao'hui'he'lv'xing'she	0
青岛健康旅行社	qing'dao'jian'kang'lv'xing'she	0
青岛建银旅行社	qing'dao'jian'yin'lv'xing'she	0
青岛江山旅行社	qing'dao'jiang'shan'lv'xing'she	0
青岛教师旅行社	qing'dao'jiao'shi'lv'xing'she	0
青岛交运旅行社	qing'dao'jiao'yun'lv'xing'she	0
青岛金海旅行社	qing'dao'jin'hai'lv'xing'she	0
青岛经济技术开发区惠和旅行社	qing'dao'jing'ji'ji'shu'kai'fa'qu'hui'he'lv'xing'she	0
青岛经贸旅行社	qing'dao'jing'mao'lv'xing'she	0
青岛丽汀旅行社	qing'dao'li'ting'lv'xing'she	0
青岛联合假日旅行社	qing'dao'lian'he'jia'ri'lv'xing'she	0
青岛明珠旅行社	qing'dao'ming'zhu'lv'xing'she	0
青岛乾坤旅行社	qing'dao'qian'kun'lv'xing'she	0
青岛牵手旅行社	qing'dao'qian'shou'lv'xing'she	0
青岛山孚旅行社	qing'dao'shan'fu'lv'xing'she	0
青岛西霞口国际旅行社	qing'dao'xi'xia'kou'guo'ji'lv'xing'she	0
青岛新华旅行社	qing'dao'xin'hua'lv'xing'she	0
青岛新桥旅行社	qing'dao'xin'qiao'lv'xing'she	0
青岛新世纪国际旅行社	qing'dao'xin'shi'ji'guo'ji'lv'xing'she	0
青岛新亚旅行社	qing'dao'xin'ya'lv'xing'she	0
青岛心缘旅行社	qing'dao'xin'yuan'lv'xing'she	0
青岛幸福时光旅行社	qing'dao'xing'fu'shi'guang'lv'xing'she	0
青岛阳光海岸旅行社	qing'dao'yang'guang'hai'an'lv'xing'she	0
青岛阳光假日旅行社	qing'dao'yang'guang'jia'ri'lv'xing'she	0
青岛银海旅行社	qing'dao'yin'hai'lv'xing'she	0
青岛银泰旅行社	qing'dao'yin'tai'lv'xing'she	0
青岛雨浓旅行社	qing'dao'yu'nong'lv'xing'she	0
青岛御苑旅行社	qing'dao'yu'yuan'lv'xing'she	0
青岛众成旅行社	qing'dao'zhong'cheng'lv'xing'she	0
青岛中国国际旅行社	qing'dao'zhong'guo'guo'ji'lv'xing'she	0
青岛中国旅行社	qing'dao'zhong'guo'lv'xing'she	0
青海海峡旅行社	qing'hai'hai'xia'lv'xing'she	0
青海交通旅行社	qing'hai'jiao'tong'lv'xing'she	0
青海九州旅行社	qing'hai'jiu'zhou'lv'xing'she	0
青海蓝天旅行社	qing'hai'lan'tian'lv'xing'she	0
青海青藏国际旅行社	qing'hai'qing'zang'guo'ji'lv'xing'she	0
青海神舟旅行社	qing'hai'shen'zhou'lv'xing'she	0
青海省国际体育旅行社	qing'hai'sheng'guo'ji'ti'yu'lv'xing'she	0
青海省森林旅行社	qing'hai'sheng'sen'lin'lv'xing'she	0
青海省山水旅行社	qing'hai'sheng'shan'shui'lv'xing'she	0
青海省塔尔寺中国旅行社	qing'hai'sheng'ta'er'si'zhong'guo'lv'xing'she	0
青海省西海国际旅行社	qing'hai'sheng'xi'hai'guo'ji'lv'xing'she	0
青海省职工旅行社	qing'hai'sheng'zhi'gong'lv'xing'she	0
青海省中国国际旅行社	qing'hai'sheng'zhong'guo'guo'ji'lv'xing'she	0
青海省中国旅行社	qing'hai'sheng'zhong'guo'lv'xing'she	0
青海省中国青年旅行社	qing'hai'sheng'zhong'guo'qing'nian'lv'xing'she	0
青海四方旅行社	qing'hai'si'fang'lv'xing'she	0
青海塔尔寺邮政旅行社	qing'hai'ta'er'si'you'zheng'lv'xing'she	0
青海中国国际旅行社	qing'hai'zhong'guo'guo'ji'lv'xing'she	0
青田华侨旅行社	qing'tian'hua'qiao'lv'xing'she	0
青田县瓯江旅行社	qing'tian'xian'ou'jiang'lv'xing'she	0
青阳旅行社	qing'yang'lv'xing'she	0
清远市凤城旅行社	qing'yuan'shi'feng'cheng'lv'xing'she	0
庆元县交通旅行社	qing'yuan'xian'jiao'tong'lv'xing'she	0
曲阜大成旅行社	qu'fu'da'cheng'lv'xing'she	0
曲阜市旅行社	qu'fu'shi'lv'xing'she	0
曲阜市旅游局齐鲁旅行社	qu'fu'shi'lv'you'ju'qi'lu'lv'xing'she	0
曲阜天马旅行社	qu'fu'tian'ma'lv'xing'she	0
衢州航空旅行社	qu'zhou'hang'kong'lv'xing'she	0
衢州巨化八达旅行社	qu'zhou'ju'hua'ba'da'lv'xing'she	0
衢州市欢乐旅行社	qu'zhou'shi'huan'le'lv'xing'she	0
衢州市交通旅行社	qu'zhou'shi'jiao'tong'lv'xing'she	0
衢州市星光华旅行社	qu'zhou'shi'xing'guang'hua'lv'xing'she	0
衢州市中国旅行社	qu'zhou'shi'zhong'guo'lv'xing'she	0
衢州铁路旅行社	qu'zhou'tie'lu'lv'xing'she	0
衢州乌溪江仙霞旅行社	qu'zhou'wu'xi'jiang'xian'xia'lv'xing'she	0
全国政协协力国际旅行社	quan'guo'zheng'xie'xie'li'guo'ji'lv'xing'she	0
泉州安溪中国旅行社	quan'zhou'an'xi'zhong'guo'lv'xing'she	0
泉州东方旅行社	quan'zhou'dong'fang'lv'xing'she	0
泉州冠兴旅行社	quan'zhou'guan'xing'lv'xing'she	0
泉州海峡旅行社	quan'zhou'hai'xia'lv'xing'she	0
泉州虹桥旅行社	quan'zhou'hong'qiao'lv'xing'she	0
泉州建德旅行社	quan'zhou'jian'de'lv'xing'she	0
泉州晋江旅行社	quan'zhou'jin'jiang'lv'xing'she	0
泉州康健旅行社	quan'zhou'kang'jian'lv'xing'she	0
泉州鲤城旅行社	quan'zhou'li'cheng'lv'xing'she	0
泉州立辉旅行社	quan'zhou'li'hui'lv'xing'she	0
泉州闽兴旅行社	quan'zhou'min'xing'lv'xing'she	0
泉州侨联旅行社	quan'zhou'qiao'lian'lv'xing'she	0
泉州清源山旅行社	quan'zhou'qing'yuan'shan'lv'xing'she	0
泉州商业旅行社	quan'zhou'shang'ye'lv'xing'she	0
泉州市丰泽旅行社	quan'zhou'shi'feng'ze'lv'xing'she	0
泉州泰和旅行社	quan'zhou'tai'he'lv'xing'she	0
泉州天友旅行社	quan'zhou'tian'you'lv'xing'she	0
泉州中国国际旅行社	quan'zhou'zhong'guo'guo'ji'lv'xing'she	0
泉州中国旅行社	quan'zhou'zhong'guo'lv'xing'she	0
泉州中联旅行社	quan'zhou'zhong'lian'lv'xing'she	0
饶平县中国旅行社	rao'ping'xian'zhong'guo'lv'xing'she	0
日照和平旅行社	ri'zhao'he'ping'lv'xing'she	0
日照金诺旅行社	ri'zhao'jin'nuo'lv'xing'she	0
日照金秋旅行社	ri'zhao'jin'qiu'lv'xing'she	0
日照凯莱旅行社	ri'zhao'kai'lai'lv'xing'she	0
如皋市东方旅行社	ru'gao'shi'dong'fang'lv'xing'she	0
如皋市假日旅行社	ru'gao'shi'jia'ri'lv'xing'she	0
瑞安市新世纪教育旅行社	rui'an'shi'xin'shi'ji'jiao'yu'lv'xing'she	0
瑞安新世纪教育旅行社	rui'an'xin'shi'ji'jiao'yu'lv'xing'she	0
瑞安中国旅行社	rui'an'zhong'guo'lv'xing'she	0
赛特国际旅行社	sai'te'guo'ji'lv'xing'she	0
三国赤壁旅行社	san'guo'chi'bi'lv'xing'she	0
三江县民族风情旅行社	san'jiang'xian'min'zu'feng'qing'lv'xing'she	0
三九华联旅行社	san'jiu'hua'lian'lv'xing'she	0
三门峡春秋旅行社	san'men'xia'chun'qiu'lv'xing'she	0
三门峡富达旅行社	san'men'xia'fu'da'lv'xing'she	0
三门峡甘山旅行社	san'men'xia'gan'shan'lv'xing'she	0
三门峡假日旅行社	san'men'xia'jia'ri'lv'xing'she	0
三门峡青年旅行社	san'men'xia'qing'nian'lv'xing'she	0
三门峡神州旅行社	san'men'xia'shen'zhou'lv'xing'she	0
三门峡仰韶旅行社	san'men'xia'yang'shao'lv'xing'she	0
三门峡中国国际旅行社	san'men'xia'zhong'guo'guo'ji'lv'xing'she	0
三门峡中国旅行社	san'men'xia'zhong'guo'lv'xing'she	0
三门县天马旅行社	san'men'xian'tian'ma'lv'xing'she	0
三明国旅龙栖山旅行社	san'ming'guo'lv'long'qi'shan'lv'xing'she	0
三明市春秋旅行社	san'ming'shi'chun'qiu'lv'xing'she	0
三明市旅行社	san'ming'shi'lv'xing'she	0
三明市明运旅行社	san'ming'shi'ming'yun'lv'xing'she	0
三明市青年旅行社	san'ming'shi'qing'nian'lv'xing'she	0
三明市铁路旅行社	san'ming'shi'tie'lu'lv'xing'she	0
三明市中国青年旅行社	san'ming'shi'zhong'guo'qing'nian'lv'xing'she	0
三明中国旅行社	san'ming'zhong'guo'lv'xing'she	0
三亚假期旅行社	san'ya'jia'qi'lv'xing'she	0
三亚南山锦江旅行社	san'ya'nan'shan'jin'jiang'lv'xing'she	0
山东长城旅行社	shan'dong'chang'cheng'lv'xing'she	0
山东航空国际旅行社	shan'dong'hang'kong'guo'ji'lv'xing'she	0
山东济南风光旅行社	shan'dong'ji'nan'feng'guang'lv'xing'she	0
山东济南教育旅行社	shan'dong'ji'nan'jiao'yu'lv'xing'she	0
山东凯莱日昭旅行社	shan'dong'kai'lai'ri'zhao'lv'xing'she	0
山东孔子国际旅行社	shan'dong'kong'zi'guo'ji'lv'xing'she	0
山东立达旅行社	shan'dong'li'da'lv'xing'she	0
山东梁山旅行社	shan'dong'liang'shan'lv'xing'she	0
山东旅行社	shan'dong'lv'xing'she	0
山东欧美亚旅行社	shan'dong'ou'mei'ya'lv'xing'she	0
山东蓬莱教师旅行社	shan'dong'peng'lai'jiao'shi'lv'xing'she	0
山东蓬莱康辉旅行社	shan'dong'peng'lai'kang'hui'lv'xing'she	0
山东齐鲁金鑫旅行社	shan'dong'qi'lu'jin'xin'lv'xing'she	0
山东曲阜老年旅行社	shan'dong'qu'fu'lao'nian'lv'xing'she	0
山东山水旅行社	shan'dong'shan'shui'lv'xing'she	0
山东商务旅行社	shan'dong'shang'wu'lv'xing'she	0
山东省妇女旅行社	shan'dong'sheng'fu'nv'lv'xing'she	0
山东省交通旅行社	shan'dong'sheng'jiao'tong'lv'xing'she	0
山东省临沂市沂蒙旅行社	shan'dong'sheng'lin'yi'shi'yi'meng'lv'xing'she	0
山东省临沂市中国旅行社	shan'dong'sheng'lin'yi'shi'zhong'guo'lv'xing'she	0
山东省文化国际旅行社	shan'dong'sheng'wen'hua'guo'ji'lv'xing'she	0
山东省烟台南山旅行社	shan'dong'sheng'yan'tai'nan'shan'lv'xing'she	0
山东省烟台市福山旅行社	shan'dong'sheng'yan'tai'shi'fu'shan'lv'xing'she	0
山东省烟台市芝罘华侨旅行社	shan'dong'sheng'yan'tai'shi'zhi'fu'hua'qiao'lv'xing'she	0
山东省中国国际旅行社	shan'dong'sheng'zhong'guo'guo'ji'lv'xing'she	0
山东省中国青年旅行社	shan'dong'sheng'zhong'guo'qing'nian'lv'xing'she	0
山东泰山晨光旅行社	shan'dong'tai'shan'chen'guang'lv'xing'she	0
山东泰山旅行社	shan'dong'tai'shan'lv'xing'she	0
山东泰山腾飞旅行社	shan'dong'tai'shan'teng'fei'lv'xing'she	0
山东外经贸青岛新纪元旅行社	shan'dong'wai'jing'mao'qing'dao'xin'ji'yuan'lv'xing'she	0
山东潍坊东方旅行社	shan'dong'wei'fang'dong'fang'lv'xing'she	0
山东威海龙威旅行社	shan'dong'wei'hai'long'wei'lv'xing'she	0
山东烟台好人旅行社	shan'dong'yan'tai'hao'ren'lv'xing'she	0
山东烟台假日旅行社	shan'dong'yan'tai'jia'ri'lv'xing'she	0
山东烟台教育旅行社	shan'dong'yan'tai'jiao'yu'lv'xing'she	0
山东烟台三山旅行社	shan'dong'yan'tai'san'shan'lv'xing'she	0
山东烟台永安旅行社	shan'dong'yan'tai'yong'an'lv'xing'she	0
山东银通旅行社	shan'dong'yin'tong'lv'xing'she	0
山东友谊旅行社	shan'dong'you'yi'lv'xing'she	0
山东职工旅行社	shan'dong'zhi'gong'lv'xing'she	0
山东淄博中国青年旅行社	shan'dong'zi'bo'zhong'guo'qing'nian'lv'xing'she	0
山水假期旅行社	shan'shui'jia'qi'lv'xing'she	0
汕特侨商旅行社	shan'te'qiao'shang'lv'xing'she	0
汕头帝豪天驰国际旅行社	shan'tou'di'hao'tian'chi'guo'ji'lv'xing'she	0
汕头好风光旅行社	shan'tou'hao'feng'guang'lv'xing'she	0
汕头假日旅行社	shan'tou'jia'ri'lv'xing'she	0
汕头金桥旅行社	shan'tou'jin'qiao'lv'xing'she	0
汕头经济特区金海湾国际旅行社	shan'tou'jing'ji'te'qu'jin'hai'wan'guo'ji'lv'xing'she	0
汕头经济特区侨商旅行社	shan'tou'jing'ji'te'qu'qiao'shang'lv'xing'she	0
汕头经济特区中贸旅行社	shan'tou'jing'ji'te'qu'zhong'mao'lv'xing'she	0
汕头南峰旅行社	shan'tou'nan'feng'lv'xing'she	0
汕头市广澳旅行社	shan'tou'shi'guang'ao'lv'xing'she	0
汕头市海发旅行社	shan'tou'shi'hai'fa'lv'xing'she	0
汕头市海燕旅行社	shan'tou'shi'hai'yan'lv'xing'she	0
汕头市好风光旅行社	shan'tou'shi'hao'feng'guang'lv'xing'she	0
汕头市交通旅行社	shan'tou'shi'jiao'tong'lv'xing'she	0
汕头市金凤旅行社	shan'tou'shi'jin'feng'lv'xing'she	0
汕头市金湖旅行社	shan'tou'shi'jin'hu'lv'xing'she	0
汕头市乐观旅行社	shan'tou'shi'le'guan'lv'xing'she	0
汕头市名胜旅行社	shan'tou'shi'ming'sheng'lv'xing'she	0
汕头市青云旅行社	shan'tou'shi'qing'yun'lv'xing'she	0
汕头市顺安旅行社	shan'tou'shi'shun'an'lv'xing'she	0
汕头市职工旅行社	shan'tou'shi'zhi'gong'lv'xing'she	0
汕头翔华旅行社	shan'tou'xiang'hua'lv'xing'she	0
汕头粤东旅行社	shan'tou'yue'dong'lv'xing'she	0
汕头中国国际旅行社	shan'tou'zhong'guo'guo'ji'lv'xing'she	0
汕头中国青年旅行社	shan'tou'zhong'guo'qing'nian'lv'xing'she	0
汕尾中国旅行社	shan'wei'zhong'guo'lv'xing'she	0
山西北达航空旅行社	shan'xi'bei'da'hang'kong'lv'xing'she	0
山西北方风情旅行社	shan'xi'bei'fang'feng'qing'lv'xing'she	0
山西丛丛旅行社	shan'xi'cong'cong'lv'xing'she	0
陕西大庆旅行社	shan'xi'da'qing'lv'xing'she	0
山西大同颐达旅行社	shan'xi'da'tong'yi'da'lv'xing'she	0
陕西电子旅行社	shan'xi'dian'zi'lv'xing'she	0
陕西泛旅旅行社	shan'xi'fan'lv'lv'xing'she	0
陕西国内旅行社	shan'xi'guo'nei'lv'xing'she	0
陕西虹阳旅行社	shan'xi'hong'yang'lv'xing'she	0
山西环海实业总公司环海旅行社	shan'xi'huan'hai'shi'ye'zong'gong'si'huan'hai'lv'xing'she	0
陕西交通旅行社	shan'xi'jiao'tong'lv'xing'she	0
山西教育旅行社	shan'xi'jiao'yu'lv'xing'she	0
山西晋昌旅行社	shan'xi'jin'chang'lv'xing'she	0
山西晋城假日旅行社	shan'xi'jin'cheng'jia'ri'lv'xing'she	0
山西精英旅行社	shan'xi'jing'ying'lv'xing'she	0
陕西老干金秋旅行社	shan'xi'lao'gan'jin'qiu'lv'xing'she	0
陕西联谊旅行社	shan'xi'lian'yi'lv'xing'she	0
陕西旅行社	shan'xi'lv'xing'she	0
山西千友旅行社	shan'xi'qian'you'lv'xing'she	0
陕西秦飞旅行社	shan'xi'qin'fei'lv'xing'she	0
陕西青联旅行社	shan'xi'qing'lian'lv'xing'she	0
陕西省大庆旅行社	shan'xi'sheng'da'qing'lv'xing'she	0
山西省佛教文化旅行社	shan'xi'sheng'fo'jiao'wen'hua'lv'xing'she	0
山西省国防旅行社	shan'xi'sheng'guo'fang'lv'xing'she	0
山西省黄河旅行社	shan'xi'sheng'huang'he'lv'xing'she	0
山西省晋阳文化旅行社	shan'xi'sheng'jin'yang'wen'hua'lv'xing'she	0
山西省三晋旅行社	shan'xi'sheng'san'jin'lv'xing'she	0
山西省森林旅行社	shan'xi'sheng'sen'lin'lv'xing'she	0
陕西省唐城旅行社	shan'xi'sheng'tang'cheng'lv'xing'she	0
山西省天马旅行社	shan'xi'sheng'tian'ma'lv'xing'she	0
陕西省新时代旅行社	shan'xi'sheng'xin'shi'dai'lv'xing'she	0
山西省艺术家旅行社	shan'xi'sheng'yi'shu'jia'lv'xing'she	0
山西省职工旅行社	shan'xi'sheng'zhi'gong'lv'xing'she	0
山西省中国国际旅行社	shan'xi'sheng'zhong'guo'guo'ji'lv'xing'she	0
山西省中国旅行社	shan'xi'sheng'zhong'guo'lv'xing'she	0
陕西省中国青年旅行社	shan'xi'sheng'zhong'guo'qing'nian'lv'xing'she	0
山西省中国青年旅行社	shan'xi'sheng'zhong'guo'qing'nian'lv'xing'she	0
陕西师范大学旅行社	shan'xi'shi'fan'da'xue'lv'xing'she	0
山西唐明旅行社	shan'xi'tang'ming'lv'xing'she	0
陕西桃李旅行社	shan'xi'tao'li'lv'xing'she	0
陕西天和旅行社	shan'xi'tian'he'lv'xing'she	0
陕西外运旅行社	shan'xi'wai'yun'lv'xing'she	0
山西五洲旅行社	shan'xi'wu'zhou'lv'xing'she	0
陕西希望旅行社	shan'xi'xi'wang'lv'xing'she	0
陕西新闻旅行社	shan'xi'xin'wen'lv'xing'she	0
山西忻州天缘旅行社	shan'xi'xin'zhou'tian'yuan'lv'xing'she	0
山西忻州阳光旅行社	shan'xi'xin'zhou'yang'guang'lv'xing'she	0
陕西延安旅行社	shan'xi'yan'an'lv'xing'she	0
陕西邮电旅行社	shan'xi'you'dian'lv'xing'she	0
山西友好旅行社	shan'xi'you'hao'lv'xing'she	0
山西邮政旅行社	shan'xi'you'zheng'lv'xing'she	0
陕西远东国际旅行社	shan'xi'yuan'dong'guo'ji'lv'xing'she	0
山西远方旅行社	shan'xi'yuan'fang'lv'xing'she	0
陕西粤海旅行社	shan'xi'yue'hai'lv'xing'she	0
陕西职工国际旅行社	shan'xi'zhi'gong'guo'ji'lv'xing'she	0
山西中国青年旅行社	shan'xi'zhong'guo'qing'nian'lv'xing'she	0
商会旅行社	shang'hui'lv'xing'she	0
上饶圭峰旅行社	shang'rao'gui'feng'lv'xing'she	0
上饶国旅实业有限公司天马旅行社	shang'rao'guo'lv'shi'ye'you'xian'gong'si'tian'ma'lv'xing'she	0
上饶环球旅行社	shang'rao'huan'qiu'lv'xing'she	0
上饶三清山青云旅行社	shang'rao'san'qing'shan'qing'yun'lv'xing'she	0
上饶市青年旅行社	shang'rao'shi'qing'nian'lv'xing'she	0
上饶市职工旅行社	shang'rao'shi'zhi'gong'lv'xing'she	0
上饶天马旅行社	shang'rao'tian'ma'lv'xing'she	0
上饶铁路旅行社	shang'rao'tie'lu'lv'xing'she	0
韶关市教育旅行社	shao'guan'shi'jiao'yu'lv'xing'she	0
韶关市粤北旅行社	shao'guan'shi'yue'bei'lv'xing'she	0
韶关中国国际旅行社	shao'guan'zhong'guo'guo'ji'lv'xing'she	0
韶关中国旅行社	shao'guan'zhong'guo'lv'xing'she	0
韶山毛泽东纪念园旅行社	shao'shan'mao'ze'dong'ji'nian'yuan'lv'xing'she	0
韶山中国国际旅行社	shao'shan'zhong'guo'guo'ji'lv'xing'she	0
绍兴观光旅行社	shao'xing'guan'guang'lv'xing'she	0
绍兴上虞市旅行社	shao'xing'shang'yu'shi'lv'xing'she	0
绍兴嵊州市中国旅行社	shao'xing'sheng'zhou'shi'zhong'guo'lv'xing'she	0
绍兴市海峡旅行社	shao'xing'shi'hai'xia'lv'xing'she	0
绍兴市绿叶旅行社	shao'xing'shi'lv'ye'lv'xing'she	0
绍兴市青年旅行社	shao'xing'shi'qing'nian'lv'xing'she	0
绍兴市通联旅行社	shao'xing'shi'tong'lian'lv'xing'she	0
绍兴市职工旅行社	shao'xing'shi'zhi'gong'lv'xing'she	0
绍兴市中国旅行社	shao'xing'shi'zhong'guo'lv'xing'she	0
绍兴铁路旅行社	shao'xing'tie'lu'lv'xing'she	0
绍兴县鉴湖旅行社	shao'xing'xian'jian'hu'lv'xing'she	0
绍兴县金柯桥旅行社	shao'xing'xian'jin'ke'qiao'lv'xing'she	0
绍兴新昌县旅行社	shao'xing'xin'chang'xian'lv'xing'she	0
绍兴中国国际旅行社	shao'xing'zhong'guo'guo'ji'lv'xing'she	0
绍兴中兴旅行社	shao'xing'zhong'xing'lv'xing'she	0
绍兴诸暨旅行社	shao'xing'zhu'ji'lv'xing'she	0
射阳霞客旅行社	she'yang'xia'ke'lv'xing'she	0
射阳职工旅行社	she'yang'zhi'gong'lv'xing'she	0
神农国际旅行社	shen'nong'guo'ji'lv'xing'she	0
神农架假日旅行社	shen'nong'jia'jia'ri'lv'xing'she	0
神农架中国旅行社	shen'nong'jia'zhong'guo'lv'xing'she	0
沈铁分局旅行社	shen'tie'fen'ju'lv'xing'she	0
沈阳报业旅行社	shen'yang'bao'ye'lv'xing'she	0
沈阳故宫旅行社	shen'yang'gu'gong'lv'xing'she	0
沈阳华龙旅行社	shen'yang'hua'long'lv'xing'she	0
沈阳华翔旅行社	shen'yang'hua'xiang'lv'xing'she	0
沈阳火车头旅行社	shen'yang'huo'che'tou'lv'xing'she	0
沈阳金海岸旅行社	shen'yang'jin'hai'an'lv'xing'she	0
沈阳金桥国际旅行社	shen'yang'jin'qiao'guo'ji'lv'xing'she	0
沈阳京润旅行社	shen'yang'jing'run'lv'xing'she	0
沈阳蓝天旅行社	shen'yang'lan'tian'lv'xing'she	0
沈阳老年旅行社	shen'yang'lao'nian'lv'xing'she	0
沈阳联友旅行社	shen'yang'lian'you'lv'xing'she	0
沈阳全成旅行社	shen'yang'quan'cheng'lv'xing'she	0
沈阳山水旅行社	shen'yang'shan'shui'lv'xing'she	0
沈阳市北国旅行社	shen'yang'shi'bei'guo'lv'xing'she	0
沈阳世纪旅行社	shen'yang'shi'ji'lv'xing'she	0
沈阳市名流旅行社	shen'yang'shi'ming'liu'lv'xing'she	0
沈阳市万泉旅行社	shen'yang'shi'wan'quan'lv'xing'she	0
沈阳市新天旅行社	shen'yang'shi'xin'tian'lv'xing'she	0
沈阳市友好旅行社	shen'yang'shi'you'hao'lv'xing'she	0
沈阳顺达旅行社	shen'yang'shun'da'lv'xing'she	0
沈阳田园旅行社	shen'yang'tian'yuan'lv'xing'she	0
沈阳铁道青年旅行社	shen'yang'tie'dao'qing'nian'lv'xing'she	0
沈阳铁路分局旅行社	shen'yang'tie'lu'fen'ju'lv'xing'she	0
沈阳文教旅行社	shen'yang'wen'jiao'lv'xing'she	0
沈阳迎宾旅行社	shen'yang'ying'bin'lv'xing'she	0
沈阳玉麒麟旅行社	shen'yang'yu'qi'lin'lv'xing'she	0
沈阳园林国际旅行社	shen'yang'yuan'lin'guo'ji'lv'xing'she	0
沈阳招商旅行社	shen'yang'zhao'shang'lv'xing'she	0
沈阳职工旅行社	shen'yang'zhi'gong'lv'xing'she	0
深圳机场国际旅行社	shen'zhen'ji'chang'guo'ji'lv'xing'she	0
深圳江南旅行社	shen'zhen'jiang'nan'lv'xing'she	0
深圳经济特区华侨城中国旅行社	shen'zhen'jing'ji'te'qu'hua'qiao'cheng'zhong'guo'lv'xing'she	0
深圳经济特区旅行社	shen'zhen'jing'ji'te'qu'lv'xing'she	0
深圳南山国际旅行社	shen'zhen'nan'shan'guo'ji'lv'xing'she	0
深圳深华国际旅行社	shen'zhen'shen'hua'guo'ji'lv'xing'she	0
深圳市报业国际旅行社	shen'zhen'shi'bao'ye'guo'ji'lv'xing'she	0
深圳市长虹旅行社	shen'zhen'shi'chang'hong'lv'xing'she	0
深圳市东方国际旅行社	shen'zhen'shi'dong'fang'guo'ji'lv'xing'she	0
深圳市航空国际旅行社	shen'zhen'shi'hang'kong'guo'ji'lv'xing'she	0
深圳市环球旅行社	shen'zhen'shi'huan'qiu'lv'xing'she	0
深圳市巨邦国际旅行社	shen'zhen'shi'ju'bang'guo'ji'lv'xing'she	0
深圳市龙岗区沙湾福建中国旅行社	shen'zhen'shi'long'gang'qu'sha'wan'fu'jian'zhong'guo'lv'xing'she	0
深圳市鹏运国际旅行社	shen'zhen'shi'peng'yun'guo'ji'lv'xing'she	0
深圳市深业国际旅行社	shen'zhen'shi'shen'ye'guo'ji'lv'xing'she	0
深圳市通发旅行社	shen'zhen'shi'tong'fa'lv'xing'she	0
深圳市讯业国际旅行社	shen'zhen'shi'xun'ye'guo'ji'lv'xing'she	0
深圳市友谊国际旅行社	shen'zhen'shi'you'yi'guo'ji'lv'xing'she	0
深圳市中国旅行社	shen'zhen'shi'zhong'guo'lv'xing'she	0
深圳友谊旅行社	shen'zhen'you'yi'lv'xing'she	0
深圳职工国际旅行社	shen'zhen'zhi'gong'guo'ji'lv'xing'she	0
神州国际旅行社	shen'zhou'guo'ji'lv'xing'she	0
神州旅行社	shen'zhou'lv'xing'she	0
胜利油田国际旅行社	sheng'li'you'tian'guo'ji'lv'xing'she	0
胜利油田青年旅行社	sheng'li'you'tian'qing'nian'lv'xing'she	0
胜利油田职工旅行社	sheng'li'you'tian'zhi'gong'lv'xing'she	0
嵊泗列岛旅游总公司嵊泗旅行社	sheng'si'lie'dao'lv'you'zong'gong'si'sheng'si'lv'xing'she	0
什邡三山旅行社	shi'fang'san'shan'lv'xing'she	0
什邡山水旅行社	shi'fang'shan'shui'lv'xing'she	0
什邡市旅行社	shi'fang'shi'lv'xing'she	0
什邡莹华山旅行社	shi'fang'ying'hua'shan'lv'xing'she	0
石家庄红星旅行社	shi'jia'zhuang'hong'xing'lv'xing'she	0
石家庄华都旅行社	shi'jia'zhuang'hua'du'lv'xing'she	0
石家庄蓝天旅行社	shi'jia'zhuang'lan'tian'lv'xing'she	0
石家庄市妇女旅行社	shi'jia'zhuang'shi'fu'nv'lv'xing'she	0
石家庄市公交旅行社	shi'jia'zhuang'shi'gong'jiao'lv'xing'she	0
石家庄市迅达交通旅行社	shi'jia'zhuang'shi'xun'da'jiao'tong'lv'xing'she	0
石家庄铁道旅行社	shi'jia'zhuang'tie'dao'lv'xing'she	0
石家庄铁路正太旅行社	shi'jia'zhuang'tie'lu'zheng'tai'lv'xing'she	0
石家庄亚太旅行社	shi'jia'zhuang'ya'tai'lv'xing'she	0
石家庄园丁旅行社	shi'jia'zhuang'yuan'ding'lv'xing'she	0
市启城旅行社	shi'qi'cheng'lv'xing'she	0
石狮东方旅行社	shi'shi'dong'fang'lv'xing'she	0
石狮假日旅行社	shi'shi'jia'ri'lv'xing'she	0
石狮旅行社	shi'shi'lv'xing'she	0
石狮中国旅行社	shi'shi'zhong'guo'lv'xing'she	0
石台中信旅行社	shi'tai'zhong'xin'lv'xing'she	0
市文化局文化旅行社	shi'wen'hua'ju'wen'hua'lv'xing'she	0
十堰湖北神农架森林旅行社	shi'yan'hu'bei'shen'nong'jia'sen'lin'lv'xing'she	0
十堰神农架大自然旅行社	shi'yan'shen'nong'jia'da'zi'ran'lv'xing'she	0
十堰神农架国家森林公园旅行社	shi'yan'shen'nong'jia'guo'jia'sen'lin'gong'yuan'lv'xing'she	0
十堰神农架假日旅行社	shi'yan'shen'nong'jia'jia'ri'lv'xing'she	0
十堰神农架旅行社	shi'yan'shen'nong'jia'lv'xing'she	0
十堰神农架中国旅行社	shi'yan'shen'nong'jia'zhong'guo'lv'xing'she	0
十堰神农架中国青年旅行社	shi'yan'shen'nong'jia'zhong'guo'qing'nian'lv'xing'she	0
十堰市华夏旅行社	shi'yan'shi'hua'xia'lv'xing'she	0
十堰中国国际旅行社	shi'yan'zhong'guo'guo'ji'lv'xing'she	0
书苑旅行社	shu'yuan'lv'xing'she	0
水利电力部十二局新安江华电旅行社	shui'li'dian'li'bu'shi'er'ju'xin'an'jiang'hua'dian'lv'xing'she	0
顺达旅行社	shun'da'lv'xing'she	0
顺德市口岸国际旅行社	shun'de'shi'kou'an'guo'ji'lv'xing'she	0
顺德市青年旅行社	shun'de'shi'qing'nian'lv'xing'she	0
顺德市中国旅行社	shun'de'shi'zhong'guo'lv'xing'she	0
顺风旅行社	shun'feng'lv'xing'she	0
四川阿坝国际旅行社	si'chuan'a'ba'guo'ji'lv'xing'she	0
四川阿坝旅行社	si'chuan'a'ba'lv'xing'she	0
四川大学教育旅行社	si'chuan'da'xue'jiao'yu'lv'xing'she	0
四川德阳时代旅行社	si'chuan'de'yang'shi'dai'lv'xing'she	0
四川和平国际旅行社	si'chuan'he'ping'guo'ji'lv'xing'she	0
四川科技旅行社	si'chuan'ke'ji'lv'xing'she	0
四川明珠旅行社	si'chuan'ming'zhu'lv'xing'she	0
四川山水旅行社	si'chuan'shan'shui'lv'xing'she	0
四川省长江国际旅行社	si'chuan'sheng'chang'jiang'guo'ji'lv'xing'she	0
四川省成都市贡嘎旅行社	si'chuan'sheng'cheng'du'shi'gong'ga'lv'xing'she	0
四川省虹桥国际旅行社	si'chuan'sheng'hong'qiao'guo'ji'lv'xing'she	0
四川省蜀运旅行社	si'chuan'sheng'shu'yun'lv'xing'she	0
四川省中国国际旅行社	si'chuan'sheng'zhong'guo'guo'ji'lv'xing'she	0
四川省中国旅行社	si'chuan'sheng'zhong'guo'lv'xing'she	0
四川石油旅行社	si'chuan'shi'you'lv'xing'she	0
四川邮电旅行社	si'chuan'you'dian'lv'xing'she	0
四川职工旅行社	si'chuan'zhi'gong'lv'xing'she	0
四达国际旅行社	si'da'guo'ji'lv'xing'she	0
四海旅行社	si'hai'lv'xing'she	0
四季旅行社	si'ji'lv'xing'she	0
松阳长运旅行社	song'yang'chang'yun'lv'xing'she	0
松阳县长运旅行社	song'yang'xian'chang'yun'lv'xing'she	0
苏州春秋旅行社	su'zhou'chun'qiu'lv'xing'she	0
苏州大地旅行社	su'zhou'da'di'lv'xing'she	0
苏州电力旅行社	su'zhou'dian'li'lv'xing'she	0
苏州东吴国际旅行社	su'zhou'dong'wu'guo'ji'lv'xing'she	0
苏州东吴中国旅行社	su'zhou'dong'wu'zhong'guo'lv'xing'she	0
苏州风光旅行社	su'zhou'feng'guang'lv'xing'she	0
苏州和平国际旅行社	su'zhou'he'ping'guo'ji'lv'xing'she	0
苏州鹤翔国内旅行社	su'zhou'he'xiang'guo'nei'lv'xing'she	0
苏州环球旅行社	su'zhou'huan'qiu'lv'xing'she	0
苏州交通旅行社	su'zhou'jiao'tong'lv'xing'she	0
苏州教育旅行社	su'zhou'jiao'yu'lv'xing'she	0
苏州蓝天国内旅行社	su'zhou'lan'tian'guo'nei'lv'xing'she	0
苏州劳动旅行社	su'zhou'lao'dong'lv'xing'she	0
苏州乐园国内旅行社	su'zhou'le'yuan'guo'nei'lv'xing'she	0
苏州旅行社	su'zhou'lv'xing'she	0
苏州民族国内旅行社	su'zhou'min'zu'guo'nei'lv'xing'she	0
苏州汽车出租公司的士旅行社	su'zhou'qi'che'chu'zu'gong'si'di'shi'lv'xing'she	0
宿州市教育旅行社	su'zhou'shi'jiao'yu'lv'xing'she	0
宿州市中国旅行社	su'zhou'shi'zhong'guo'lv'xing'she	0
苏州太湖国际旅行社	su'zhou'tai'hu'guo'ji'lv'xing'she	0
苏州文化国际旅行社	su'zhou'wen'hua'guo'ji'lv'xing'she	0
宿州星之旅旅行社	su'zhou'xing'zhi'lv'lv'xing'she	0
苏州永安旅游服务总公司永安旅行社	su'zhou'yong'an'lv'you'fu'wu'zong'gong'si'yong'an'lv'xing'she	0
苏州永安旅游公司永安旅行社	su'zhou'yong'an'lv'you'gong'si'yong'an'lv'xing'she	0
苏州园林旅游服务公司园林旅行社	su'zhou'yuan'lin'lv'you'fu'wu'gong'si'yuan'lin'lv'xing'she	0
苏州职工国际旅行社	su'zhou'zhi'gong'guo'ji'lv'xing'she	0
苏州中国旅行社	su'zhou'zhong'guo'lv'xing'she	0
遂昌县含晖旅行社	sui'chang'xian'han'hui'lv'xing'she	0
绥芬河宏华旅行社	sui'fen'he'hong'hua'lv'xing'she	0
绥芬河花卉旅行社	sui'fen'he'hua'hui'lv'xing'she	0
绥芬河口岸旅行社	sui'fen'he'kou'an'lv'xing'she	0
绥芬河三丰国际旅行社	sui'fen'he'san'feng'guo'ji'lv'xing'she	0
绥芬河市陆丰国际旅行社	sui'fen'he'shi'lu'feng'guo'ji'lv'xing'she	0
绥芬河市松江旅行社	sui'fen'he'shi'song'jiang'lv'xing'she	0
绥芬河兄弟旅行社	sui'fen'he'xiong'di'lv'xing'she	0
绥芬河邮电旅行社	sui'fen'he'you'dian'lv'xing'she	0
泰安大都旅行社	tai'an'da'du'lv'xing'she	0
泰安大山旅行社	tai'an'da'shan'lv'xing'she	0
泰安交通旅行社	tai'an'jiao'tong'lv'xing'she	0
泰安金城旅行社	tai'an'jin'cheng'lv'xing'she	0
泰安金色假日旅行社	tai'an'jin'se'jia'ri'lv'xing'she	0
泰安九州旅行社	tai'an'jiu'zhou'lv'xing'she	0
泰安山水旅行社	tai'an'shan'shui'lv'xing'she	0
泰安市虹桥旅行社	tai'an'shi'hong'qiao'lv'xing'she	0
泰安市六路通旅行社	tai'an'shi'liu'lu'tong'lv'xing'she	0
泰安市天贶旅行社	tai'an'shi'tian'kuang'lv'xing'she	0
泰安市天外村旅行社	tai'an'shi'tian'wai'cun'lv'xing'she	0
泰安市新大都旅行社	tai'an'shi'xin'da'dou'lv'xing'she	0
泰安天成旅行社	tai'an'tian'cheng'lv'xing'she	0
泰安天龙旅行社	tai'an'tian'long'lv'xing'she	0
泰安望岳旅行社	tai'an'wang'yue'lv'xing'she	0
泰安职工旅行社	tai'an'zhi'gong'lv'xing'she	0
泰安中国旅行社	tai'an'zhong'guo'lv'xing'she	0
太仓国贸国内旅行社	tai'cang'guo'mao'guo'nei'lv'xing'she	0
太仓华厦国内旅行社	tai'cang'hua'sha'guo'nei'lv'xing'she	0
泰丰旅行社	tai'feng'lv'xing'she	0
泰宁县金湖邮电旅行社	tai'ning'xian'jin'hu'you'dian'lv'xing'she	0
泰宁中国旅行社	tai'ning'zhong'guo'lv'xing'she	0
泰山春秋旅行社	tai'shan'chun'qiu'lv'xing'she	0
泰山风光旅行社	tai'shan'feng'guang'lv'xing'she	0
泰山海天国际旅行社	tai'shan'hai'tian'guo'ji'lv'xing'she	0
泰山宏源旅行社	tai'shan'hong'yuan'lv'xing'she	0
泰山教育旅行社	tai'shan'jiao'yu'lv'xing'she	0
泰山金桥旅行社	tai'shan'jin'qiao'lv'xing'she	0
泰山景区蓝盾旅行社	tai'shan'jing'qu'lan'dun'lv'xing'she	0
泰山丽岳旅行社	tai'shan'li'yue'lv'xing'she	0
泰山气功旅行社	tai'shan'qi'gong'lv'xing'she	0
泰山索道旅行社	tai'shan'suo'dao'lv'xing'she	0
泰山铁信旅行社	tai'shan'tie'xin'lv'xing'she	0
泰山文化旅行社	tai'shan'wen'hua'lv'xing'she	0
泰山一马旅行社	tai'shan'yi'ma'lv'xing'she	0
泰山永安旅行社	tai'shan'yong'an'lv'xing'she	0
泰山远大旅行社	tai'shan'yuan'da'lv'xing'she	0
泰山云海旅行社	tai'shan'yun'hai'lv'xing'she	0
泰山中国国际旅行社	tai'shan'zhong'guo'guo'ji'lv'xing'she	0
泰山中国青年旅行社	tai'shan'zhong'guo'qing'nian'lv'xing'she	0
泰山中信旅行社	tai'shan'zhong'xin'lv'xing'she	0
泰兴市欧亚旅行社	tai'xing'shi'ou'ya'lv'xing'she	0
泰兴市中国青年旅行社	tai'xing'shi'zhong'guo'qing'nian'lv'xing'she	0
太原白天鹅旅行社	tai'yuan'bai'tian'e'lv'xing'she	0
太原来来旅行社	tai'yuan'lai'lai'lv'xing'she	0
太原煤乡旅行社	tai'yuan'mei'xiang'lv'xing'she	0
太原市并工旅行社	tai'yuan'shi'bing'gong'lv'xing'she	0
太原市国兴旅行社	tai'yuan'shi'guo'xing'lv'xing'she	0
太原市同源旅行社	tai'yuan'shi'tong'yuan'lv'xing'she	0
太原市新华旅行社	tai'yuan'shi'xin'hua'lv'xing'she	0
太原市雅兴旅行社	tai'yuan'shi'ya'xing'lv'xing'she	0
太原市职工旅行社	tai'yuan'shi'zhi'gong'lv'xing'she	0
太原市中侨旅行社	tai'yuan'shi'zhong'qiao'lv'xing'she	0
太原腾兴铁路旅行社	tai'yuan'teng'xing'tie'lu'lv'xing'she	0
太原西山旅行社	tai'yuan'xi'shan'lv'xing'she	0
台州东亚旅行社	tai'zhou'dong'ya'lv'xing'she	0
台州光大旅行社	tai'zhou'guang'da'lv'xing'she	0
台州华夏旅行社	tai'zhou'hua'xia'lv'xing'she	0
台州青年旅行社	tai'zhou'qing'nian'lv'xing'she	0
泰州市长运旅行社	tai'zhou'shi'chang'yun'lv'xing'she	0
泰州市国脉旅行社	tai'zhou'shi'guo'mai'lv'xing'she	0
泰州市假日旅行社	tai'zhou'shi'jia'ri'lv'xing'she	0
台州市江南旅行社	tai'zhou'shi'jiang'nan'lv'xing'she	0
台州市金安旅行社	tai'zhou'shi'jin'an'lv'xing'she	0
台州市路桥兴安旅行社	tai'zhou'shi'lu'qiao'xing'an'lv'xing'she	0
台州市天马旅行社	tai'zhou'shi'tian'ma'lv'xing'she	0
台州市通达航空旅行社	tai'zhou'shi'tong'da'hang'kong'lv'xing'she	0
台州天台山国际旅行社	tai'zhou'tian'tai'shan'guo'ji'lv'xing'she	0
泰州扬子江旅行社	tai'zhou'yang'zi'jiang'lv'xing'she	0
台州中国旅行社	tai'zhou'zhong'guo'lv'xing'she	0
唐山北方旅行社	tang'shan'bei'fang'lv'xing'she	0
唐山市华辰旅行社	tang'shan'shi'hua'chen'lv'xing'she	0
唐山市神舟旅行社	tang'shan'shi'shen'zhou'lv'xing'she	0
唐山市中国旅行社	tang'shan'shi'zhong'guo'lv'xing'she	0
唐山友谊旅行社	tang'shan'you'yi'lv'xing'she	0
桃花源旅行社	tao'hua'yuan'lv'xing'she	0
天津八达旅行社	tian'jin'ba'da'lv'xing'she	0
天津百乐旅行社	tian'jin'bai'le'lv'xing'she	0
天津百龙旅行社	tian'jin'bai'long'lv'xing'she	0
天津博瀚旅行社	tian'jin'bo'han'lv'xing'she	0
天津昌逸旅行社	tian'jin'chang'yi'lv'xing'she	0
天津春秋旅行社	tian'jin'chun'qiu'lv'xing'she	0
天津大地国际旅行社	tian'jin'da'di'guo'ji'lv'xing'she	0
天津方舟旅行社	tian'jin'fang'zhou'lv'xing'she	0
天津飞达商务旅行社	tian'jin'fei'da'shang'wu'lv'xing'she	0
天津富达旅行社	tian'jin'fu'da'lv'xing'she	0
天津港旅行社	tian'jin'gang'lv'xing'she	0
天津观光旅行社	tian'jin'guan'guang'lv'xing'she	0
天津海峡旅行社	tian'jin'hai'xia'lv'xing'she	0
天津宏马旅行社	tian'jin'hong'ma'lv'xing'she	0
天津红桥旅行社	tian'jin'hong'qiao'lv'xing'she	0
天津华特旅行社	tian'jin'hua'te'lv'xing'she	0
天津花园旅行社	tian'jin'hua'yuan'lv'xing'she	0
天津江河旅行社	tian'jin'jiang'he'lv'xing'she	0
天津教育国际旅行社	tian'jin'jiao'yu'guo'ji'lv'xing'she	0
天津金宝旅行社	tian'jin'jin'bao'lv'xing'she	0
天津金旭旅行社	tian'jin'jin'xu'lv'xing'she	0
天津经典假期国际旅行社	tian'jin'jing'dian'jia'qi'guo'ji'lv'xing'she	0
天津静海旅行社	tian'jin'jing'hai'lv'xing'she	0
天津九龙旅行社	tian'jin'jiu'long'lv'xing'she	0
天津开发区华泰旅行社	tian'jin'kai'fa'qu'hua'tai'lv'xing'she	0
天津开发区泰达旅行社	tian'jin'kai'fa'qu'tai'da'lv'xing'she	0
天津康顺旅行社	tian'jin'kang'shun'lv'xing'she	0
天津可隆旅行社	tian'jin'ke'long'lv'xing'she	0
天津旅行社	tian'jin'lv'xing'she	0
天津美达旅行社	tian'jin'mei'da'lv'xing'she	0
天津清源旅行社	tian'jin'qing'yuan'lv'xing'she	0
天津三峰旅行社	tian'jin'san'feng'lv'xing'she	0
天津商务旅行社	tian'jin'shang'wu'lv'xing'she	0
天津圣亚旅行社	tian'jin'sheng'ya'lv'xing'she	0
天津市百乐旅行社	tian'jin'shi'bai'le'lv'xing'she	0
天津市出租汽车总公司九州旅行社	tian'jin'shi'chu'zu'qi'che'zong'gong'si'jiu'zhou'lv'xing'she	0
天津市大亚旅行社	tian'jin'shi'da'ya'lv'xing'she	0
天津师范大学实达旅行社	tian'jin'shi'fan'da'xue'shi'da'lv'xing'she	0
天津市风帆旅行社	tian'jin'shi'feng'fan'lv'xing'she	0
天津市妇女国际旅行社	tian'jin'shi'fu'nv'guo'ji'lv'xing'she	0
天津市公交旅行社	tian'jin'shi'gong'jiao'lv'xing'she	0
天津市和平区天泰旅行社	tian'jin'shi'he'ping'qu'tian'tai'lv'xing'she	0
天津市河西区太平洋旅行社	tian'jin'shi'he'xi'qu'tai'ping'yang'lv'xing'she	0
天津市华美旅行社	tian'jin'shi'hua'mei'lv'xing'she	0
天津市寰宇旅行社	tian'jin'shi'huan'yu'lv'xing'she	0
天津市黄土地旅行社	tian'jin'shi'huang'tu'di'lv'xing'she	0
天津世纪旅行社	tian'jin'shi'ji'lv'xing'she	0
天津市教师旅行社	tian'jin'shi'jiao'shi'lv'xing'she	0
天津市金宝旅行旅行社	tian'jin'shi'jin'bao'lv'xing'lv'xing'she	0
天津市金岛旅行社	tian'jin'shi'jin'dao'lv'xing'she	0
天津市金龙旅行社	tian'jin'shi'jin'long'lv'xing'she	0
天津市金翼国际旅行社	tian'jin'shi'jin'yi'guo'ji'lv'xing'she	0
天津市九州旅行社	tian'jin'shi'jiu'zhou'lv'xing'she	0
天津市龙悦国际旅行社	tian'jin'shi'long'yue'guo'ji'lv'xing'she	0
天津市侨友旅行社	tian'jin'shi'qiao'you'lv'xing'she	0
天津市市青电旅行社	tian'jin'shi'shi'qing'dian'lv'xing'she	0
天津市四通旅行社	tian'jin'shi'si'tong'lv'xing'she	0
天津市天龙旅行社	tian'jin'shi'tian'long'lv'xing'she	0
天津市天马旅行社	tian'jin'shi'tian'ma'lv'xing'she	0
天津市天使旅行社	tian'jin'shi'tian'shi'lv'xing'she	0
天津市外院旅行社	tian'jin'shi'wai'yuan'lv'xing'she	0
天津市沃特旅行社	tian'jin'shi'wo'te'lv'xing'she	0
天津市鑫鹏旅行社	tian'jin'shi'xin'peng'lv'xing'she	0
天津市邮购公司旅行社	tian'jin'shi'you'gou'gong'si'lv'xing'she	0
天津市中国旅行社	tian'jin'shi'zhong'guo'lv'xing'she	0
天津市中华行运通旅行社	tian'jin'shi'zhong'hua'xing'yun'tong'lv'xing'she	0
天津四方旅行社	tian'jin'si'fang'lv'xing'she	0
天津四海旅行社	tian'jin'si'hai'lv'xing'she	0
天津太平洋旅行社	tian'jin'tai'ping'yang'lv'xing'she	0
天津天地旅行社	tian'jin'tian'di'lv'xing'she	0
天津天鹅旅行社	tian'jin'tian'e'lv'xing'she	0
天津天狮国际旅行社	tian'jin'tian'shi'guo'ji'lv'xing'she	0
天津通海旅行社	tian'jin'tong'hai'lv'xing'she	0
天津万祺旅行社	tian'jin'wan'qi'lv'xing'she	0
天津仙百合旅行社	tian'jin'xian'bai'he'lv'xing'she	0
天津协通国际旅行社	tian'jin'xie'tong'guo'ji'lv'xing'she	0
天津协通旅行社	tian'jin'xie'tong'lv'xing'she	0
天津新世家旅行社	tian'jin'xin'shi'jia'lv'xing'she	0
天津新亚旅行社	tian'jin'xin'ya'lv'xing'she	0
天津星海旅行社	tian'jin'xing'hai'lv'xing'she	0
天津旭日旅行社	tian'jin'xu'ri'lv'xing'she	0
天津银达金融旅行社	tian'jin'yin'da'jin'rong'lv'xing'she	0
天津友好国际旅行社	tian'jin'you'hao'guo'ji'lv'xing'she	0
天津友好旅行社	tian'jin'you'hao'lv'xing'she	0
天津园林旅行社	tian'jin'yuan'lin'lv'xing'she	0
天津中广国际旅行社	tian'jin'zhong'guang'guo'ji'lv'xing'she	0
天津中国国际旅行社	tian'jin'zhong'guo'guo'ji'lv'xing'she	0
天津中国青年旅行社	tian'jin'zhong'guo'qing'nian'lv'xing'she	0
天津中山旅行社	tian'jin'zhong'shan'lv'xing'she	0
天龙八部国际旅行社	tian'long'ba'bu'guo'ji'lv'xing'she	0
天马旅行社	tian'ma'lv'xing'she	0
天平国际旅行社	tian'ping'guo'ji'lv'xing'she	0
天汽集团海波旅行社	tian'qi'ji'tuan'hai'bo'lv'xing'she	0
天时旅行社	tian'shi'lv'xing'she	0
天水羲皇旅行社	tian'shui'xi'huang'lv'xing'she	0
天台山水旅行社	tian'tai'shan'shui'lv'xing'she	0
天台中国国际旅行社	tian'tai'zhong'guo'guo'ji'lv'xing'she	0
天园国际旅行社	tian'yuan'guo'ji'lv'xing'she	0
天柱山春秋旅行社	tian'zhu'shan'chun'qiu'lv'xing'she	0
天柱山森林旅行社	tian'zhu'shan'sen'lin'lv'xing'she	0
天柱山神州旅行社	tian'zhu'shan'shen'zhou'lv'xing'she	0
天柱山舒州旅行社	tian'zhu'shan'shu'zhou'lv'xing'she	0
天柱山皖西南旅行社	tian'zhu'shan'wan'xi'nan'lv'xing'she	0
天柱山物华旅行社	tian'zhu'shan'wu'hua'lv'xing'she	0
天柱山新世纪旅行社	tian'zhu'shan'xin'shi'ji'lv'xing'she	0
天柱山心怡旅行社	tian'zhu'shan'xin'yi'lv'xing'she	0
天柱山园林旅行社	tian'zhu'shan'yuan'lin'lv'xing'she	0
天柱山中乔假日旅行社	tian'zhu'shan'zhong'qiao'jia'ri'lv'xing'she	0
铁道部第四工程局天津旅行社	tie'dao'bu'di'si'gong'cheng'ju'tian'jin'lv'xing'she	0
铁力旅行社	tie'li'lv'xing'she	0
铁路国际旅行社	tie'lu'guo'ji'lv'xing'she	0
铁路青岛站旅行社	tie'lu'qing'dao'zhan'lv'xing'she	0
通达旅行社	tong'da'lv'xing'she	0
同江市旅行社	tong'jiang'shi'lv'xing'she	0
铜陵市中国旅行社	tong'ling'shi'zhong'guo'lv'xing'she	0
桐庐电力旅行社	tong'lu'dian'li'lv'xing'she	0
桐庐钓鱼台旅行社	tong'lu'diao'yu'tai'lv'xing'she	0
桐庐富春江旅行社	tong'lu'fu'chun'jiang'lv'xing'she	0
桐庐中侨旅行社	tong'lu'zhong'qiao'lv'xing'she	0
桐乡市梧桐假日旅行社	tong'xiang'shi'wu'tong'jia'ri'lv'xing'she	0
桐乡梧桐假日旅行社	tong'xiang'wu'tong'jia'ri'lv'xing'she	0
同源国际旅行社	tong'yuan'guo'ji'lv'xing'she	0
通州市广电旅行社	tong'zhou'shi'guang'dian'lv'xing'she	0
万帮旅行社	wan'bang'lv'xing'she	0
万年青旅行社	wan'nian'qing'lv'xing'she	0
万全旅行社	wan'quan'lv'xing'she	0
万象时空旅行社	wan'xiang'shi'kong'lv'xing'she	0
王子旅行社	wang'zi'lv'xing'she	0
围场旅行社	wei'chang'lv'xing'she	0
围场青年旅行社	wei'chang'qing'nian'lv'xing'she	0
潍坊华之旅旅行社	wei'fang'hua'zhi'lv'lv'xing'she	0
潍坊金宝旅行社	wei'fang'jin'bao'lv'xing'she	0
潍坊希望旅行社	wei'fang'xi'wang'lv'xing'she	0
潍坊中国国际旅行社	wei'fang'zhong'guo'guo'ji'lv'xing'she	0
威海高教旅行社	wei'hai'gao'jiao'lv'xing'she	0
威海海峡旅行社	wei'hai'hai'xia'lv'xing'she	0
威海海苑旅行社	wei'hai'hai'yuan'lv'xing'she	0
威海金鸽旅行社	wei'hai'jin'ge'lv'xing'she	0
威海金色假日旅行社	wei'hai'jin'se'jia'ri'lv'xing'she	0
威海凯顺旅行社	wei'hai'kai'shun'lv'xing'she	0
威海民族旅行社	wei'hai'min'zu'lv'xing'she	0
威海山水旅行社	wei'hai'shan'shui'lv'xing'she	0
威海圣水观旅行社	wei'hai'sheng'shui'guan'lv'xing'she	0
威海石岛旅行社	wei'hai'shi'dao'lv'xing'she	0
威海铁路旅行社	wei'hai'tie'lu'lv'xing'she	0
威海西霞口国际旅行社	wei'hai'xi'xia'kou'guo'ji'lv'xing'she	0
威海中国国际旅行社	wei'hai'zhong'guo'guo'ji'lv'xing'she	0
威海中国旅行社	wei'hai'zhong'guo'lv'xing'she	0
威海中视旅行社	wei'hai'zhong'shi'lv'xing'she	0
威海中信国际旅行社	wei'hai'zhong'xin'guo'ji'lv'xing'she	0
微山湖旅行社	wei'shan'hu'lv'xing'she	0
文化旅行社	wen'hua'lv'xing'she	0
文山三鑫旅行社	wen'shan'san'xin'lv'xing'she	0
温州苍南旅行社	wen'zhou'cang'nan'lv'xing'she	0
温州大众旅行社	wen'zhou'da'zhong'lv'xing'she	0
温州国际旅行社	wen'zhou'guo'ji'lv'xing'she	0
温州湖滨旅行社	wen'zhou'hu'bin'lv'xing'she	0
温州楠溪江旅行社	wen'zhou'nan'xi'jiang'lv'xing'she	0
温州平阳县长运旅行社	wen'zhou'ping'yang'xian'chang'yun'lv'xing'she	0
温州市纺织旅行社	wen'zhou'shi'fang'zhi'lv'xing'she	0
温州市金秋旅行社	wen'zhou'shi'jin'qiu'lv'xing'she	0
温州市友好旅行社	wen'zhou'shi'you'hao'lv'xing'she	0
温州市职工旅行社	wen'zhou'shi'zhi'gong'lv'xing'she	0
温州雁荡山环宇旅行社	wen'zhou'yan'dang'shan'huan'yu'lv'xing'she	0
温州雁荡山山河旅行社	wen'zhou'yan'dang'shan'shan'he'lv'xing'she	0
温州浙南旅行社	wen'zhou'zhe'nan'lv'xing'she	0
温州中国旅行社	wen'zhou'zhong'guo'lv'xing'she	0
武汉阿里山旅行社	wu'han'a'li'shan'lv'xing'she	0
武汉白云旅行社	wu'han'bai'yun'lv'xing'she	0
武汉大学旅行社	wu'han'da'xue'lv'xing'she	0
武汉风光旅行社	wu'han'feng'guang'lv'xing'she	0
武汉湖北神农国际旅行社	wu'han'hu'bei'shen'nong'guo'ji'lv'xing'she	0
武汉欢乐假期旅行社	wu'han'huan'le'jia'qi'lv'xing'she	0
武汉蓝天旅行社	wu'han'lan'tian'lv'xing'she	0
武汉旅行社	wu'han'lv'xing'she	0
武汉青源旅行社	wu'han'qing'yuan'lv'xing'she	0
武汉神州老年旅行社	wu'han'shen'zhou'lao'nian'lv'xing'she	0
武汉市安达旅行社	wu'han'shi'an'da'lv'xing'she	0
武汉市安通旅行社	wu'han'shi'an'tong'lv'xing'she	0
武汉市江夏旅行社	wu'han'shi'jiang'xia'lv'xing'she	0
武汉市青年旅行社	wu'han'shi'qing'nian'lv'xing'she	0
武汉市山水旅行社	wu'han'shi'shan'shui'lv'xing'she	0
武汉市文化旅行社	wu'han'shi'wen'hua'lv'xing'she	0
武汉市武昌旅行社	wu'han'shi'wu'chang'lv'xing'she	0
武汉市运通旅行社	wu'han'shi'yun'tong'lv'xing'she	0
武汉晚报新闻旅行社	wu'han'wan'bao'xin'wen'lv'xing'she	0
武汉武昌车站铁路旅行社	wu'han'wu'chang'che'zhan'tie'lu'lv'xing'she	0
武汉武大旅行社	wu'han'wu'da'lv'xing'she	0
武汉扬子江国际旅行社	wu'han'yang'zi'jiang'guo'ji'lv'xing'she	0
武汉邮电旅行社	wu'han'you'dian'lv'xing'she	0
五华县中国旅行社	wu'hua'xian'zhong'guo'lv'xing'she	0
吴江风光国内旅行社	wu'jiang'feng'guang'guo'nei'lv'xing'she	0
吴江佳安国内旅行社	wu'jiang'jia'an'guo'nei'lv'xing'she	0
吴江天马旅行社	wu'jiang'tian'ma'lv'xing'she	0
吴江同里国内旅行社	wu'jiang'tong'li'guo'nei'lv'xing'she	0
吴江吴都国内旅行社	wu'jiang'wu'dou'guo'nei'lv'xing'she	0
吴江新时代国内旅行社	wu'jiang'xin'shi'dai'guo'nei'lv'xing'she	0
武进群星旅行社	wu'jin'qun'xing'lv'xing'she	0
武进市职工旅行社	wu'jin'shi'zhi'gong'lv'xing'she	0
武陵源金峰旅行社	wu'ling'yuan'jin'feng'lv'xing'she	0
武陵源职工假日旅行社	wu'ling'yuan'zhi'gong'jia'ri'lv'xing'she	0
乌鲁木齐阿凡提旅行社	wu'lu'mu'qi'a'fan'ti'lv'xing'she	0
乌鲁木齐博达旅行社	wu'lu'mu'qi'bo'da'lv'xing'she	0
乌鲁木齐辰光旅行社	wu'lu'mu'qi'chen'guang'lv'xing'she	0
乌鲁木齐高新区新纪元旅行社	wu'lu'mu'qi'gao'xin'qu'xin'ji'yuan'lv'xing'she	0
乌鲁木齐供销旅行社	wu'lu'mu'qi'gong'xiao'lv'xing'she	0
乌鲁木齐教育旅行社	wu'lu'mu'qi'jiao'yu'lv'xing'she	0
乌鲁木齐邮政旅行社	wu'lu'mu'qi'you'zheng'lv'xing'she	0
巫山县风景旅行社	wu'shan'xian'feng'jing'lv'xing'she	0
巫山县国轻旅行社	wu'shan'xian'guo'qing'lv'xing'she	0
巫山县恒达旅行社	wu'shan'xian'heng'da'lv'xing'she	0
巫山县金桥旅行社	wu'shan'xian'jin'qiao'lv'xing'she	0
巫山县金穗旅行社	wu'shan'xian'jin'sui'lv'xing'she	0
巫山县旅行社	wu'shan'xian'lv'xing'she	0
巫山县青年旅行社	wu'shan'xian'qing'nian'lv'xing'she	0
巫山县三峡教育旅行社	wu'shan'xian'san'xia'jiao'yu'lv'xing'she	0
巫山县神女旅行社	wu'shan'xian'shen'nv'lv'xing'she	0
巫山县巫峡旅行社	wu'shan'xian'wu'xia'lv'xing'she	0
巫山县小小三峡旅行社	wu'shan'xian'xiao'xiao'san'xia'lv'xing'she	0
巫山县新世纪旅行社	wu'shan'xian'xin'shi'ji'lv'xing'she	0
五台山风景名胜区森林旅行社	wu'tai'shan'feng'jing'ming'sheng'qu'sen'lin'lv'xing'she	0
五台山风景名胜区友好旅行社	wu'tai'shan'feng'jing'ming'sheng'qu'you'hao'lv'xing'she	0
五台山旅行社	wu'tai'shan'lv'xing'she	0
五台山中国国际旅行社	wu'tai'shan'zhong'guo'guo'ji'lv'xing'she	0
武铁汉口火车站旅行社	wu'tie'han'kou'huo'che'zhan'lv'xing'she	0
武铁汉口站旅行社	wu'tie'han'kou'zhan'lv'xing'she	0
无锡湖滨国际旅行社	wu'xi'hu'bin'guo'ji'lv'xing'she	0
无锡江南国际旅行社	wu'xi'jiang'nan'guo'ji'lv'xing'she	0
无锡教育旅行社	wu'xi'jiao'yu'lv'xing'she	0
无锡康辉旅行社	wu'xi'kang'hui'lv'xing'she	0
无锡市风光旅行社	wu'xi'shi'feng'guang'lv'xing'she	0
无锡市海澜旅行社	wu'xi'shi'hai'lan'lv'xing'she	0
无锡市申锡铁路旅行社	wu'xi'shi'shen'xi'tie'lu'lv'xing'she	0
无锡市水秀旅行社	wu'xi'shi'shui'xiu'lv'xing'she	0
无锡市太湖旅行社	wu'xi'shi'tai'hu'lv'xing'she	0
无锡市银都旅行社	wu'xi'shi'yin'du'lv'xing'she	0
无锡市职工国际旅行社	wu'xi'shi'zhi'gong'guo'ji'lv'xing'she	0
无锡太湖国家旅游度假区灵山旅行社	wu'xi'tai'hu'guo'jia'lv'you'du'jia'qu'ling'shan'lv'xing'she	0
无锡职工国际旅行社	wu'xi'zhi'gong'guo'ji'lv'xing'she	0
吴县航空国内旅行社	wu'xian'hang'kong'guo'nei'lv'xing'she	0
吴县市西山国森旅行社	wu'xian'shi'xi'shan'guo'sen'lv'xing'she	0
吴县西山国家森林公园国内旅行社	wu'xian'xi'shan'guo'jia'sen'lin'gong'yuan'guo'nei'lv'xing'she	0
武夷山稻香村旅行社	wu'yi'shan'dao'xiang'cun'lv'xing'she	0
武夷山航空旅行社	wu'yi'shan'hang'kong'lv'xing'she	0
武夷山华尔斯旅行社	wu'yi'shan'hua'er'si'lv'xing'she	0
武夷山交通旅行社	wu'yi'shan'jiao'tong'lv'xing'she	0
武夷山教育旅行社	wu'yi'shan'jiao'yu'lv'xing'she	0
武夷山金茂旅行社	wu'yi'shan'jin'mao'lv'xing'she	0
武夷山闽运旅行社	wu'yi'shan'min'yun'lv'xing'she	0
武夷山南方铁路旅行社	wu'yi'shan'nan'fang'tie'lu'lv'xing'she	0
武夷山市春秋旅行社	wu'yi'shan'shi'chun'qiu'lv'xing'she	0
武夷山市度假旅行社	wu'yi'shan'shi'du'jia'lv'xing'she	0
武夷山市教育旅行社	wu'yi'shan'shi'jiao'yu'lv'xing'she	0
武夷山市九舟旅行社	wu'yi'shan'shi'jiu'zhou'lv'xing'she	0
武夷山市商贸旅行社	wu'yi'shan'shi'shang'mao'lv'xing'she	0
武夷山市天马旅行社	wu'yi'shan'shi'tian'ma'lv'xing'she	0
武夷山市原野旅行社	wu'yi'shan'shi'yuan'ye'lv'xing'she	0
武夷山夷景旅行社	wu'yi'shan'yi'jing'lv'xing'she	0
武夷山玉女旅行社	wu'yi'shan'yu'nv'lv'xing'she	0
武夷山云安旅行社	wu'yi'shan'yun'an'lv'xing'she	0
武夷山中国国际旅行社	wu'yi'shan'zhong'guo'guo'ji'lv'xing'she	0
武夷山中国旅行社	wu'yi'shan'zhong'guo'lv'xing'she	0
武夷中国旅行社	wu'yi'zhong'guo'lv'xing'she	0
西北民航青年旅行社	xi'bei'min'hang'qing'nian'lv'xing'she	0
西北师范大学教育旅行社	xi'bei'shi'fan'da'xue'jiao'yu'lv'xing'she	0
西昌东方航天旅行社	xi'chang'dong'fang'hang'tian'lv'xing'she	0
西昌航天旅行社	xi'chang'hang'tian'lv'xing'she	0
西昌金英旅行社	xi'chang'jin'ying'lv'xing'she	0
西昌市大凉山旅行社	xi'chang'shi'da'liang'shan'lv'xing'she	0
西昌市交通旅行社	xi'chang'shi'jiao'tong'lv'xing'she	0
西昌招商旅行社	xi'chang'zhao'shang'lv'xing'she	0
息耒小庄旅行社	xi'lei'xiao'zhuang'lv'xing'she	0
西联旅行社	xi'lian'lv'xing'she	0
西南交通大学峨眉山大学生旅行社	xi'nan'jiao'tong'da'xue'e'mei'shan'da'xue'sheng'lv'xing'she	0
西宁铁道旅行社	xi'ning'tie'dao'lv'xing'she	0
锡山旅行社	xi'shan'lv'xing'she	0
西双版纳财鑫旅行社	xi'shuang'ban'na'cai'xin'lv'xing'she	0
西双版纳风情旅行社	xi'shuang'ban'na'feng'qing'lv'xing'she	0
西双版纳公主旅行社	xi'shuang'ban'na'gong'zhu'lv'xing'she	0
西双版纳光达旅行社	xi'shuang'ban'na'guang'da'lv'xing'she	0
西双版纳海泷旅行社	xi'shuang'ban'na'hai'long'lv'xing'she	0
西双版纳航泰旅行社	xi'shuang'ban'na'hang'tai'lv'xing'she	0
西双版纳皇冠旅行社	xi'shuang'ban'na'huang'guan'lv'xing'she	0
西双版纳交通旅行社	xi'shuang'ban'na'jiao'tong'lv'xing'she	0
西双版纳金盾旅行社	xi'shuang'ban'na'jin'dun'lv'xing'she	0
西双版纳金元旅行社	xi'shuang'ban'na'jin'yuan'lv'xing'she	0
西双版纳京洪旅行社	xi'shuang'ban'na'jing'hong'lv'xing'she	0
西双版纳景兴旅行社	xi'shuang'ban'na'jing'xing'lv'xing'she	0
西双版纳康辉旅行社	xi'shuang'ban'na'kang'hui'lv'xing'she	0
西双版纳青年旅行社	xi'shuang'ban'na'qing'nian'lv'xing'she	0
西双版纳文化旅行社	xi'shuang'ban'na'wen'hua'lv'xing'she	0
西双版纳依兰旅行社	xi'shuang'ban'na'yi'lan'lv'xing'she	0
西双版纳永安旅行社	xi'shuang'ban'na'yong'an'lv'xing'she	0
西双版纳雨林旅行社	xi'shuang'ban'na'yu'lin'lv'xing'she	0
西双版纳中国国际旅行社	xi'shuang'ban'na'zhong'guo'guo'ji'lv'xing'she	0
西藏布达拉民间旅行社	xi'zang'bu'da'la'min'jian'lv'xing'she	0
西藏昌都国际旅行社	xi'zang'chang'du'guo'ji'lv'xing'she	0
西藏妇女旅行社	xi'zang'fu'nv'lv'xing'she	0
西藏刚坚旅行社	xi'zang'gang'jian'lv'xing'she	0
西藏哈达集团国际旅行社	xi'zang'ha'da'ji'tuan'guo'ji'lv'xing'she	0
西藏环宇旅行社	xi'zang'huan'yu'lv'xing'she	0
西藏假日国际旅行社	xi'zang'jia'ri'guo'ji'lv'xing'she	0
西藏交通圣地旅行社	xi'zang'jiao'tong'sheng'di'lv'xing'she	0
西藏金谷旅行社	xi'zang'jin'gu'lv'xing'she	0
西藏康辉旅行社	xi'zang'kang'hui'lv'xing'she	0
西藏山水旅行社	xi'zang'shan'shui'lv'xing'she	0
西藏神湖旅行社	xi'zang'shen'hu'lv'xing'she	0
西藏雪莲旅行社	xi'zang'xue'lian'lv'xing'she	0
西藏雪域旅行社	xi'zang'xue'yu'lv'xing'she	0
西藏艺苑旅行社	xi'zang'yi'yuan'lv'xing'she	0
西藏中国旅行社	xi'zang'zhong'guo'lv'xing'she	0
西藏自治区外贸旅行社	xi'zang'zi'zhi'qu'wai'mao'lv'xing'she	0
厦门春辉旅行社	xia'men'chun'hui'lv'xing'she	0
厦门国贸国际旅行社	xia'men'guo'mao'guo'ji'lv'xing'she	0
厦门国贸旅行社	xia'men'guo'mao'lv'xing'she	0
厦门海外环球旅行社	xia'men'hai'wai'huan'qiu'lv'xing'she	0
厦门海峡旅行社	xia'men'hai'xia'lv'xing'she	0
厦门华东旅行社	xia'men'hua'dong'lv'xing'she	0
厦门欢乐假期旅行社	xia'men'huan'le'jia'qi'lv'xing'she	0
厦门环州旅行社	xia'men'huan'zhou'lv'xing'she	0
厦门建发国际旅行社	xia'men'jian'fa'guo'ji'lv'xing'she	0
厦门建发旅行社	xia'men'jian'fa'lv'xing'she	0
厦门教育旅行社	xia'men'jiao'yu'lv'xing'she	0
厦门鹭佳旅行社	xia'men'lu'jia'lv'xing'she	0
厦门旅行社	xia'men'lv'xing'she	0
厦门民安旅行社	xia'men'min'an'lv'xing'she	0
厦门民谊旅行社	xia'men'min'yi'lv'xing'she	0
厦门青旅东南旅行社	xia'men'qing'lv'dong'nan'lv'xing'she	0
厦门山水旅行社	xia'men'shan'shui'lv'xing'she	0
厦门商业旅行社	xia'men'shang'ye'lv'xing'she	0
厦门市太平洋旅行社	xia'men'shi'tai'ping'yang'lv'xing'she	0
厦门市友好旅行社	xia'men'shi'you'hao'lv'xing'she	0
厦门特贸国际旅行社	xia'men'te'mao'guo'ji'lv'xing'she	0
厦门特运旅行社	xia'men'te'yun'lv'xing'she	0
厦门天马旅行社	xia'men'tian'ma'lv'xing'she	0
厦门铁路旅行社	xia'men'tie'lu'lv'xing'she	0
厦门文化旅行社	xia'men'wen'hua'lv'xing'she	0
厦门兴宝国际旅行社	xia'men'xing'bao'guo'ji'lv'xing'she	0
厦门兴良友旅行社	xia'men'xing'liang'you'lv'xing'she	0
厦门洋洋旅行社	xia'men'yang'yang'lv'xing'she	0
厦门育青旅行社	xia'men'yu'qing'lv'xing'she	0
厦门中国国际旅行社	xia'men'zhong'guo'guo'ji'lv'xing'she	0
厦门中旅假日旅行社	xia'men'zhong'lv'jia'ri'lv'xing'she	0
厦门中侨旅行社	xia'men'zhong'qiao'lv'xing'she	0
仙境旅行社	xian'jing'lv'xing'she	0
仙居旅行社	xian'ju'lv'xing'she	0
仙居中国旅行社	xian'ju'zhong'guo'lv'xing'she	0
襄樊市航空旅行社	xiang'fan'shi'hang'kong'lv'xing'she	0
襄樊铁路国际旅行社	xiang'fan'tie'lu'guo'ji'lv'xing'she	0
湘西之旅旅行社	xiang'xi'zhi'lv'lv'xing'she	0
孝感市谊乐旅行社	xiao'gan'shi'yi'le'lv'xing'she	0
萧山市旅行社	xiao'shan'shi'lv'xing'she	0
新干线旅行社	xin'gan'xian'lv'xing'she	0
鑫海国际旅行社	xin'hai'guo'ji'lv'xing'she	0
新疆阿拉山口国际旅行社	xin'jiang'a'la'shan'kou'guo'ji'lv'xing'she	0
新疆北疆铁路旅行社	xin'jiang'bei'jiang'tie'lu'lv'xing'she	0
新疆昌吉州科教旅行社	xin'jiang'chang'ji'zhou'ke'jiao'lv'xing'she	0
新疆大地国际旅行社	xin'jiang'da'di'guo'ji'lv'xing'she	0
新疆大自然国际旅行社	xin'jiang'da'zi'ran'guo'ji'lv'xing'she	0
新疆妇女旅行社	xin'jiang'fu'nv'lv'xing'she	0
新疆海峡国际旅行社	xin'jiang'hai'xia'guo'ji'lv'xing'she	0
新疆瀚海旅行社	xin'jiang'han'hai'lv'xing'she	0
新疆好望角旅行社	xin'jiang'hao'wang'jiao'lv'xing'she	0
新疆华侨国内旅行社	xin'jiang'hua'qiao'guo'nei'lv'xing'she	0
新疆交通旅行社	xin'jiang'jiao'tong'lv'xing'she	0
新疆金戈旅行社	xin'jiang'jin'ge'lv'xing'she	0
新疆经贸国际旅行社	xin'jiang'jing'mao'guo'ji'lv'xing'she	0
新疆经贸旅行社	xin'jiang'jing'mao'lv'xing'she	0
新疆京新国际旅行社	xin'jiang'jing'xin'guo'ji'lv'xing'she	0
新疆喀纳斯国际旅行社	xin'jiang'ka'na'si'guo'ji'lv'xing'she	0
新疆喀什中国旅行社	xin'jiang'ka'shi'zhong'guo'lv'xing'she	0
新疆康华旅行社	xin'jiang'kang'hua'lv'xing'she	0
新疆康辉国际旅行社	xin'jiang'kang'hui'guo'ji'lv'xing'she	0
新疆绿洲中国旅行社	xin'jiang'lv'zhou'zhong'guo'lv'xing'she	0
新疆美丽华旅行社	xin'jiang'mei'li'hua'lv'xing'she	0
新疆民航旅行社	xin'jiang'min'hang'lv'xing'she	0
新疆民族国际旅行社	xin'jiang'min'zu'guo'ji'lv'xing'she	0
新疆穆斯林旅行社	xin'jiang'mu'si'lin'lv'xing'she	0
新疆山水旅行社	xin'jiang'shan'shui'lv'xing'she	0
新疆神州行旅行社	xin'jiang'shen'zhou'xing'lv'xing'she	0
新疆丝绸之路旅行社	xin'jiang'si'chou'zhi'lu'lv'xing'she	0
新疆天鹅旅行社	xin'jiang'tian'e'lv'xing'she	0
新疆天山天池国际旅行社	xin'jiang'tian'shan'tian'chi'guo'ji'lv'xing'she	0
新疆天山行旅行社	xin'jiang'tian'shan'xing'lv'xing'she	0
新疆乌鲁木齐康乐假期旅行社	xin'jiang'wu'lu'mu'qi'kang'le'jia'qi'lv'xing'she	0
新疆乌鲁木齐旅游局宏远旅行社	xin'jiang'wu'lu'mu'qi'lv'you'ju'hong'yuan'lv'xing'she	0
新疆乌鲁木齐西部游旅行社	xin'jiang'wu'lu'mu'qi'xi'bu'you'lv'xing'she	0
新疆西王母旅行社	xin'jiang'xi'wang'mu'lv'xing'she	0
新疆鑫海旅行社	xin'jiang'xin'hai'lv'xing'she	0
新疆新天地旅行社	xin'jiang'xin'tian'di'lv'xing'she	0
新疆伊宁国际旅行社	xin'jiang'yi'ning'guo'ji'lv'xing'she	0
新疆迎宾旅行社	xin'jiang'ying'bin'lv'xing'she	0
新疆邮电国际旅行社	xin'jiang'you'dian'guo'ji'lv'xing'she	0
新疆中国国际旅行社	xin'jiang'zhong'guo'guo'ji'lv'xing'she	0
新疆中国旅行社	xin'jiang'zhong'guo'lv'xing'she	0
新闵旅行社	xin'min'lv'xing'she	0
新宁县莨山旅行社	xin'ning'xian'liang'shan'lv'xing'she	0
新天地旅行社	xin'tian'di'lv'xing'she	0
新乡市佳日旅行社	xin'xiang'shi'jia'ri'lv'xing'she	0
新乡市天泉旅行社	xin'xiang'shi'tian'quan'lv'xing'she	0
新兴县中国旅行社	xin'xing'xian'zhong'guo'lv'xing'she	0
新余市中国国际旅行社	xin'yu'shi'zhong'guo'guo'ji'lv'xing'she	0
新源县旅行社	xin'yuan'xian'lv'xing'she	0
忻州中国旅行社	xin'zhou'zhong'guo'lv'xing'she	0
兴贸旅行社	xing'mao'lv'xing'she	0
兴山县高岚旅行社	xing'shan'xian'gao'lan'lv'xing'she	0
邢台辰光国际旅行社	xing'tai'chen'guang'guo'ji'lv'xing'she	0
邢台辰光旅行社	xing'tai'chen'guang'lv'xing'she	0
邢台广电旅行社	xing'tai'guang'dian'lv'xing'she	0
邢台航空旅行社	xing'tai'hang'kong'lv'xing'she	0
兴州旅行社	xing'zhou'lv'xing'she	0
许昌文化旅行社	xu'chang'wen'hua'lv'xing'she	0
盱眙旅行社	xu'yi'lv'xing'she	0
徐州安达旅行社	xu'zhou'an'da'lv'xing'she	0
徐州春秋旅行社	xu'zhou'chun'qiu'lv'xing'she	0
徐州大正旅行社	xu'zhou'da'zheng'lv'xing'she	0
徐州东方旅行社	xu'zhou'dong'fang'lv'xing'she	0
徐州光大旅行社	xu'zhou'guang'da'lv'xing'she	0
徐州国泰旅行社	xu'zhou'guo'tai'lv'xing'she	0
徐州华鸿旅行社	xu'zhou'hua'hong'lv'xing'she	0
徐州淮海旅行社	xu'zhou'huai'hai'lv'xing'she	0
徐州假日旅行社	xu'zhou'jia'ri'lv'xing'she	0
徐州康辉旅行社	xu'zhou'kang'hui'lv'xing'she	0
徐州旅行社	xu'zhou'lv'xing'she	0
徐州太阳旅行社	xu'zhou'tai'yang'lv'xing'she	0
徐州天力电信旅行社	xu'zhou'tian'li'dian'xin'lv'xing'she	0
徐州天马旅行社	xu'zhou'tian'ma'lv'xing'she	0
徐州铁路国际旅行社	xu'zhou'tie'lu'guo'ji'lv'xing'she	0
徐州新闻旅行社	xu'zhou'xin'wen'lv'xing'she	0
徐州云龙湖旅行社	xu'zhou'yun'long'hu'lv'xing'she	0
徐州云龙旅行社	xu'zhou'yun'long'lv'xing'she	0
徐州职工旅行社	xu'zhou'zhi'gong'lv'xing'she	0
徐州中国国际旅行社	xu'zhou'zhong'guo'guo'ji'lv'xing'she	0
徐州中国旅行社	xu'zhou'zhong'guo'lv'xing'she	0
宣城国际旅行社	xuan'cheng'guo'ji'lv'xing'she	0
宣慰旅行社	xuan'wei'lv'xing'she	0
亚克西旅行社	ya'ke'xi'lv'xing'she	0
亚龙湾假期国际旅行社	ya'long'wan'jia'qi'guo'ji'lv'xing'she	0
亚州旅行社	ya'zhou'lv'xing'she	0
延安假日旅行社	yan'an'jia'ri'lv'xing'she	0
延安青年旅行社	yan'an'qing'nian'lv'xing'she	0
延安中国国际旅行社	yan'an'zhong'guo'guo'ji'lv'xing'she	0
延边阿里郎国际旅行社	yan'bian'a'li'lang'guo'ji'lv'xing'she	0
延边白山国际旅行社	yan'bian'bai'shan'guo'ji'lv'xing'she	0
延边太平洋国际旅行社	yan'bian'tai'ping'yang'guo'ji'lv'xing'she	0
延边邮电国际旅行社	yan'bian'you'dian'guo'ji'lv'xing'she	0
延边中国旅行社	yan'bian'zhong'guo'lv'xing'she	0
盐城国泰商务旅行社	yan'cheng'guo'tai'shang'wu'lv'xing'she	0
盐城航空旅行社	yan'cheng'hang'kong'lv'xing'she	0
盐城鸿雁旅行社	yan'cheng'hong'yan'lv'xing'she	0
盐城华通旅行社	yan'cheng'hua'tong'lv'xing'she	0
盐城环球旅行社	yan'cheng'huan'qiu'lv'xing'she	0
盐城假日旅行社	yan'cheng'jia'ri'lv'xing'she	0
盐城旅行社	yan'cheng'lv'xing'she	0
盐城商务国泰旅行社	yan'cheng'shang'wu'guo'tai'lv'xing'she	0
盐城市春秋旅行社	yan'cheng'shi'chun'qiu'lv'xing'she	0
盐城市望海商务旅行社	yan'cheng'shi'wang'hai'shang'wu'lv'xing'she	0
盐城四海交通旅行社	yan'cheng'si'hai'jiao'tong'lv'xing'she	0
盐城望海商务旅行社	yan'cheng'wang'hai'shang'wu'lv'xing'she	0
盐城新百旅行社	yan'cheng'xin'bai'lv'xing'she	0
盐城职工旅行社	yan'cheng'zhi'gong'lv'xing'she	0
盐城中国旅行社	yan'cheng'zhong'guo'lv'xing'she	0
延吉大地旅行社	yan'ji'da'di'lv'xing'she	0
延吉东北亚旅行社	yan'ji'dong'bei'ya'lv'xing'she	0
延吉延边长白山木森林国际旅行社	yan'ji'yan'bian'chang'bai'shan'mu'sen'lin'guo'ji'lv'xing'she	0
延吉延边大学国际旅行社	yan'ji'yan'bian'da'xue'guo'ji'lv'xing'she	0
延吉延边东方旅行社	yan'ji'yan'bian'dong'fang'lv'xing'she	0
延吉延边航空国际旅行社	yan'ji'yan'bian'hang'kong'guo'ji'lv'xing'she	0
延吉延边航空旅行社	yan'ji'yan'bian'hang'kong'lv'xing'she	0
延吉延边虹桥旅行社	yan'ji'yan'bian'hong'qiao'lv'xing'she	0
延吉延边江河国际旅行社	yan'ji'yan'bian'jiang'he'guo'ji'lv'xing'she	0
延吉延边江河旅行社	yan'ji'yan'bian'jiang'he'lv'xing'she	0
延吉延边康辉旅行社	yan'ji'yan'bian'kang'hui'lv'xing'she	0
延吉延边青年旅行社	yan'ji'yan'bian'qing'nian'lv'xing'she	0
延吉延边文化国际旅行社	yan'ji'yan'bian'wen'hua'guo'ji'lv'xing'she	0
延吉延边亚洲旅行社	yan'ji'yan'bian'ya'zhou'lv'xing'she	0
延吉延边远东国际旅行社	yan'ji'yan'bian'yuan'dong'guo'ji'lv'xing'she	0
延吉延边职工国际旅行社	yan'ji'yan'bian'zhi'gong'guo'ji'lv'xing'she	0
延吉延边中国国际旅行社	yan'ji'yan'bian'zhong'guo'guo'ji'lv'xing'she	0
延吉延边中国旅行社	yan'ji'yan'bian'zhong'guo'lv'xing'she	0
炎陵县金叶旅行社	yan'ling'xian'jin'ye'lv'xing'she	0
炎陵县炎帝旅行社	yan'ling'xian'yan'di'lv'xing'she	0
砚山旅行社	yan'shan'lv'xing'she	0
烟台百锐旅行社	yan'tai'bai'rui'lv'xing'she	0
烟台北方旅行社	yan'tai'bei'fang'lv'xing'she	0
烟台北海旅行社	yan'tai'bei'hai'lv'xing'she	0
烟台长岛青联旅行社	yan'tai'chang'dao'qing'lian'lv'xing'she	0
烟台超越旅行社	yan'tai'chao'yue'lv'xing'she	0
烟台春秋旅行社	yan'tai'chun'qiu'lv'xing'she	0
烟台东海旅行社	yan'tai'dong'hai'lv'xing'she	0
烟台发展旅行社	yan'tai'fa'zhan'lv'xing'she	0
烟台风光旅行社	yan'tai'feng'guang'lv'xing'she	0
烟台凤凰旅行社	yan'tai'feng'huang'lv'xing'she	0
烟台福达旅行社	yan'tai'fu'da'lv'xing'she	0
烟台港滨海旅行社	yan'tai'gang'bin'hai'lv'xing'she	0
烟台海滨假日旅行社	yan'tai'hai'bin'jia'ri'lv'xing'she	0
烟台海港旅行社	yan'tai'hai'gang'lv'xing'she	0
烟台海联旅行社	yan'tai'hai'lian'lv'xing'she	0
烟台海山旅行社	yan'tai'hai'shan'lv'xing'she	0
烟台航空旅行社	yan'tai'hang'kong'lv'xing'she	0
烟台虹口旅行社	yan'tai'hong'kou'lv'xing'she	0
烟台虹桥旅行社	yan'tai'hong'qiao'lv'xing'she	0
烟台鸿雁旅行社	yan'tai'hong'yan'lv'xing'she	0
烟台环宇旅行社	yan'tai'huan'yu'lv'xing'she	0
烟台黄海国际旅行社	yan'tai'huang'hai'guo'ji'lv'xing'she	0
烟台火车站铁龙旅行社	yan'tai'huo'che'zhan'tie'long'lv'xing'she	0
烟台胶东旅行社	yan'tai'jiao'dong'lv'xing'she	0
烟台交通旅行社	yan'tai'jiao'tong'lv'xing'she	0
烟台交运旅行社	yan'tai'jiao'yun'lv'xing'she	0
烟台金桥旅行社	yan'tai'jin'qiao'lv'xing'she	0
烟台金元旅行社	yan'tai'jin'yuan'lv'xing'she	0
烟台开发区旅行社	yan'tai'kai'fa'qu'lv'xing'she	0
烟台开心假日旅行社	yan'tai'kai'xin'jia'ri'lv'xing'she	0
烟台劳动大厦旅行社	yan'tai'lao'dong'da'sha'lv'xing'she	0
烟台旅行社	yan'tai'lv'xing'she	0
烟台山水旅行社	yan'tai'shan'shui'lv'xing'she	0
烟台市碧海旅行社	yan'tai'shi'bi'hai'lv'xing'she	0
烟台市华泰旅行社	yan'tai'shi'hua'tai'lv'xing'she	0
烟台市蓬莱光大旅行社	yan'tai'shi'peng'lai'guang'da'lv'xing'she	0
烟台市奇山旅行社	yan'tai'shi'qi'shan'lv'xing'she	0
烟台塔山旅行社	yan'tai'ta'shan'lv'xing'she	0
烟台天马旅行社	yan'tai'tian'ma'lv'xing'she	0
烟台天天旅行社	yan'tai'tian'tian'lv'xing'she	0
烟台天翔旅行社	yan'tai'tian'xiang'lv'xing'she	0
烟台铁道旅行社	yan'tai'tie'dao'lv'xing'she	0
烟台铁龙旅行社	yan'tai'tie'long'lv'xing'she	0
烟台铁路旅行社	yan'tai'tie'lu'lv'xing'she	0
烟台鑫海假日旅行社	yan'tai'xin'hai'jia'ri'lv'xing'she	0
烟台新华旅行社	yan'tai'xin'hua'lv'xing'she	0
烟台新闻旅行社	yan'tai'xin'wen'lv'xing'she	0
烟台友谊旅行社	yan'tai'you'yi'lv'xing'she	0
烟台远达旅行社	yan'tai'yuan'da'lv'xing'she	0
烟台原野旅行社	yan'tai'yuan'ye'lv'xing'she	0
烟台运通旅行社	yan'tai'yun'tong'lv'xing'she	0
烟台中国国际旅行社	yan'tai'zhong'guo'guo'ji'lv'xing'she	0
烟台中国旅行社	yan'tai'zhong'guo'lv'xing'she	0
烟台中国青年旅行社	yan'tai'zhong'guo'qing'nian'lv'xing'she	0
阳春市中国旅行社	yang'chun'shi'zhong'guo'lv'xing'she	0
阳光旅行社	yang'guang'lv'xing'she	0
阳山县中国旅行社	yang'shan'xian'zhong'guo'lv'xing'she	0
扬州广源电力旅行社	yang'zhou'guang'yuan'dian'li'lv'xing'she	0
扬州市环球旅行社	yang'zhou'shi'huan'qiu'lv'xing'she	0
扬州市石塔旅行社	yang'zhou'shi'shi'ta'lv'xing'she	0
扬州市中国旅行社	yang'zhou'shi'zhong'guo'lv'xing'she	0
扬州苏之旅旅行社	yang'zhou'su'zhi'lv'lv'xing'she	0
扬州中国国际旅行社	yang'zhou'zhong'guo'guo'ji'lv'xing'she	0
扬州中国青年旅行社	yang'zhou'zhong'guo'qing'nian'lv'xing'she	0
怡安国际旅行社	yi'an'guo'ji'lv'xing'she	0
宜昌长坂坡旅行社	yi'chang'chang'ban'po'lv'xing'she	0
宜昌长宜旅行社	yi'chang'chang'yi'lv'xing'she	0
宜昌楚风旅行社	yi'chang'chu'feng'lv'xing'she	0
宜昌大三峡旅行社	yi'chang'da'san'xia'lv'xing'she	0
宜昌葛洲坝船闸旅行社	yi'chang'ge'zhou'ba'chuan'zha'lv'xing'she	0
宜昌葛洲坝旅行社	yi'chang'ge'zhou'ba'lv'xing'she	0
宜昌葛州坝寿山旅行社	yi'chang'ge'zhou'ba'shou'shan'lv'xing'she	0
宜昌鼓楼旅行社	yi'chang'gu'lou'lv'xing'she	0
宜昌光大旅行社	yi'chang'guang'da'lv'xing'she	0
宜昌归州旅行社	yi'chang'gui'zhou'lv'xing'she	0
宜昌恒通旅行社	yi'chang'heng'tong'lv'xing'she	0
宜昌红叶旅行社	yi'chang'hong'ye'lv'xing'she	0
宜昌华侨旅行社	yi'chang'hua'qiao'lv'xing'she	0
宜昌环球旅行社	yi'chang'huan'qiu'lv'xing'she	0
宜昌汇丰原旅行社	yi'chang'hui'feng'yuan'lv'xing'she	0
宜昌技协旅行社	yi'chang'ji'xie'lv'xing'she	0
宜昌江河旅行社	yi'chang'jiang'he'lv'xing'she	0
宜昌教育旅行社	yi'chang'jiao'yu'lv'xing'she	0
宜昌津昌旅行社	yi'chang'jin'chang'lv'xing'she	0
宜昌金海旅行社	yi'chang'jin'hai'lv'xing'she	0
宜昌金利源旅行社	yi'chang'jin'li'yuan'lv'xing'she	0
宜昌金色假期旅行社	yi'chang'jin'se'jia'qi'lv'xing'she	0
宜昌金翼旅行社	yi'chang'jin'yi'lv'xing'she	0
宜昌康辉旅行社	yi'chang'kang'hui'lv'xing'she	0
宜昌科技旅行社	yi'chang'ke'ji'lv'xing'she	0
宜昌旅行社	yi'chang'lv'xing'she	0
宜昌民族旅行社	yi'chang'min'zu'lv'xing'she	0
宜昌南湖旅行社	yi'chang'nan'hu'lv'xing'she	0
宜昌群乐旅行社	yi'chang'qun'le'lv'xing'she	0
宜昌三峡机场旅行社	yi'chang'san'xia'ji'chang'lv'xing'she	0
宜昌三峡旅行社	yi'chang'san'xia'lv'xing'she	0
宜昌三峡中国国际旅行社	yi'chang'san'xia'zhong'guo'guo'ji'lv'xing'she	0
宜昌山水旅行社	yi'chang'shan'shui'lv'xing'she	0
宜昌市东风旅行社	yi'chang'shi'dong'feng'lv'xing'she	0
宜昌市虹桥旅行社	yi'chang'shi'hong'qiao'lv'xing'she	0
宜昌市环宇旅行社	yi'chang'shi'huan'yu'lv'xing'she	0
宜昌市火车站旅行社	yi'chang'shi'huo'che'zhan'lv'xing'she	0
宜昌市江峡旅行社	yi'chang'shi'jiang'xia'lv'xing'she	0
宜昌市教育旅行社	yi'chang'shi'jiao'yu'lv'xing'she	0
宜昌市金桥旅行社	yi'chang'shi'jin'qiao'lv'xing'she	0
宜昌市民乐旅行社	yi'chang'shi'min'yue'lv'xing'she	0
宜昌市平湖国际旅行社	yi'chang'shi'ping'hu'guo'ji'lv'xing'she	0
宜昌市顺达旅行社	yi'chang'shi'shun'da'lv'xing'she	0
宜昌市太升轮船旅行社	yi'chang'shi'tai'sheng'lun'chuan'lv'xing'she	0
宜昌市天地自然旅行社	yi'chang'shi'tian'di'zi'ran'lv'xing'she	0
宜昌市希望旅行社	yi'chang'shi'xi'wang'lv'xing'she	0
宜昌市宜通运输集团旅行社	yi'chang'shi'yi'tong'yun'shu'ji'tuan'lv'xing'she	0
宜昌市职工旅行社	yi'chang'shi'zhi'gong'lv'xing'she	0
宜昌市秭归交通旅行社	yi'chang'shi'zi'gui'jiao'tong'lv'xing'she	0
宜昌桃花岭旅行社	yi'chang'tao'hua'ling'lv'xing'she	0
宜昌天禄邮电旅行社	yi'chang'tian'lu'you'dian'lv'xing'she	0
宜昌天马旅行社	yi'chang'tian'ma'lv'xing'she	0
宜昌天缘旅行社	yi'chang'tian'yuan'lv'xing'she	0
宜昌铁路旅行社	yi'chang'tie'lu'lv'xing'she	0
宜昌五洲假日旅行社	yi'chang'wu'zhou'jia'ri'lv'xing'she	0
宜昌西陵旅行社	yi'chang'xi'ling'lv'xing'she	0
宜昌襄樊铁路旅行社	yi'chang'xiang'fan'tie'lu'lv'xing'she	0
宜昌新纪缘旅行社	yi'chang'xin'ji'yuan'lv'xing'she	0
宜昌新天地旅行社	yi'chang'xin'tian'di'lv'xing'she	0
宜昌新闻旅行社	yi'chang'xin'wen'lv'xing'she	0
宜昌阳光旅行社	yi'chang'yang'guang'lv'xing'she	0
宜昌扬子江旅行社	yi'chang'yang'zi'jiang'lv'xing'she	0
宜昌夷陵旅行社	yi'chang'yi'ling'lv'xing'she	0
宜昌银河电力旅行社	yi'chang'yin'he'dian'li'lv'xing'she	0
宜昌运通旅行社	yi'chang'yun'tong'lv'xing'she	0
宜昌招商旅行社	yi'chang'zhao'shang'lv'xing'she	0
宜昌中堡岛旅行社	yi'chang'zhong'bao'dao'lv'xing'she	0
宜昌中长港旅行社	yi'chang'zhong'chang'gang'lv'xing'she	0
宜昌中纺旅行社	yi'chang'zhong'fang'lv'xing'she	0
宜昌中国国际旅行社	yi'chang'zhong'guo'guo'ji'lv'xing'she	0
宜昌中国旅行社	yi'chang'zhong'guo'lv'xing'she	0
宜昌中国青年旅行社	yi'chang'zhong'guo'qing'nian'lv'xing'she	0
宜昌秭归交通旅行社	yi'chang'zi'gui'jiao'tong'lv'xing'she	0
伊春带岭旅行社	yi'chun'dai'ling'lv'xing'she	0
伊春嘉荫旅行社	yi'chun'jia'yin'lv'xing'she	0
伊春金山旅行社	yi'chun'jin'shan'lv'xing'she	0
伊春郎乡旅行社	yi'chun'lang'xiang'lv'xing'she	0
伊春桃山旅行社	yi'chun'tao'shan'lv'xing'she	0
伊春五营旅行社	yi'chun'wu'ying'lv'xing'she	0
伊春中国国际旅行社	yi'chun'zhong'guo'guo'ji'lv'xing'she	0
伊宁国际旅行社	yi'ning'guo'ji'lv'xing'she	0
艺术旅行社	yi'shu'lv'xing'she	0
宜通运输集团旅行社	yi'tong'yun'shu'ji'tuan'lv'xing'she	0
义乌商都旅行社	yi'wu'shang'du'lv'xing'she	0
义乌市华丰旅行社	yi'wu'shi'hua'feng'lv'xing'she	0
义乌市旅行社	yi'wu'shi'lv'xing'she	0
易县太平洋旅行社	yi'xian'tai'ping'yang'lv'xing'she	0
宜兴市神马旅行社	yi'xing'shi'shen'ma'lv'xing'she	0
宜兴市亚洲国际旅行社	yi'xing'shi'ya'zhou'guo'ji'lv'xing'she	0
宜兴市职工旅行社	yi'xing'shi'zhi'gong'lv'xing'she	0
宜兴中国国际旅行社	yi'xing'zhong'guo'guo'ji'lv'xing'she	0
仪征市中北旅行社	yi'zheng'shi'zhong'bei'lv'xing'she	0
银河旅行社	yin'he'lv'xing'she	0
英德市青年旅行社	ying'de'shi'qing'nian'lv'xing'she	0
英德市中国旅行社	ying'de'shi'zhong'guo'lv'xing'she	0
鹰潭龙虎山中国青年旅行社	ying'tan'long'hu'shan'zhong'guo'qing'nian'lv'xing'she	0
鹰潭市长征旅行社	ying'tan'shi'chang'zheng'lv'xing'she	0
鹰潭市电力旅行社	ying'tan'shi'dian'li'lv'xing'she	0
鹰潭市东方旅行社	ying'tan'shi'dong'fang'lv'xing'she	0
鹰潭市虹桥旅行社	ying'tan'shi'hong'qiao'lv'xing'she	0
鹰潭市红太阳旅行社	ying'tan'shi'hong'tai'yang'lv'xing'she	0
鹰潭市华侨旅行社	ying'tan'shi'hua'qiao'lv'xing'she	0
鹰潭市金鹰旅行社	ying'tan'shi'jin'ying'lv'xing'she	0
鹰潭市开欣旅行社	ying'tan'shi'kai'xin'lv'xing'she	0
鹰潭市旅行社	ying'tan'shi'lv'xing'she	0
鹰潭市文化旅行社	ying'tan'shi'wen'hua'lv'xing'she	0
鹰潭市新世纪旅行社	ying'tan'shi'xin'shi'ji'lv'xing'she	0
鹰潭市鹰嘉旅行社	ying'tan'shi'ying'jia'lv'xing'she	0
鹰潭铁路蓝天旅行社	ying'tan'tie'lu'lan'tian'lv'xing'she	0
鹰潭铁路旅行社	ying'tan'tie'lu'lv'xing'she	0
鹰潭中国旅行社	ying'tan'zhong'guo'lv'xing'she	0
永安铁路旅行社	yong'an'tie'lu'lv'xing'she	0
永春侨联旅行社	yong'chun'qiao'lian'lv'xing'she	0
永春中国旅行社	yong'chun'zhong'guo'lv'xing'she	0
永康旅行社	yong'kang'lv'xing'she	0
永康市旅行社	yong'kang'shi'lv'xing'she	0
邮电国际旅行社	you'dian'guo'ji'lv'xing'she	0
邮电国际旅游集团杭州邮政旅行社	you'dian'guo'ji'lv'you'ji'tuan'hang'zhou'you'zheng'lv'xing'she	0
友好旅行社	you'hao'lv'xing'she	0
友谊旅行社	you'yi'lv'xing'she	0
玉柴旅行社	yu'chai'lv'xing'she	0
玉环天马旅行社	yu'huan'tian'ma'lv'xing'she	0
裕康旅行社	yu'kang'lv'xing'she	0
玉林市国际旅行社	yu'lin'shi'guo'ji'lv'xing'she	0
玉林市旅行社	yu'lin'shi'lv'xing'she	0
玉泉旅行社	yu'quan'lv'xing'she	0
玉山青年旅行社	yu'shan'qing'nian'lv'xing'she	0
玉山三清山旅行社	yu'shan'san'qing'shan'lv'xing'she	0
玉溪市江川旅行社	yu'xi'shi'jiang'chuan'lv'xing'she	0
玉溪市聂耳旅行社	yu'xi'shi'nie'er'lv'xing'she	0
玉溪市易门旅行社	yu'xi'shi'yi'men'lv'xing'she	0
余姚市旅行社	yu'yao'shi'lv'xing'she	0
原野旅行社	yuan'ye'lv'xing'she	0
乐清市雁荡山国际旅行社	yue'qing'shi'yan'dang'shan'guo'ji'lv'xing'she	0
乐清市职工旅行社	yue'qing'shi'zhi'gong'lv'xing'she	0
乐清市中国旅行社	yue'qing'shi'zhong'guo'lv'xing'she	0
乐清中国旅行社	yue'qing'zhong'guo'lv'xing'she	0
岳阳八方旅行社	yue'yang'ba'fang'lv'xing'she	0
岳阳巴陵招商旅行社	yue'yang'ba'ling'zhao'shang'lv'xing'she	0
岳阳春秋旅行社	yue'yang'chun'qiu'lv'xing'she	0
岳阳洞庭湖旅行社	yue'yang'dong'ting'hu'lv'xing'she	0
岳阳妇女旅行社	yue'yang'fu'nv'lv'xing'she	0
岳阳虹桥旅行社	yue'yang'hong'qiao'lv'xing'she	0
岳阳教育旅行社	yue'yang'jiao'yu'lv'xing'she	0
岳阳金马旅行社	yue'yang'jin'ma'lv'xing'she	0
岳阳金园旅行社	yue'yang'jin'yuan'lv'xing'she	0
岳阳军辉旅行社	yue'yang'jun'hui'lv'xing'she	0
岳阳龙城旅行社	yue'yang'long'cheng'lv'xing'she	0
岳阳南湖假日旅行社	yue'yang'nan'hu'jia'ri'lv'xing'she	0
岳阳市君山旅行社	yue'yang'shi'jun'shan'lv'xing'she	0
岳阳市龙城旅行社	yue'yang'shi'long'cheng'lv'xing'she	0
岳阳市中国青年旅行社	yue'yang'shi'zhong'guo'qing'nian'lv'xing'she	0
岳阳天下楼旅行社	yue'yang'tian'xia'lou'lv'xing'she	0
岳阳五一职工旅行社	yue'yang'wu'yi'zhi'gong'lv'xing'she	0
岳阳中国国际旅行社	yue'yang'zhong'guo'guo'ji'lv'xing'she	0
云浮市顺达国际旅行社	yun'fu'shi'shun'da'guo'ji'lv'xing'she	0
云浮市中国旅行社	yun'fu'shi'zhong'guo'lv'xing'she	0
云南安达旅行社	yun'nan'an'da'lv'xing'she	0
云南大自然旅行社	yun'nan'da'zi'ran'lv'xing'she	0
云南德宏芒市黄埔旅行社	yun'nan'de'hong'mang'shi'huang'pu'lv'xing'she	0
云南峨山旅行社	yun'nan'e'shan'lv'xing'she	0
云南个旧市旅行社	yun'nan'ge'jiu'shi'lv'xing'she	0
云南工商联旅行社	yun'nan'gong'shang'lian'lv'xing'she	0
云南航空国际观光旅行社	yun'nan'hang'kong'guo'ji'guan'guang'lv'xing'she	0
云南航空国际旅行社	yun'nan'hang'kong'guo'ji'lv'xing'she	0
云南航空西双版纳天达旅行社	yun'nan'hang'kong'xi'shuang'ban'na'tian'da'lv'xing'she	0
云南和平旅行社	yun'nan'he'ping'lv'xing'she	0
云南红河旅行社	yun'nan'hong'he'lv'xing'she	0
云南金秋旅行社	yun'nan'jin'qiu'lv'xing'she	0
云南科技国际旅行社	yun'nan'ke'ji'guo'ji'lv'xing'she	0
云南昆明大学旅行社	yun'nan'kun'ming'da'xue'lv'xing'she	0
云南昆明中国青年旅行社	yun'nan'kun'ming'zhong'guo'qing'nian'lv'xing'she	0
云南丽江虎跳峡国际旅行社	yun'nan'li'jiang'hu'tiao'xia'guo'ji'lv'xing'she	0
云南丽江雪鹰国际旅行社	yun'nan'li'jiang'xue'ying'guo'ji'lv'xing'she	0
云南明珠国际旅行社	yun'nan'ming'zhu'guo'ji'lv'xing'she	0
云南欧亚国际旅行社	yun'nan'ou'ya'guo'ji'lv'xing'she	0
云南企业家旅行社	yun'nan'qi'ye'jia'lv'xing'she	0
云南山水国际旅行社	yun'nan'shan'shui'guo'ji'lv'xing'she	0
云南省澄江旅行社	yun'nan'sheng'cheng'jiang'lv'xing'she	0
云南省国际旅行社	yun'nan'sheng'guo'ji'lv'xing'she	0
云南省旅游服务旅行社	yun'nan'sheng'lv'you'fu'wu'lv'xing'she	0
云南省玉溪市旅行社	yun'nan'sheng'yu'xi'shi'lv'xing'she	0
云南探险娱乐旅行社	yun'nan'tan'xian'yu'le'lv'xing'she	0
云南天虹旅行社	yun'nan'tian'hong'lv'xing'she	0
云南文山三鑫集团有限公司旅行社	yun'nan'wen'shan'san'xin'ji'tuan'you'xian'gong'si'lv'xing'she	0
云南西双版纳西娜旅行社	yun'nan'xi'shuang'ban'na'xi'na'lv'xing'she	0
云南新联旅行社	yun'nan'xin'lian'lv'xing'she	0
云南阳光旅行社	yun'nan'yang'guang'lv'xing'she	0
云南邮电旅行社	yun'nan'you'dian'lv'xing'she	0
云南招商国际旅行社	yun'nan'zhao'shang'guo'ji'lv'xing'she	0
增城市中国旅行社	zeng'cheng'shi'zhong'guo'lv'xing'she	0
湛江富海旅行社	zhan'jiang'fu'hai'lv'xing'she	0
湛江国际旅行社	zhan'jiang'guo'ji'lv'xing'she	0
湛江青年旅行社	zhan'jiang'qing'nian'lv'xing'she	0
湛江市华达旅行社	zhan'jiang'shi'hua'da'lv'xing'she	0
湛江市青联旅行社	zhan'jiang'shi'qing'lian'lv'xing'she	0
湛江市运通旅行社	zhan'jiang'shi'yun'tong'lv'xing'she	0
湛江市职工旅行社	zhan'jiang'shi'zhi'gong'lv'xing'she	0
湛江市中国国际旅行社	zhan'jiang'shi'zhong'guo'guo'ji'lv'xing'she	0
湛江市中国旅行社	zhan'jiang'shi'zhong'guo'lv'xing'she	0
湛江市紫荆旅行社	zhan'jiang'shi'zi'jing'lv'xing'she	0
湛江铁路旅行社	zhan'jiang'tie'lu'lv'xing'she	0
湛江友谊旅行社	zhan'jiang'you'yi'lv'xing'she	0
湛江中国旅行社	zhan'jiang'zhong'guo'lv'xing'she	0
张家港国泰国内旅行社	zhang'jia'gang'guo'tai'guo'nei'lv'xing'she	0
张家港佳安国内旅行社	zhang'jia'gang'jia'an'guo'nei'lv'xing'she	0
张家港青华国内旅行社	zhang'jia'gang'qing'hua'guo'nei'lv'xing'she	0
张家界慈利紫霞旅行社	zhang'jia'jie'ci'li'zi'xia'lv'xing'she	0
张家界大鹏旅行社	zhang'jia'jie'da'peng'lv'xing'she	0
张家界东升旅行社	zhang'jia'jie'dong'sheng'lv'xing'she	0
张家界风光旅行社	zhang'jia'jie'feng'guang'lv'xing'she	0
张家界国家森林公园旅行社	zhang'jia'jie'guo'jia'sen'lin'gong'yuan'lv'xing'she	0
张家界红十字旅行社	zhang'jia'jie'hong'shi'zi'lv'xing'she	0
张家界鸿雁旅行社	zhang'jia'jie'hong'yan'lv'xing'she	0
张家界火车站旅行社	zhang'jia'jie'huo'che'zhan'lv'xing'she	0
张家界交通旅行社	zhang'jia'jie'jiao'tong'lv'xing'she	0
张家界教育旅行社	zhang'jia'jie'jiao'yu'lv'xing'she	0
张家界金帆旅行社	zhang'jia'jie'jin'fan'lv'xing'she	0
张家界锦华国际旅行社	zhang'jia'jie'jin'hua'guo'ji'lv'xing'she	0
张家界茅岩河旅行社	zhang'jia'jie'mao'yan'he'lv'xing'she	0
张家界民族旅行社	zhang'jia'jie'min'zu'lv'xing'she	0
张家界青年旅行社	zhang'jia'jie'qing'nian'lv'xing'she	0
张家界青云假期旅行社	zhang'jia'jie'qing'yun'jia'qi'lv'xing'she	0
张家界市妇女旅行社	zhang'jia'jie'shi'fu'nv'lv'xing'she	0
张家界石化旅行社	zhang'jia'jie'shi'hua'lv'xing'she	0
张家界市金马旅行社	zhang'jia'jie'shi'jin'ma'lv'xing'she	0
张家界市青年旅行社	zhang'jia'jie'shi'qing'nian'lv'xing'she	0
张家界市神州旅行社	zhang'jia'jie'shi'shen'zhou'lv'xing'she	0
张家界市中国国际旅行社	zhang'jia'jie'shi'zhong'guo'guo'ji'lv'xing'she	0
张家界顺达旅行社	zhang'jia'jie'shun'da'lv'xing'she	0
张家界天马旅行社	zhang'jia'jie'tian'ma'lv'xing'she	0
张家界铁路旅行社	zhang'jia'jie'tie'lu'lv'xing'she	0
张家界湘深旅行社	zhang'jia'jie'xiang'shen'lv'xing'she	0
张家界湘西风情旅行社	zhang'jia'jie'xiang'xi'feng'qing'lv'xing'she	0
张家界湘西青年旅行社	zhang'jia'jie'xiang'xi'qing'nian'lv'xing'she	0
张家界新华旅行社	zhang'jia'jie'xin'hua'lv'xing'she	0
张家界冶金旅行社	zhang'jia'jie'ye'jin'lv'xing'she	0
张家界中国国际旅行社	zhang'jia'jie'zhong'guo'guo'ji'lv'xing'she	0
张之旅旅行社	zhang'zhi'lv'lv'xing'she	0
漳州环球旅行社	zhang'zhou'huan'qiu'lv'xing'she	0
漳州金秋旅行社	zhang'zhou'jin'qiu'lv'xing'she	0
漳州金叶旅行社	zhang'zhou'jin'ye'lv'xing'she	0
漳州康辉旅行社	zhang'zhou'kang'hui'lv'xing'she	0
漳州中国国际旅行社	zhang'zhou'zhong'guo'guo'ji'lv'xing'she	0
肇庆翠湖旅行社	zhao'qing'cui'hu'lv'xing'she	0
肇庆口岸中国旅行社	zhao'qing'kou'an'zhong'guo'lv'xing'she	0
肇庆市国泰旅行社	zhao'qing'shi'guo'tai'lv'xing'she	0
肇庆市中国国际旅行社	zhao'qing'shi'zhong'guo'guo'ji'lv'xing'she	0
肇庆市中国旅行社	zhao'qing'shi'zhong'guo'lv'xing'she	0
肇庆通联旅行社	zhao'qing'tong'lian'lv'xing'she	0
肇庆星湖国际旅行社	zhao'qing'xing'hu'guo'ji'lv'xing'she	0
肇庆肇之旅行社	zhao'qing'zhao'zhi'lv'xing'she	0
招商局桂林阳朔国际旅行社	zhao'shang'ju'gui'lin'yang'shuo'guo'ji'lv'xing'she	0
招商局西安国际旅行社	zhao'shang'ju'xi'an'guo'ji'lv'xing'she	0
浙江城市金融旅行社	zhe'jiang'cheng'shi'jin'rong'lv'xing'she	0
浙江慈溪风光旅行社	zhe'jiang'ci'xi'feng'guang'lv'xing'she	0
浙江大江南旅行社	zhe'jiang'da'jiang'nan'lv'xing'she	0
浙江大学旅行社	zhe'jiang'da'xue'lv'xing'she	0
浙江妇女国际旅行社	zhe'jiang'fu'nv'guo'ji'lv'xing'she	0
浙江光大国际旅行社	zhe'jiang'guang'da'guo'ji'lv'xing'she	0
浙江国际合作旅行社	zhe'jiang'guo'ji'he'zuo'lv'xing'she	0
浙江海外新华旅行社	zhe'jiang'hai'wai'xin'hua'lv'xing'she	0
浙江航空国际旅行社	zhe'jiang'hang'kong'guo'ji'lv'xing'she	0
浙江航空旅行社	zhe'jiang'hang'kong'lv'xing'she	0
浙江建设国际旅行社	zhe'jiang'jian'she'guo'ji'lv'xing'she	0
浙江建设旅行社	zhe'jiang'jian'she'lv'xing'she	0
浙江缙云交通旅行社	zhe'jiang'jin'yun'jiao'tong'lv'xing'she	0
浙江缙云星辉旅行社	zhe'jiang'jin'yun'xing'hui'lv'xing'she	0
浙江康辉国际旅行社	zhe'jiang'kang'hui'guo'ji'lv'xing'she	0
浙江康辉旅行社	zhe'jiang'kang'hui'lv'xing'she	0
浙江普陀鸿雁旅行社	zhe'jiang'pu'tuo'hong'yan'lv'xing'she	0
浙江普陀金秋旅行社	zhe'jiang'pu'tuo'jin'qiu'lv'xing'she	0
浙江普陀朱家尖旅行社	zhe'jiang'pu'tuo'zhu'jia'jian'lv'xing'she	0
浙江青春旅行社	zhe'jiang'qing'chun'lv'xing'she	0
浙江青旅国内旅行社	zhe'jiang'qing'lv'guo'nei'lv'xing'she	0
浙江森林旅行社	zhe'jiang'sen'lin'lv'xing'she	0
浙江神州旅行社	zhe'jiang'shen'zhou'lv'xing'she	0
浙江省安吉旅行社	zhe'jiang'sheng'an'ji'lv'xing'she	0
浙江省国际合作旅行社	zhe'jiang'sheng'guo'ji'he'zuo'lv'xing'she	0
浙江省湖州德清天风旅行社	zhe'jiang'sheng'hu'zhou'de'qing'tian'feng'lv'xing'she	0
浙江省嘉善青年旅行社	zhe'jiang'sheng'jia'shan'qing'nian'lv'xing'she	0
浙江省建德市新安江森林旅行社	zhe'jiang'sheng'jian'de'shi'xin'an'jiang'sen'lin'lv'xing'she	0
浙江省青田县交通旅行社	zhe'jiang'sheng'qing'tian'xian'jiao'tong'lv'xing'she	0
浙江省衢州市中国旅行社	zhe'jiang'sheng'qu'zhou'shi'zhong'guo'lv'xing'she	0
浙江省商业旅行社	zhe'jiang'sheng'shang'ye'lv'xing'she	0
浙江省桐庐旅行社	zhe'jiang'sheng'tong'lu'lv'xing'she	0
浙江省象山旅行社	zhe'jiang'sheng'xiang'shan'lv'xing'she	0
浙江省职工友好旅行社	zhe'jiang'sheng'zhi'gong'you'hao'lv'xing'she	0
浙江省中国国际旅行社	zhe'jiang'sheng'zhong'guo'guo'ji'lv'xing'she	0
浙江省中国旅行社	zhe'jiang'sheng'zhong'guo'lv'xing'she	0
浙江省中国青年旅行社	zhe'jiang'sheng'zhong'guo'qing'nian'lv'xing'she	0
浙江省舟山第一海运公司海山旅行社	zhe'jiang'sheng'zhou'shan'di'yi'hai'yun'gong'si'hai'shan'lv'xing'she	0
浙江省舟山港客旅行社	zhe'jiang'sheng'zhou'shan'gang'ke'lv'xing'she	0
浙江温岭市青年旅行社	zhe'jiang'wen'ling'shi'qing'nian'lv'xing'she	0
浙江物资旅行社	zhe'jiang'wu'zi'lv'xing'she	0
浙江香溢国际旅行社	zhe'jiang'xiang'yi'guo'ji'lv'xing'she	0
浙江新昌金道旅行社	zhe'jiang'xin'chang'jin'dao'lv'xing'she	0
浙江新大陆旅行社	zhe'jiang'xin'da'lu'lv'xing'she	0
浙江新天地旅行社	zhe'jiang'xin'tian'di'lv'xing'she	0
浙江雁荡山国际旅行社	zhe'jiang'yan'dang'shan'guo'ji'lv'xing'she	0
浙江燕杭旅行社	zhe'jiang'yan'hang'lv'xing'she	0
浙江邮电旅行社	zhe'jiang'you'dian'lv'xing'she	0
浙江运通旅行社	zhe'jiang'yun'tong'lv'xing'she	0
浙江之江旅行社	zhe'jiang'zhi'jiang'lv'xing'she	0
浙江中大国际旅行社	zhe'jiang'zhong'da'guo'ji'lv'xing'she	0
浙江中山国际旅行社	zhe'jiang'zhong'shan'guo'ji'lv'xing'she	0
浙江舟山教育旅行社	zhe'jiang'zhou'shan'jiao'yu'lv'xing'she	0
浙江舟山旅行社	zhe'jiang'zhou'shan'lv'xing'she	0
浙江舟山普陀通达旅行社	zhe'jiang'zhou'shan'pu'tuo'tong'da'lv'xing'she	0
镇江长江旅行社	zhen'jiang'chang'jiang'lv'xing'she	0
镇江风光旅行社	zhen'jiang'feng'guang'lv'xing'she	0
镇江光大旅行社	zhen'jiang'guang'da'lv'xing'she	0
镇江环球旅行社	zhen'jiang'huan'qiu'lv'xing'she	0
镇江火车头旅行社	zhen'jiang'huo'che'tou'lv'xing'she	0
镇江假日旅行社	zhen'jiang'jia'ri'lv'xing'she	0
镇江金达旅行社	zhen'jiang'jin'da'lv'xing'she	0
镇江金龙旅行社	zhen'jiang'jin'long'lv'xing'she	0
镇江金山旅行社	zhen'jiang'jin'shan'lv'xing'she	0
镇江康辉旅行社	zhen'jiang'kang'hui'lv'xing'she	0
镇江天马旅行社	zhen'jiang'tian'ma'lv'xing'she	0
镇江文化旅行社	zhen'jiang'wen'hua'lv'xing'she	0
镇江友好旅行社	zhen'jiang'you'hao'lv'xing'she	0
镇江邮政旅行社	zhen'jiang'you'zheng'lv'xing'she	0
镇江园林旅行社	zhen'jiang'yuan'lin'lv'xing'she	0
镇江招商旅行社	zhen'jiang'zhao'shang'lv'xing'she	0
镇江职工旅行社	zhen'jiang'zhi'gong'lv'xing'she	0
镇江中国国际旅行社	zhen'jiang'zhong'guo'guo'ji'lv'xing'she	0
镇江中国旅行社	zhen'jiang'zhong'guo'lv'xing'she	0
镇江中国文化旅行社	zhen'jiang'zhong'guo'wen'hua'lv'xing'she	0
镇江竹轩旅行社	zhen'jiang'zhu'xuan'lv'xing'she	0
郑州杜康旅行社	zheng'zhou'du'kang'lv'xing'she	0
郑州广联旅行社	zheng'zhou'guang'lian'lv'xing'she	0
郑州海悦旅行社	zheng'zhou'hai'yue'lv'xing'she	0
郑州华夏旅行社	zheng'zhou'hua'xia'lv'xing'she	0
郑州联运旅行社	zheng'zhou'lian'yun'lv'xing'she	0
郑州良友旅行社	zheng'zhou'liang'you'lv'xing'she	0
郑州青屏旅行社	zheng'zhou'qing'ping'lv'xing'she	0
郑州轻松假日旅行社	zheng'zhou'qing'song'jia'ri'lv'xing'she	0
郑州少林国大旅行社	zheng'zhou'shao'lin'guo'da'lv'xing'she	0
郑州时代旅行社	zheng'zhou'shi'dai'lv'xing'she	0
郑州天地旅行社	zheng'zhou'tian'di'lv'xing'she	0
郑州天下旅行社	zheng'zhou'tian'xia'lv'xing'she	0
郑州铁路国际旅行社	zheng'zhou'tie'lu'guo'ji'lv'xing'she	0
郑州铁路局旅行社	zheng'zhou'tie'lu'ju'lv'xing'she	0
郑州铁路旅游服务公司旅行社	zheng'zhou'tie'lu'lv'you'fu'wu'gong'si'lv'xing'she	0
郑州未来国际旅行社	zheng'zhou'wei'lai'guo'ji'lv'xing'she	0
郑州新华旅行社	zheng'zhou'xin'hua'lv'xing'she	0
郑州邮政旅行社	zheng'zhou'you'zheng'lv'xing'she	0
郑州豫华旅行社	zheng'zhou'yu'hua'lv'xing'she	0
郑州中大旅行社	zheng'zhou'zhong'da'lv'xing'she	0
志成旅行社	zhi'cheng'lv'xing'she	0
中城国际旅行社	zhong'cheng'guo'ji'lv'xing'she	0
中电国际旅行社	zhong'dian'guo'ji'lv'xing'she	0
中广国际旅行社	zhong'guang'guo'ji'lv'xing'she	0
中国北航国际旅行社	zhong'guo'bei'hang'guo'ji'lv'xing'she	0
中国北京五洲国际旅行社	zhong'guo'bei'jing'wu'zhou'guo'ji'lv'xing'she	0
中国大连通达旅行社	zhong'guo'da'lian'tong'da'lv'xing'she	0
中国钓鱼台国际旅行社	zhong'guo'diao'yu'tai'guo'ji'lv'xing'she	0
中国妇女旅行社	zhong'guo'fu'nv'lv'xing'she	0
中国甘肃省金城旅行社	zhong'guo'gan'su'sheng'jin'cheng'lv'xing'she	0
中国光旅集团岳阳光大旅行社	zhong'guo'guang'lv'ji'tuan'yue'yang'guang'da'lv'xing'she	0
中国国际旅行社	zhong'guo'guo'ji'lv'xing'she	0
中国海峡旅行社	zhong'guo'hai'xia'lv'xing'she	0
中国黑河海外旅行社	zhong'guo'hei'he'hai'wai'lv'xing'she	0
中国黄山金五谷旅行社	zhong'guo'huang'shan'jin'wu'gu'lv'xing'she	0
中国吉林市青年旅行社	zhong'guo'ji'lin'shi'qing'nian'lv'xing'she	0
中国康辉大同旅行社	zhong'guo'kang'hui'da'tong'lv'xing'she	0
中国康辉黄山国际旅行社	zhong'guo'kang'hui'huang'shan'guo'ji'lv'xing'she	0
中国康辉黄山旅行社	zhong'guo'kang'hui'huang'shan'lv'xing'she	0
中国康辉宁夏国际旅行社	zhong'guo'kang'hui'ning'xia'guo'ji'lv'xing'she	0
中国康辉汕头旅行社	zhong'guo'kang'hui'shan'tou'lv'xing'she	0
中国康辉深圳旅行社	zhong'guo'kang'hui'shen'zhen'lv'xing'she	0
中国康辉十堰旅行社	zhong'guo'kang'hui'shi'yan'lv'xing'she	0
中国康辉苏州国际旅行社	zhong'guo'kang'hui'su'zhou'guo'ji'lv'xing'she	0
中国康辉天津国际旅行社	zhong'guo'kang'hui'tian'jin'guo'ji'lv'xing'she	0
中国康辉无锡旅行社	zhong'guo'kang'hui'wu'xi'lv'xing'she	0
中国康辉西安旅行社	zhong'guo'kang'hui'xi'an'lv'xing'she	0
中国康辉新疆国际旅行社	zhong'guo'kang'hui'xin'jiang'guo'ji'lv'xing'she	0
中国昆明青年旅行社	zhong'guo'kun'ming'qing'nian'lv'xing'she	0
中国庐山九江文化旅行社	zhong'guo'lu'shan'jiu'jiang'wen'hua'lv'xing'she	0
中国旅行社	zhong'guo'lv'xing'she	0
中国青岛阳光海岸旅行社	zhong'guo'qing'dao'yang'guang'hai'an'lv'xing'she	0
中国青年旅行社	zhong'guo'qing'nian'lv'xing'she	0
中国山水旅行社	zhong'guo'shan'shui'lv'xing'she	0
中国铁道旅行社	zhong'guo'tie'dao'lv'xing'she	0
中国王府国际旅行社	zhong'guo'wang'fu'guo'ji'lv'xing'she	0
中国威海康辉旅行社	zhong'guo'wei'hai'kang'hui'lv'xing'she	0
中国威海天马旅行社	zhong'guo'wei'hai'tian'ma'lv'xing'she	0
中国文化旅行社	zhong'guo'wen'hua'lv'xing'she	0
中国文化旅游集团杭州文化旅行社	zhong'guo'wen'hua'lv'you'ji'tuan'hang'zhou'wen'hua'lv'xing'she	0
中国西安市旅行社	zhong'guo'xi'an'shi'lv'xing'she	0
中国锡华国际旅行社	zhong'guo'xi'hua'guo'ji'lv'xing'she	0
中国西南航空公司重庆蓝鸟国际旅行社	zhong'guo'xi'nan'hang'kong'gong'si'chong'qing'lan'niao'guo'ji'lv'xing'she	0
中国新华航空天津旅行社	zhong'guo'xin'hua'hang'kong'tian'jin'lv'xing'she	0
中国新疆汇通天马国际旅行社	zhong'guo'xin'jiang'hui'tong'tian'ma'guo'ji'lv'xing'she	0
中国新疆金桥民俗国际旅行社	zhong'guo'xin'jiang'jin'qiao'min'su'guo'ji'lv'xing'she	0
中国新疆西域国际旅行社	zhong'guo'xin'jiang'xi'yu'guo'ji'lv'xing'she	0
中国新疆邮电国际旅行社	zhong'guo'xin'jiang'you'dian'guo'ji'lv'xing'she	0
中国云南省国际旅行社	zhong'guo'yun'nan'sheng'guo'ji'lv'xing'she	0
中国浙江舟山普陀山旅游电子商务旅行社	zhong'guo'zhe'jiang'zhou'shan'pu'tuo'shan'lv'you'dian'zi'shang'wu'lv'xing'she	0
中国职工天津旅行社	zhong'guo'zhi'gong'tian'jin'lv'xing'she	0
中佳国际旅行社	zhong'jia'guo'ji'lv'xing'she	0
中旅首都旅行社	zhong'lv'shou'du'lv'xing'she	0
中南国际旅行社	zhong'nan'guo'ji'lv'xing'she	0
中侨国际旅行社	zhong'qiao'guo'ji'lv'xing'she	0
中山固力旅行社	zhong'shan'gu'li'lv'xing'she	0
中山华夏旅行社	zhong'shan'hua'xia'lv'xing'she	0
中山市航远旅行社	zhong'shan'shi'hang'yuan'lv'xing'she	0
中山市交通旅行社	zhong'shan'shi'jiao'tong'lv'xing'she	0
中山市青年旅行社	zhong'shan'shi'qing'nian'lv'xing'she	0
中山市西郊旅游发展公司旅行社	zhong'shan'shi'xi'jiao'lv'you'fa'zhan'gong'si'lv'xing'she	0
中山市香山旅行社	zhong'shan'shi'xiang'shan'lv'xing'she	0
中山市小榄国际旅行社	zhong'shan'shi'xiao'lan'guo'ji'lv'xing'she	0
中山中国旅行社	zhong'shan'zhong'guo'lv'xing'she	0
中石化西北石油局新星集团霍尔果斯旅行社	zhong'shi'hua'xi'bei'shi'you'ju'xin'xing'ji'tuan'huo'er'guo'si'lv'xing'she	0
中锡国际旅行社	zhong'xi'guo'ji'lv'xing'she	0
中谊国际旅行社	zhong'yi'guo'ji'lv'xing'she	0
中油塔里木旅行社	zhong'you'ta'li'mu'lv'xing'she	0
中远国际旅行社	zhong'yuan'guo'ji'lv'xing'she	0
中原铁道国际旅行社	zhong'yuan'tie'dao'guo'ji'lv'xing'she	0
舟山露亭旅行社	zhou'shan'lu'ting'lv'xing'she	0
舟山青年旅行社	zhou'shan'qing'nian'lv'xing'she	0
舟山市定海光大旅行社	zhou'shan'shi'ding'hai'guang'da'lv'xing'she	0
舟山市海都旅行社	zhou'shan'shi'hai'dou'lv'xing'she	0
舟山市海山旅行社	zhou'shan'shi'hai'shan'lv'xing'she	0
舟山市金三角旅行社	zhou'shan'shi'jin'san'jiao'lv'xing'she	0
舟山市普陀鸣雁旅行社	zhou'shan'shi'pu'tuo'ming'yan'lv'xing'she	0
舟山市普陀区通达旅行社	zhou'shan'shi'pu'tuo'qu'tong'da'lv'xing'she	0
舟山市青华旅行社	zhou'shan'shi'qing'hua'lv'xing'she	0
舟山市天马旅行社	zhou'shan'shi'tian'ma'lv'xing'she	0
舟山市舟轮旅行社	zhou'shan'shi'zhou'lun'lv'xing'she	0
舟山天丰集团旅行社	zhou'shan'tian'feng'ji'tuan'lv'xing'she	0
舟山邮电旅行社	zhou'shan'you'dian'lv'xing'she	0
舟山中国国际旅行社	zhou'shan'zhong'guo'guo'ji'lv'xing'she	0
舟山中国旅行社	zhou'shan'zhong'guo'lv'xing'she	0
珠海飞沙国际度假城旅行社	zhu'hai'fei'sha'guo'ji'du'jia'cheng'lv'xing'she	0
珠海国际度假旅行社	zhu'hai'guo'ji'du'jia'lv'xing'she	0
珠海国际金融旅行社	zhu'hai'guo'ji'jin'rong'lv'xing'she	0
珠海海天旅行社	zhu'hai'hai'tian'lv'xing'she	0
珠海航空国际旅行社	zhu'hai'hang'kong'guo'ji'lv'xing'she	0
珠海经济特区海通旅行社	zhu'hai'jing'ji'te'qu'hai'tong'lv'xing'she	0
珠海经济特区濠江旅行社	zhu'hai'jing'ji'te'qu'hao'jiang'lv'xing'she	0
珠海经济特区环球国际旅行社	zhu'hai'jing'ji'te'qu'huan'qiu'guo'ji'lv'xing'she	0
珠海经济特区九洲旅行社	zhu'hai'jing'ji'te'qu'jiu'zhou'lv'xing'she	0
珠海经济特区怡海旅行社	zhu'hai'jing'ji'te'qu'yi'hai'lv'xing'she	0
珠海君悦国际旅行社	zhu'hai'jun'yue'guo'ji'lv'xing'she	0
珠海市碧海旅行社	zhu'hai'shi'bi'hai'lv'xing'she	0
珠海市拱宾国际旅行社	zhu'hai'shi'gong'bin'guo'ji'lv'xing'she	0
珠海市教育旅行社	zhu'hai'shi'jiao'yu'lv'xing'she	0
珠海石景山国际旅行社	zhu'hai'shi'jing'shan'guo'ji'lv'xing'she	0
珠海市望海旅行社	zhu'hai'shi'wang'hai'lv'xing'she	0
珠海市香洲江南旅行社	zhu'hai'shi'xiang'zhou'jiang'nan'lv'xing'she	0
珠海泰申旅行社	zhu'hai'tai'shen'lv'xing'she	0
诸暨市东方旅行社	zhu'ji'shi'dong'fang'lv'xing'she	0
诸暨市交通旅行社	zhu'ji'shi'jiao'tong'lv'xing'she	0
诸暨市职工旅行社	zhu'ji'shi'zhi'gong'lv'xing'she	0
诸暨西子旅行社	zhu'ji'xi'zi'lv'xing'she	0
株洲巴士旅行社	zhu'zhou'ba'shi'lv'xing'she	0
株洲长乐旅行社	zhu'zhou'chang'le'lv'xing'she	0
株洲春秋旅行社	zhu'zhou'chun'qiu'lv'xing'she	0
株洲飞燕旅行社	zhu'zhou'fei'yan'lv'xing'she	0
株洲富丽旅行社	zhu'zhou'fu'li'lv'xing'she	0
株洲妇女旅行社	zhu'zhou'fu'nv'lv'xing'she	0
株洲鸿飞旅行社	zhu'zhou'hong'fei'lv'xing'she	0
株洲环宇旅行社	zhu'zhou'huan'yu'lv'xing'she	0
株洲假日旅行社	zhu'zhou'jia'ri'lv'xing'she	0
株洲交通旅行社	zhu'zhou'jiao'tong'lv'xing'she	0
株洲九方旅行社	zhu'zhou'jiu'fang'lv'xing'she	0
株洲蓝天旅行社	zhu'zhou'lan'tian'lv'xing'she	0
株洲南方旅行社	zhu'zhou'nan'fang'lv'xing'she	0
株洲青年旅行社	zhu'zhou'qing'nian'lv'xing'she	0
株洲全鑫旅行社	zhu'zhou'quan'xin'lv'xing'she	0
株洲湘运旅行社	zhu'zhou'xiang'yun'lv'xing'she	0
株洲新时速旅行社	zhu'zhou'xin'shi'su'lv'xing'she	0
株洲新闻旅行社	zhu'zhou'xin'wen'lv'xing'she	0
株洲兴科旅行社	zhu'zhou'xing'ke'lv'xing'she	0
株洲炎帝神农旅行社	zhu'zhou'yan'di'shen'nong'lv'xing'she	0
株洲中联旅行社	zhu'zhou'zhong'lian'lv'xing'she	0
涿州国际旅行社	zhuo'zhou'guo'ji'lv'xing'she	0
涿州旅行社	zhuo'zhou'lv'xing'she	0
淄博国际旅行社	zi'bo'guo'ji'lv'xing'she	0
淄博恒台旅行社	zi'bo'heng'tai'lv'xing'she	0
淄博聊斋旅行社	zi'bo'liao'zhai'lv'xing'she	0
淄博青年旅行社	zi'bo'qing'nian'lv'xing'she	0
淄博市大众旅行社	zi'bo'shi'da'zhong'lv'xing'she	0
淄博市中国旅行社	zi'bo'shi'zhong'guo'lv'xing'she	0
紫金县中国旅行社	zi'jin'xian'zhong'guo'lv'xing'she	0
资中县龙都旅行社	zi'zhong'xian'long'du'lv'xing'she	0
