安全需要	an'quan'xu'yao	0
暗示	an'shi	0
按销售量抽成法	an'xiao'shou'liang'chou'cheng'fa	0
把关人	ba'guan'ren	0
报纸	bao'zhi	0
被追求公众	bei'zhui'qiu'gong'zhong	0
闭锁原则	bi'suo'yuan'ze	0
编码	bian'ma	0
编码者	bian'ma'zhe	0
表同作用	biao'tong'zuo'yong	0
补偿作用	bu'chang'zuo'yong	0
部落村	bu'luo'cun	0
不受欢迎公众	bu'shou'huan'ying'gong'zhong	0
财务公共关系	cai'wu'gong'gong'guan'xi	0
参与制	can'yu'zhi	0
参照群	can'zhao'qun	0
操作测验	cao'zuo'ce'yan	0
测验法	ce'yan'fa	0
产品形象	chan'pin'xing'xiang	0
超功能关系	chao'gong'neng'guan'xi	0
成见效应	cheng'jian'xiao'ying	0
成就平衡吸引规律	cheng'jiu'ping'heng'xi'yin'gui'lv	0
城市社区	cheng'shi'she'qu	0
冲突形态	chong'tu'xing'tai	0
初级社会群体	chu'ji'she'hui'qun'ti	0
传播产业	chuan'bo'chan'ye	0
传播代码	chuan'bo'dai'ma	0
传播对象	chuan'bo'dui'xiang	0
传播符号	chuan'bo'fu'hao	0
传播功能	chuan'bo'gong'neng	0
传播关系	chuan'bo'guan'xi	0
传播结构	chuan'bo'jie'gou	0
传播媒介发展四阶段	chuan'bo'mei'jie'fa'zhan'si'jie'duan	0
传播模式	chuan'bo'mo'shi	0
传播效果	chuan'bo'xiao'guo	0
传播学	chuan'bo'xue	0
传者	chuan'zhe	0
慈善团体公众	ci'shan'tuan'ti'gong'zhong	0
次属关系	ci'shu'guan'xi	0
次要公众	ci'yao'gong'zhong	0
挫折	cuo'zhe	0
挫折理论	cuo'zhe'li'lun	0
大众传播	da'zhong'chuan'bo	0
大众传播媒介	da'zhong'chuan'bo'mei'jie	0
大众交流	da'zhong'jiao'liu	0
大众媒体	da'zhong'mei'ti	0
大众社会	da'zhong'she'hui	0
大众文化	da'zhong'wen'hua	0
代码	dai'ma	0
单功能关系	dan'gong'neng'guan'xi	0
单向传播	dan'xiang'chuan'bo	0
道德控制	dao'de'kong'zhi	0
地方关系	di'fang'guan'xi	0
地球村	di'qiu'cun	0
地位和尊严需要	di'wei'he'zun'yan'xu'yao	0
第一印象	di'yi'yin'xiang	0
地缘群体	di'yuan'qun'ti	0
地缘人际关系	di'yuan'ren'ji'guan'xi	0
电视	dian'shi	0
动机	dong'ji	0
董事公众	dong'shi'gong'zhong	0
斗争关系	dou'zheng'guan'xi	0
独立公众	du'li'gong'zhong	0
对个人的知觉	dui'ge'ren'de'zhi'jue	0
对立关系	dui'li'guan'xi	0
多功能关系	duo'gong'neng'guan'xi	0
多余信息	duo'yu'xin'xi	0
发送者	fa'song'zhe	0
反感关系	fan'gan'guan'xi	0
反馈	fan'kui	0
反射	fan'she	0
防御型公共关系	fang'yu'xing'gong'gong'guan'xi	0
非公众	fei'gong'zhong	0
非语言符号	fei'yu'yan'fu'hao	0
非正式群体	fei'zheng'shi'qun'ti	0
封闭人际关系	feng'bi'ren'ji'guan'xi	0
封闭形态	feng'bi'xing'tai	0
符号	fu'hao	0
服务被服务型业缘关系	fu'wu'bei'fu'wu'xing'ye'yuan'guan'xi	0
服务性公共关系	fu'wu'xing'gong'gong'guan'xi	0
复杂关系	fu'za'guan'xi	0
复杂人	fu'za'ren	0
感情	gan'qing	0
感情投资	gan'qing'tou'zi	0
感情需要	gan'qing'xu'yao	0
感染	gan'ran	0
感召力	gan'zhao'li	0
个案法	ge'an'fa	0
个别测验	ge'bie'ce'yan	0
个人决策	ge'ren'jue'ce	0
个人心理冲突	ge'ren'xin'li'chong'tu	0
个人需要满足原则	ge'ren'xu'yao'man'zu'yuan'ze	0
个体心理	ge'ti'xin'li	0
个性	ge'xing	0
个性测验	ge'xing'ce'yan	0
个性记录表	ge'xing'ji'lu'biao	0
个性心理学	ge'xing'xin'li'xue	0
公告牌	gong'gao'pai	0
公共关系	gong'gong'guan'xi	0
公共关系程序	gong'gong'guan'xi'cheng'xu	0
公共关系从业人员	gong'gong'guan'xi'cong'ye'ren'yuan	0
公共关系的对象	gong'gong'guan'xi'de'dui'xiang	0
公共关系调查	gong'gong'guan'xi'diao'cha	0
公共关系工作	gong'gong'guan'xi'gong'zuo	0
公共关系过程	gong'gong'guan'xi'guo'cheng	0
公共关系活动	gong'gong'guan'xi'huo'dong	0
公共关系计划	gong'gong'guan'xi'ji'hua	0
公共关系模式	gong'gong'guan'xi'mo'shi	0
公共关系目标	gong'gong'guan'xi'mu'biao	0
公共关系学	gong'gong'guan'xi'xue	0
公共关系业务	gong'gong'guan'xi'ye'wu	0
公共关系职业	gong'gong'guan'xi'zhi'ye	0
公共关系状态	gong'gong'guan'xi'zhuang'tai	0
公共关系咨议	gong'gong'guan'xi'zi'yi	0
公关	gong'guan	0
攻击	gong'ji	0
工人公众	gong'ren'gong'zhong	0
共生效应	gong'sheng'xiao'ying	0
工业社会	gong'ye'she'hui	0
公意	gong'yi	0
公众	gong'zhong	0
公众关系	gong'zhong'guan'xi	0
公众通讯	gong'zhong'tong'xun	0
工作满足感	gong'zuo'man'zu'gan	0
古典管理	gu'dian'guan'li	0
股东公众	gu'dong'gong'zhong	0
股东关系	gu'dong'guan'xi	0
顾客公众	gu'ke'gong'zhong	0
顾客关系	gu'ke'guan'xi	0
固执	gu'zhi	0
观察法	guan'cha'fa	0
观察力	guan'cha'li	0
观察评定法	guan'cha'ping'ding'fa	0
管理	guan'li	0
管理方法	guan'li'fang'fa	0
管理幅度	guan'li'fu'du	0
管理科学	guan'li'ke'xue	0
管理跨度	guan'li'kua'du	0
管理宽调	guan'li'kuan'tiao	0
管理心理学	guan'li'xin'li'xue	0
管理心理与行为决策	guan'li'xin'li'yu'xing'wei'jue'ce	0
管理职能	guan'li'zhi'neng	0
关系网	guan'xi'wang	0
观众效应	guan'zhong'xiao'ying	0
广播	guang'bo	0
广告心理学	guang'gao'xin'li'xue	0
光环效应	guang'huan'xiao'ying	0
归属需要	gui'shu'xu'yao	0
归因	gui'yin	0
国际公共关系	guo'ji'gong'gong'guan'xi	0
海报	hai'bao	0
函牍	han'du	0
和睦关系	he'mu'guan'xi	0
横向同业公众	heng'xiang'tong'ye'gong'zhong	0
后工业社会	hou'gong'ye'she'hui	0
后光效应	hou'guang'xiao'ying	0
互补形态	hu'bu'xing'tai	0
互利形态	hu'li'xing'tai	0
互益原则	hu'yi'yuan'ze	0
环境监视	huan'jing'jian'shi	0
回馈	hui'kui	0
基本群	ji'ben'qun	0
基本态度	ji'ben'tai'du	0
极端性转移	ji'duan'xing'zhuan'yi	0
激励	ji'li	0
激励因素	ji'li'yin'su	0
技术员公众	ji'shu'yuan'gong'zhong	0
集体测验	ji'ti'ce'yan	0
集体意识	ji'ti'yi'shi	0
机械能力性向测验	ji'xie'neng'li'xing'xiang'ce'yan	0
记忆能力	ji'yi'neng'li	0
家庭代际数	jia'ting'dai'ji'shu	0
简报	jian'bao	0
简单关系	jian'dan'guan'xi	0
柬函	jian'han	0
建设型公共关系	jian'she'xing'gong'gong'guan'xi	0
奖励	jiang'li	0
交互报偿吸引规律	jiao'hu'bao'chang'xi'yin'gui'lv	0
交际性公共关系	jiao'ji'xing'gong'gong'guan'xi	0
矫正型公共关系	jiao'zheng'xing'gong'gong'guan'xi	0
结合关系	jie'he'guan'xi	0
接近性吸引规律	jie'jin'xing'xi'yin'gui'lv	0
接近原则	jie'jin'yuan'ze	0
进攻型公共关系	jin'gong'xing'gong'gong'guan'xi	0
金融公共关系	jin'rong'gong'gong'guan'xi	0
近因效应	jin'yin'xiao'ying	0
经济人	jing'ji'ren	0
精神发泄法	jing'shen'fa'xie'fa	0
精神需要	jing'shen'xu'yao	0
经销商公众	jing'xiao'shang'gong'zhong	0
竞争关系	jing'zheng'guan'xi	0
距离临近律	ju'li'lin'jin'lv	0
聚散型公众	ju'san'xing'gong'zhong	0
决策	jue'ce	0
决策有效性	jue'ce'you'xiao'xing	0
刻板印象	ke'ban'yin'xiang	0
控制行为	kong'zhi'xing'wei	0
口语刺激	kou'yu'ci'ji	0
劳动心理学	lao'dong'xin'li'xue	0
冷媒介	leng'mei'jie	0
理解	li'jie	0
良好人际关系	liang'hao'ren'ji'guan'xi	0
邻里效应	lin'li'xiao'ying	0
领导	ling'dao	0
领导体制	ling'dao'ti'zhi	0
领导心理	ling'dao'xin'li	0
零散型公众	ling'san'xing'gong'zhong	0
流动性公众	liu'dong'xing'gong'zhong	0
录像	lu'xiang	0
逻辑推理能力	luo'ji'tui'li'neng'li	0
罗夏克测验	luo'xia'ke'ce'yan	0
媒介	mei'jie	0
媒介产业	mei'jie'chan'ye	0
媒介关系	mei'jie'guan'xi	0
媒介合成体	mei'jie'he'cheng'ti	0
美誉度	mei'yu'du	0
名片效应	ming'pian'xiao'ying	0
模仿	mo'fang	0
目标导向行为	mu'biao'dao'xiang'xing'wei	0
目标行为	mu'biao'xing'wei	0
目标作业法	mu'biao'zuo'ye'fa	0
难度测验	nan'du'ce'yan	0
内部公共关系	nei'bu'gong'gong'guan'xi	0
内部公众	nei'bu'gong'zhong	0
内部刊物	nei'bu'kan'wu	0
内化	nei'hua	0
内在奖励	nei'zai'jiang'li	0
内在控制	nei'zai'kong'zhi	0
能力	neng'li	0
能力测验	neng'li'ce'yan	0
能力阈限	neng'li'yu'xian	0
逆意公众	ni'yi'gong'zhong	0
凝聚力	ning'ju'li	0
偶然群	ou'ran'qun	0
朋友人际关系	peng'you'ren'ji'guan'xi	0
皮格马利翁效应	pi'ge'ma'li'weng'xiao'ying	0
偏见	pian'jian	0
平等互助互谅互让原则	ping'deng'hu'zhu'hu'liang'hu'rang'yuan'ze	0
平等原则	ping'deng'yuan'ze	0
评价能力	ping'jia'neng'li	0
平行原则	ping'xing'yuan'ze	0
期刊	qi'kan	0
企业刊物	qi'ye'kan'wu	0
前馈	qian'kui	0
潜在公众	qian'zai'gong'zhong	0
墙报	qiang'bao	0
强迫性吸引规律	qiang'po'xing'xi'yin'gui'lv	0
强制关系	qiang'zhi'guan'xi	0
强制形态	qiang'zhi'xing'tai	0
侵犯行为	qin'fan'xing'wei	0
亲社会行为	qin'she'hui'xing'wei	0
亲属人际关系	qin'shu'ren'ji'guan'xi	0
亲缘关系指数	qin'yuan'guan'xi'zhi'shu	0
亲缘人际关系	qin'yuan'ren'ji'guan'xi	0
情感	qing'gan	0
情感传播	qing'gan'chuan'bo	0
情境	qing'jing	0
情绪感染	qing'xu'gan'ran	0
情绪互动	qing'xu'hu'dong	0
情绪效应	qing'xu'xiao'ying	0
渠道	qu'dao	0
区域关系	qu'yu'guan'xi	0
群体	qun'ti	0
群体冲突	qun'ti'chong'tu	0
群体规范	qun'ti'gui'fan	0
群体活动效率原则	qun'ti'huo'dong'xiao'lv'yuan'ze	0
群体决策	qun'ti'jue'ce	0
群体凝聚力	qun'ti'ning'ju'li	0
群体心理	qun'ti'xin'li	0
群体压力	qun'ti'ya'li	0
群体意识	qun'ti'yi'shi	0
热媒介	re'mei'jie	0
人本原理	ren'ben'yuan'li	0
人的现代化	ren'de'xian'dai'hua	0
人际传播	ren'ji'chuan'bo	0
人际感情	ren'ji'gan'qing	0
人际关系	ren'ji'guan'xi	0
人际关系形态	ren'ji'guan'xi'xing'tai	0
人际关系学	ren'ji'guan'xi'xue	0
人际距离	ren'ji'ju'li	0
人际期待	ren'ji'qi'dai	0
人际知觉	ren'ji'zhi'jue	0
人群关系	ren'qun'guan'xi	0
人文环境	ren'wen'huan'jing	0
人性	ren'xing	0
上下级关系	shang'xia'ji'guan'xi	0
商业心理学	shang'ye'xin'li'xue	0
社会	she'hui	0
社会保险	she'hui'bao'xian	0
社会保障制度	she'hui'bao'zhang'zhi'du	0
社会标签效应	she'hui'biao'qian'xiao'ying	0
社会从众行为	she'hui'cong'zhong'xing'wei	0
社会地位	she'hui'di'wei	0
社会动机	she'hui'dong'ji	0
社会风气	she'hui'feng'qi	0
社会福利	she'hui'fu'li	0
社会福利社区组织	she'hui'fu'li'she'qu'zu'zhi	0
社会关系	she'hui'guan'xi	0
社会规范	she'hui'gui'fan	0
社会环境	she'hui'huan'jing	0
社会阶层	she'hui'jie'ceng	0
社会精英	she'hui'jing'ying	0
社会利益原则	she'hui'li'yi'yuan'ze	0
社会权威	she'hui'quan'wei	0
社会群体	she'hui'qun'ti	0
社会人	she'hui'ren	0
社会身份	she'hui'shen'fen	0
社会生活	she'hui'sheng'huo	0
社会态度	she'hui'tai'du	0
社会文化	she'hui'wen'hua	0
社会问题	she'hui'wen'ti	0
社会现象	she'hui'xian'xiang	0
社会效益	she'hui'xiao'yi	0
社会心理	she'hui'xin'li	0
社会心理群体	she'hui'xin'li'qun'ti	0
社会心理学	she'hui'xin'li'xue	0
社会需要	she'hui'xu'yao	0
社会学	she'hui'xue	0
社会意识	she'hui'yi'shi	0
社会舆论	she'hui'yu'lun	0
社会与社会关系	she'hui'yu'she'hui'guan'xi	0
社会知觉	she'hui'zhi'jue	0
社会主义精神文明	she'hui'zhu'yi'jing'shen'wen'ming	0
社会助长作用	she'hui'zhu'zhang'zuo'yong	0
社会组织	she'hui'zu'zhi	0
社交人	she'jiao'ren	0
社区	she'qu	0
社区发展	she'qu'fa'zhan	0
社区公众	she'qu'gong'zhong	0
社区关系	she'qu'guan'xi	0
社区中心	she'qu'zhong'xin	0
社区组织	she'qu'zu'zhi	0
生活方式	sheng'huo'fang'shi	0
生理需要	sheng'li'xu'yao	0
世界村	shi'jie'cun	0
实利人	shi'li'ren	0
士气	shi'qi	0
士气调查	shi'qi'diao'cha	0
时尚	shi'shang	0
受传者	shou'chuan'zhe	0
受欢迎公众	shou'huan'ying'gong'zhong	0
手势刺激	shou'shi'ci'ji	0
首属关系	shou'shu'guan'xi	0
首要公众	shou'yao'gong'zhong	0
首因效应	shou'yin'xiao'ying	0
受者	shou'zhe	0
受众	shou'zhong	0
书面测验	shu'mian'ce'yan	0
双向传播	shuang'xiang'chuan'bo	0
顺意公众	shun'yi'gong'zhong	0
斯凯伦计划	si'kai'lun'ji'hua	0
速度测验	su'du'ce'yan	0
他人在场	ta'ren'zai'chang	0
态度	tai'du	0
态度丛	tai'du'cong	0
态度调查	tai'du'diao'cha	0
态度相似律	tai'du'xiang'si'lv	0
谈话法	tan'hua'fa	0
特殊公众	te'shu'gong'zhong	0
特殊能力	te'shu'neng'li	0
特殊性向测验	te'shu'xing'xiang'ce'yan	0
替代作用	ti'dai'zuo'yong	0
同层次业缘人际关系	tong'ceng'ci'ye'yuan'ren'ji'guan'xi	0
同化	tong'hua	0
同级关系	tong'ji'guan'xi	0
同事关系	tong'shi'guan'xi	0
同质群体	tong'zhi'qun'ti	0
投射测验	tou'she'ce'yan	0
投射效应	tou'she'xiao'ying	0
投射作用	tou'she'zuo'yong	0
退化	tui'hua	0
妥协	tuo'xie	0
外部公共关系	wai'bu'gong'gong'guan'xi	0
外部公众	wai'bu'gong'zhong	0
外部刊物	wai'bu'kan'wu	0
外在奖励	wai'zai'jiang'li	0
韦克斯勒成人智力量表	wei'ke'si'le'cheng'ren'zhi'li'liang'biao	0
稳定形态	wen'ding'xing'tai	0
文化	wen'hua	0
文明	wen'ming	0
文饰作用	wen'shi'zuo'yong	0
文书能力性向测验	wen'shu'neng'li'xing'xiang'ce'yan	0
物质需要	wu'zhi'xu'yao	0
五种传播网络	wu'zhong'chuan'bo'wang'luo	0
习俗	xi'su	0
系统管理	xi'tong'guan'li	0
贤内助公众	xian'nei'zhu'gong'zhong	0
线索偏差	xian'suo'pian'cha	0
闲暇时间	xian'xia'shi'jian	0
线性传播	xian'xing'chuan'bo	0
相容原则	xiang'rong'yuan'ze	0
相似原则	xiang'si'yuan'ze	0
效度	xiao'du	0
消费者关系	xiao'fei'zhe'guan'xi	0
消费者系列化	xiao'fei'zhe'xi'lie'hua	0
消费者心理学	xiao'fei'zhe'xin'li'xue	0
消费者组织化	xiao'fei'zhe'zu'zhi'hua	0
小集团意识	xiao'ji'tuan'yi'shi	0
小群体	xiao'qun'ti	0
效用	xiao'yong	0
协作关系	xie'zuo'guan'xi	0
心理测验	xin'li'ce'yan	0
心理挫折	xin'li'cuo'zhe	0
心理缓和	xin'li'huan'he	0
心理技术学	xin'li'ji'shu'xue	0
心理能力测验	xin'li'neng'li'ce'yan	0
心理气氛	xin'li'qi'fen	0
心理气候	xin'li'qi'hou	0
心理卫生	xin'li'wei'sheng	0
心理因素	xin'li'yin'su	0
心理运动能力性向测验	xin'li'yun'dong'neng'li'xing'xiang'ce'yan	0
新闻稿	xin'wen'gao	0
新闻界关系	xin'wen'jie'guan'xi	0
新闻媒介公众	xin'wen'mei'jie'gong'zhong	0
信息	xin'xi	0
信息传递	xin'xi'chuan'di	0
信息方法	xin'xi'fang'fa	0
信息分类	xin'xi'fen'lei	0
信息化社会	xin'xi'hua'she'hui	0
信息加工	xin'xi'jia'gong	0
信息价值	xin'xi'jia'zhi	0
信息量	xin'xi'liang	0
信息论	xin'xi'lun	0
信息社会	xin'xi'she'hui	0
信息生成源	xin'xi'sheng'cheng'yuan	0
信息收集	xin'xi'shou'ji	0
信息源	xin'xi'yuan	0
信息贮存	xin'xi'zhu'cun	0
信息追踪	xin'xi'zhui'zong	0
信誉原则	xin'yu'yuan'ze	0
行动公众	xing'dong'gong'zhong	0
兴趣	xing'qu	0
行为	xing'wei	0
行为规律	xing'wei'gui'lv	0
行为结构	xing'wei'jie'gou	0
行为科学	xing'wei'ke'xue	0
行为模式	xing'wei'mo'shi	0
形象塑造运动	xing'xiang'su'zao'yun'dong	0
需要	xu'yao	0
需要互补律	xu'yao'hu'bu'lv	0
需要互补吸引规律	xu'yao'hu'bu'xi'yin'gui'lv	0
宣传小册子	xuan'chuan'xiao'ce'zi	0
宣传性公共关系	xuan'chuan'xing'gong'gong'guan'xi	0
选择性记忆	xuan'ze'xing'ji'yi	0
选择性接触	xuan'ze'xing'jie'chu	0
选择性接受	xuan'ze'xing'jie'shou	0
选择性理解	xuan'ze'xing'li'jie	0
选择性注意	xuan'ze'xing'zhu'yi	0
血亲人际关系	xue'qin'ren'ji'guan'xi	0
血亲人际群体	xue'qin'ren'ji'qun'ti	0
讯息	xun'xi	0
压力	ya'li	0
谣言	yao'yan	0
业缘关系	ye'yuan'guan'xi	0
业缘群体	ye'yuan'qun'ti	0
业缘人际关系	ye'yuan'ren'ji'guan'xi	0
一般能力	yi'ban'neng'li	0
意见调查	yi'jian'diao'cha	0
译码	yi'ma	0
译码者	yi'ma'zhe	0
意志控制	yi'zhi'kong'zhi	0
印象	yin'xiang	0
印象整饰	yin'xiang'zheng'shi	0
影响力	ying'xiang'li	0
诱发性吸引规律	you'fa'xing'xi'yin'gui'lv	0
友谊	you'yi	0
预测行为	yu'ce'xing'wei	0
舆论	yu'lun	0
舆论领袖	yu'lun'ling'xiu	0
员工关系	yuan'gong'guan'xi	0
员工手册	yuan'gong'shou'ce	0
原料供应者公众	yuan'liao'gong'ying'zhe'gong'zhong	0
原始传播方式	yuan'shi'chuan'bo'fang'shi	0
晕轮效应	yun'lun'xiao'ying	0
杂志	za'zhi	0
障碍人际关系	zhang'ai'ren'ji'guan'xi	0
障碍形态	zhang'ai'xing'tai	0
正常人际关系	zheng'chang'ren'ji'guan'xi	0
政府公众	zheng'fu'gong'zhong	0
政府关系	zheng'fu'guan'xi	0
征询性公共关系	zheng'xun'xing'gong'gong'guan'xi	0
职工关系	zhi'gong'guan'xi	0
知觉	zhi'jue	0
知觉选择性	zhi'jue'xuan'ze'xing	0
智力	zhi'li	0
智力测验	zhi'li'ce'yan	0
知名度	zhi'ming'du	0
知名度和美誉度形象地位图	zhi'ming'du'he'mei'yu'du'xing'xiang'di'wei'tu	0
知晓公众	zhi'xiao'gong'zhong	0
职员刊物	zhi'yuan'kan'wu	0
制约现象	zhi'yue'xian'xiang	0
中间传播	zhong'jian'chuan'bo	0
中介传播	zhong'jie'chuan'bo	0
中立公众	zhong'li'gong'zhong	0
周期性公众	zhou'qi'xing'gong'zhong	0
主客关系	zhu'ke'guan'xi	0
主题统觉测验	zhu'ti'tong'jue'ce'yan	0
自陈量表法	zi'chen'liang'biao'fa	0
自动人	zi'dong'ren	0
自我传播	zi'wo'chuan'bo	0
自我控制	zi'wo'kong'zhi	0
自我实现人	zi'wo'shi'xian'ren	0
自我实现需要	zi'wo'shi'xian'xu'yao	0
自我知觉	zi'wo'zhi'jue	0
自由时间	zi'you'shi'jian	0
综合刊物	zong'he'kan'wu	0
组织传播	zu'zhi'chuan'bo	0
组织形象	zu'zhi'xing'xiang	0
组织形象地位四象限图	zu'zhi'xing'xiang'di'wei'si'xiang'xian'tu	0
