暗器制作术	an'qi'zhi'zuo'shu	0
八卦剑气	ba'gua'jian'qi	0
霸王	ba'wang	0
霸王疾风箭	ba'wang'ji'feng'jian	0
霸王拳	ba'wang'quan	0
霸王卸甲	ba'wang'xie'jia	0
百蛊心经	bai'gu'xin'jing	0
白虹簪	bai'hong'zan	0
白驹丸	bai'ju'wan	0
百辟	bai'pi	0
拜山	bai'shan	0
拜山香客	bai'shan'xiang'ke	0
白水洞	bai'shui'dong	0
白莹莹	bai'ying'ying	0
百战	bai'zhan	0
帮派	bang'pai	0
帮助中心	bang'zhu'zhong'xin	0
宝光杖	bao'guang'zhang	0
爆尸大法	bao'shi'da'fa	0
宝象	bao'xiang	0
北斗七星阵	bei'dou'qi'xing'zhen	0
北方区	bei'fang'qu	0
奔雷剑法	ben'lei'jian'fa	0
奔雷琴	ben'lei'qin	0
绷带	beng'dai	0
碧湖绣装	bi'hu'xiu'zhuang	0
碧鳞装	bi'lin'zhuang	0
必闪	bi'shan	0
碧蛇手	bi'she'shou	0
碧血	bi'xue	0
碧月飞星枪	bi'yue'fei'xing'qiang	0
碧云绣装	bi'yun'xiu'zhuang	0
编号	bian'hao	0
汴京城	bian'jing'cheng	0
汴京府东	bian'jing'fu'dong	0
汴京府南	bian'jing'fu'nan	0
汴京府西	bian'jing'fu'xi	0
汴京马贩	bian'jing'ma'fan	0
标准男子上衣	biao'zhun'nan'zi'shang'yi	0
标准男子下衣	biao'zhun'nan'zi'xia'yi	0
冰蚕绸衫	bing'can'chou'shan	0
冰心洞	bing'xin'dong	0
不动明王咒	bu'dong'ming'wang'zhou	0
不灭心法	bu'mie'xin'fa	0
彩华裳	cai'hua'shang	0
彩木发簪	cai'mu'fa'zan	0
彩裳	cai'shang	0
彩纹木簪	cai'wen'mu'zan	0
彩绣装	cai'xiu'zhuang	0
采药	cai'yao	0
蠶蛊	can'gu	0
残影诀	can'ying'jue	0
藏剑阁	cang'jian'ge	0
藏剑山庄	cang'jian'shan'zhuang	0
沧澜衣	cang'lan'yi	0
苍龙岭	cang'long'ling	0
曹彬	cao'bin	0
操尸术	cao'shi'shu	0
缠梦剑意	chan'meng'jian'yi	0
长兵器锻造	chang'bing'qi'duan'zao	0
长生	chang'sheng	0
陈钟鹤	chen'zhong'he	0
成都府	cheng'du'fu	0
成都府北	cheng'du'fu'bei	0
成都府南	cheng'du'fu'nan	0
成都府西	cheng'du'fu'xi	0
称号	cheng'hao	0
城市	cheng'shi	0
赤鳞装	chi'lin'zhuang	0
赤龙袍	chi'long'pao	0
赤蜻眼罩	chi'qing'yan'zhao	0
赤砂剑	chi'sha'jian	0
赤铜胄	chi'tong'zhou	0
蚩牙	chi'ya	0
吃药	chi'yao	0
赤月枪	chi'yue'qiang	0
仇人	chou'ren	0
抽丝	chou'si	0
初级技能	chu'ji'ji'neng	0
初级武功	chu'ji'wu'gong	0
出云	chu'yun	0
穿心刺	chuan'xin'ci	0
穿心弓	chuan'xin'gong	0
穿云手	chuan'yun'shou	0
窗口模式	chuang'kou'mo'shi	0
春风笔	chun'feng'bi	0
春眠不觉晓	chun'mian'bu'jue'xiao	0
纯阳气	chun'yang'qi	0
淬毒飞针	cui'du'fei'zhen	0
淬毒秘术	cui'du'mi'shu	0
催尸邪气	cui'shi'xie'qi	0
大般若杖	da'ban'ruo'zhang	0
大草原	da'cao'yuan	0
大乘如来心法	da'cheng'ru'lai'xin'fa	0
大慈大悲咒	da'ci'da'bei'zhou	0
打狗棒	da'gou'bang	0
打狗棍法	da'gou'gun'fa	0
打狗棍阵	da'gou'gun'zhen	0
大力金刚指	da'li'jin'gang'zhi	0
达摩武经	da'mo'wu'jing	0
大须弥掌	da'xu'mi'zhang	0
大院	da'yuan	0
大自在杖	da'zi'zai'zhang	0
打坐	da'zuo	0
单数购买	dan'shu'gou'mai	0
单数卖出	dan'shu'mai'chu	0
当代高僧	dang'dai'gao'seng	0
当代铸剑大师	dang'dai'zhu'jian'da'shi	0
道具	dao'ju	0
道具背包	dao'ju'bei'bao	0
等级	deng'ji	0
地杰	di'jie	0
地宁玄阴剑	di'ning'xuan'yin'jian	0
地图	di'tu	0
地图获取	di'tu'huo'qu	0
点钢枪	dian'gang'qiang	0
定国紫染带	ding'guo'zi'ran'dai	0
洞察	dong'cha	0
东海海滨	dong'hai'hai'bin	0
东汉琴乐大家	dong'han'qin'le'da'jia	0
动韦陀拳	dong'wei'tuo'quan	0
毒刺骨	du'ci'gu	0
毒蛊	du'gu	0
独门暗器	du'men'an'qi	0
渡元诀	du'yuan'jue	0
短兵器锻造	duan'bing'qi'duan'zao	0
断肠镖	duan'chang'biao	0
断水心法	duan'shui'xin'fa	0
队伍管理	dui'wu'guan'li	0
队长移交	dui'zhang'yi'jiao	0
夺魂	duo'hun	0
夺魄幡	duo'po'fan	0
峨眉	e'mei	0
峨嵋初级佛法	e'mei'chu'ji'fo'fa	0
峨嵋初级琴曲	e'mei'chu'ji'qin'qu	0
峨嵋初级心法	e'mei'chu'ji'xin'fa	0
峨嵋顶级佛法	e'mei'ding'ji'fo'fa	0
峨嵋顶级琴曲	e'mei'ding'ji'qin'qu	0
峨嵋佛家	e'mei'fo'jia	0
峨嵋佛家武功	e'mei'fo'jia'wu'gong	0
峨嵋佛意	e'mei'fo'yi	0
峨嵋高级佛法	e'mei'gao'ji'fo'fa	0
峨嵋高级琴曲	e'mei'gao'ji'qin'qu	0
峨嵋高级武功	e'mei'gao'ji'wu'gong	0
峨嵋派	e'mei'pai	0
峨嵋派入门任务	e'mei'pai'ru'men'ren'wu	0
峨嵋俗家	e'mei'su'jia	0
峨嵋镇派琴曲	e'mei'zhen'pai'qin'qu	0
峨嵋中级佛法	e'mei'zhong'ji'fo'fa	0
峨嵋中级琴曲	e'mei'zhong'ji'qin'qu	0
峨嵋中级心法	e'mei'zhong'ji'xin'fa	0
恶人谷	e'ren'gu	0
二龙山	er'long'shan	0
伐木	fa'mu	0
防风笠	fang'feng'li	0
方猿	fang'yuan	0
飞红绣装	fei'hong'xiu'zhuang	0
飞鸟	fei'niao	0
飞瀑连珠	fei'pu'lian'zhu	0
飞天彩裳	fei'tian'cai'shang	0
飞鱼手	fei'yu'shou	0
飞鱼装	fei'yu'zhuang	0
飞云笠	fei'yun'li	0
焚琴煮鹤诀	fen'qin'zhu'he'jue	0
分水棍	fen'shui'gun	0
分水谱	fen'shui'pu	0
风尘绣装	feng'chen'xiu'zhuang	0
丰都鬼城	feng'du'gui'cheng	0
疯蛊	feng'gu	0
风雷	feng'lei	0
封魔洞	feng'mo'dong	0
封魔棍法	feng'mo'gun'fa	0
凤求凰	feng'qiu'huang	0
风翔	feng'xiang	0
凤眼洞	feng'yan'dong	0
风雨巾	feng'yu'jin	0
风雨裳	feng'yu'shang	0
风雨绣装	feng'yu'xiu'zhuang	0
佛光普照	fo'guang'pu'zhao	0
佛光战气	fo'guang'zhan'qi	0
佛门大德高僧	fo'men'da'de'gao'seng	0
佛音战意	fo'yin'zhan'yi	0
腐骨毒液	fu'gu'du'ye	0
伏虎气功	fu'hu'qi'gong	0
伏魔杖	fu'mo'zhang	0
伏牛山	fu'niu'shan	0
覆水心法	fu'shui'xin'fa	0
拂云	fu'yun	0
服装店	fu'zhuang'dian	0
丐帮	gai'bang	0
丐帮初级棍法	gai'bang'chu'ji'gun'fa	0
丐帮初级技能	gai'bang'chu'ji'ji'neng	0
丐帮初级拳法	gai'bang'chu'ji'quan'fa	0
丐帮初级心法	gai'bang'chu'ji'xin'fa	0
丐帮高级功法	gai'bang'gao'ji'gong'fa	0
丐帮高级拳法	gai'bang'gao'ji'quan'fa	0
丐帮高级心法	gai'bang'gao'ji'xin'fa	0
丐帮棍法	gai'bang'gun'fa	0
丐帮基本拳掌功法	gai'bang'ji'ben'quan'zhang'gong'fa	0
丐帮基本使棍功法	gai'bang'ji'ben'shi'gun'gong'fa	0
丐帮净衣	gai'bang'jing'yi	0
丐帮净衣武功	gai'bang'jing'yi'wu'gong	0
丐帮入门任务	gai'bang'ru'men'ren'wu	0
丐帮污衣	gai'bang'wu'yi	0
丐帮污衣武功	gai'bang'wu'yi'wu'gong	0
丐帮掌法	gai'bang'zhang'fa	0
丐帮镇派拳法	gai'bang'zhen'pai'quan'fa	0
丐帮至高棍法	gai'bang'zhi'gao'gun'fa	0
丐帮中级功法	gai'bang'zhong'ji'gong'fa	0
丐帮中级技能	gai'bang'zhong'ji'ji'neng	0
丐帮中级拳法	gai'bang'zhong'ji'quan'fa	0
丐帮中级心法	gai'bang'zhong'ji'xin'fa	0
高级技能	gao'ji'ji'neng	0
高级武功	gao'ji'wu'gong	0
根骨	gen'gu	0
攻击命中率	gong'ji'ming'zhong'lv	0
攻速	gong'su	0
勾册	gou'ce	0
勾魂阱	gou'hun'jing	0
钩镰枪	gou'lian'qiang	0
蛊虫	gu'chong	0
古阳洞	gu'yang'dong	0
灌木林	guan'mu'lin	0
观音诀	guan'yin'jue	0
光明顶	guang'ming'ding	0
鬼面束发	gui'mian'shu'fa	0
海神发结	hai'shen'fa'jie	0
海月清辉	hai'yue'qing'hui	0
含光剑	han'guang'jian	0
含沙射影	han'sha'she'ying	0
含幽谷	han'you'gu	0
好感度	hao'gan'du	0
豪侠衣	hao'xia'yi	0
豪勇装	hao'yong'zhuang	0
好友	hao'you	0
号钟	hao'zhong	0
鹤舞棍	he'wu'gun	0
黑风洞	hei'feng'dong	0
黑锦头带	hei'jin'tou'dai	0
黑绒绣装	hei'rong'xiu'zhuang	0
黑血神针	hei'xue'shen'zhen	0
黑皂布衣	hei'zao'bu'yi	0
弘法杖	hong'fa'zhang	0
鸿鹄	hong'hu	0
红绫面巾	hong'ling'mian'jin	0
红魔手	hong'mo'shou	0
红霓裳	hong'ni'chang	0
洪七	hong'qi	0
红玉	hong'yu	0
红云裳	hong'yun'shang	0
红云绣装	hong'yun'xiu'zhuang	0
胡姬舞衣	hu'ji'wu'yi	0
胡姬绣装	hu'ji'xiu'zhuang	0
护甲织造	hu'jia'zhi'zao	0
虎皮劲装	hu'pi'jin'zhuang	0
虎皮装	hu'pi'zhuang	0
虎啸	hu'xiao	0
化骨粉	hua'gu'fen	0
华山	hua'shan	0
华阳巾	hua'yang'jin	0
幻蛊	huan'gu	0
浣花裳	huan'hua'shang	0
幻影装	huan'ying'zhuang	0
黄绸束带	huang'chou'shu'dai	0
黄虎皮衣	huang'hu'pi'yi	0
皇陵墓	huang'ling'mu	0
皇陵墓室	huang'ling'mu'shi	0
回城符	hui'cheng'fu	0
回风装	hui'feng'zhuang	0
回龙转凤羹	hui'long'zhuan'feng'geng	0
会仙岭	hui'xian'ling	0
会心	hui'xin	0
慧眼咒	hui'yan'zhou	0
混天气功	hun'tian'qi'gong	0
混元一气功	hun'yuan'yi'qi'gong	0
伙工头	huo'gong'tou	0
火浣绣装	huo'huan'xiu'zhuang	0
火尖枪	huo'jian'qiang	0
火系初级剑法	huo'xi'chu'ji'jian'fa	0
火系高级剑法	huo'xi'gao'ji'jian'fa	0
火系中级剑法	huo'xi'zhong'ji'jian'fa	0
火翔装	huo'xiang'zhuang	0
火蛛圣衫	huo'zhu'sheng'shan	0
基本心法	ji'ben'xin'fa	0
基础技艺	ji'chu'ji'yi	0
机关破解术	ji'guan'po'jie'shu	0
技能成长	ji'neng'cheng'zhang	0
技能获得	ji'neng'huo'de	0
技能使用	ji'neng'shi'yong	0
技能消耗品	ji'neng'xiao'hao'pin	0
集尸邪气	ji'shi'xie'qi	0
家传技艺	jia'chuan'ji'yi	0
袈裟伏魔神通	jia'sha'fu'mo'shen'tong	0
迦叶腿	jia'ye'tui	0
鉴定物品	jian'ding'wu'pin	0
建立队伍	jian'li'dui'wu	0
剑门关	jian'men'guan	0
剑侠情缘	jian'xia'qing'yuan	0
江北六道总捕头宇文通	jiang'bei'liu'dao'zong'bu'tou'yu'wen'tong	0
江北彭家	jiang'bei'peng'jia	0
江湖技艺	jiang'hu'ji'yi	0
江津村	jiang'jin'cun	0
江南霹雳堂雷门	jiang'nan'pi'li'tang'lei'men	0
江南巧手堂	jiang'nan'qiao'shou'tang	0
江南区	jiang'nan'qu	0
江南织造坊	jiang'nan'zhi'zao'fang	0
脚店客站	jiao'dian'ke'zhan	0
焦尾	jiao'wei	0
娇小女子上衣	jiao'xiao'nv'zi'shang'yi	0
娇小女子头饰	jiao'xiao'nv'zi'tou'shi	0
娇小女子下衣	jiao'xiao'nv'zi'xia'yi	0
戒刀	jie'dao	0
解毒秘术	jie'du'mi'shu	0
解散队伍	jie'san'dui'wu	0
结义结婚	jie'yi'jie'hun	0
锦布发带	jin'bu'fa'dai	0
金风冠	jin'feng'guan	0
金凤簪	jin'feng'zan	0
金刚不坏	jin'gang'bu'huai	0
金光洞	jin'guang'dong	0
巾帼衫	jin'guo'shan	0
禁军	jin'jun	0
锦澜装	jin'lan'zhuang	0
金缕装	jin'lv'zhuang	0
紧那罗棒	jin'na'luo'bang	0
金山一卡通	jin'shan'yi'ka'tong	0
锦丝缠带	jin'si'chan'dai	0
金丝装	jin'si'zhuang	0
金绦发带	jin'tao'fa'dai	0
金系初级剑法	jin'xi'chu'ji'jian'fa	0
金系高级剑法	jin'xi'gao'ji'jian'fa	0
金系中级剑法	jin'xi'zhong'ji'jian'fa	0
锦缨裳	jin'ying'shang	0
锦樱绣装	jin'ying'xiu'zhuang	0
金玉绸衫	jin'yu'chou'shan	0
锦云裳	jin'yun'shang	0
金钟罩	jin'zhong'zhao	0
精钢炫金甲	jing'gang'xuan'jin'jia	0
精钢战盔	jing'gang'zhan'kui	0
惊雷笔	jing'lei'bi	0
惊涛琴	jing'tao'qin	0
精铁弓	jing'tie'gong	0
静夜思	jing'ye'si	0
九华山	jiu'hua'shan	0
九霄环佩	jiu'xiao'huan'pei	0
九音刀	jiu'yin'dao	0
绝代高手	jue'dai'gao'shou	0
角色死亡	jue'se'si'wang	0
绝玉冠	jue'yu'guan	0
亢龙手	kang'long'shou	0
空明杖	kong'ming'zhang	0
孔雀簪	kong'que'zan	0
空桑山	kong'sang'shan	0
快捷键默认设置	kuai'jie'jian'mo'ren'she'zhi	0
快速购买	kuai'su'gou'mai	0
快速卖出	kuai'su'mai'chu	0
狂风爪	kuang'feng'zhao	0
矿坑	kuang'keng	0
狂炎装	kuang'yan'zhuang	0
傀儡蛊	kui'lei'gu	0
魁梧男子上衣	kui'wu'nan'zi'shang'yi	0
魁梧男子头饰	kui'wu'nan'zi'tou'shi	0
魁梧男子下衣	kui'wu'nan'zi'xia'yi	0
昆仑	kun'lun	0
昆吾山	kun'wu'shan	0
腊八粥	la'ba'zhou	0
蓝蝶束发	lan'die'shu'fa	0
蓝鲸皮甲	lan'jing'pi'jia	0
岚岳村	lan'yue'cun	0
狼皮装	lang'pi'zhuang	0
狼牙	lang'ya	0
琅琊洞府	lang'ya'dong'fu	0
雷池面具	lei'chi'mian'ju	0
雷动万物	lei'dong'wan'wu	0
雷神	lei'shen	0
力量	li'liang	0
炼丹术	lian'dan'shu	0
练功地图	lian'gong'di'tu	0
莲华心经	lian'hua'xin'jing	0
连环邬	lian'huan'wu	0
连环钻龙枪	lian'huan'zuan'long'qiang	0
炼甲裳	lian'jia'shang	0
炼甲绣装	lian'jia'xiu'zhuang	0
两水洞	liang'shui'dong	0
疗伤方法	liao'shang'fang'fa	0
列山金	lie'shan'jin	0
烈焰刀	lie'yan'dao	0
烈焰剑法	lie'yan'jian'fa	0
烈阳	lie'yang	0
鳞光甲衣	lin'guang'jia'yi	0
灵动山河	ling'dong'shan'he	0
玲珑裳	ling'long'shang	0
玲珑绣装	ling'long'xiu'zhuang	0
灵蛇剑	ling'she'jian	0
灵岩洞	ling'yan'dong	0
灵运裳	ling'yun'shang	0
灵运绣装	ling'yun'xiu'zhuang	0
流光剑法	liu'guang'jian'fa	0
流光绝影箭	liu'guang'jue'ying'jian	0
六棱枪	liu'leng'qiang	0
六气化玉功	liu'qi'hua'yu'gong	0
流水诀	liu'shui'jue	0
柳叶刀	liu'ye'dao	0
流叶刀	liu'ye'dao	0
六指琴魔	liu'zhi'qin'mo	0
龙霸乌金衣	long'ba'wu'jin'yi	0
龙虎洞	long'hu'dong	0
龙口	long'kou	0
龙麟	long'lin	0
龙门镇	long'men'zhen	0
龙皮装	long'pi'zhuang	0
龙泉村	long'quan'cun	0
龙舌	long'she	0
龙眼洞	long'yan'dong	0
龙在天	long'zai'tian	0
六合拳法	lu'he'quan'fa	0
绿林装	lu'lin'zhuang	0
罗汉拳	luo'han'quan	0
罗汉阵	luo'han'zhen	0
落霜剑意	luo'shuang'jian'yi	0
落雁弓	luo'yan'gong	0
绿绮	lv'qi	0
马靖生	ma'jing'sheng	0
买卖物品栏	mai'mai'wu'pin'lan	0
满天花雨	man'tian'hua'yu	0
满月笠	man'yue'li	0
莽牛装	mang'niu'zhuang	0
门派	men'pai	0
门派掌门人	men'pai'zhang'men'ren	0
门派招式	men'pai'zhao'shi	0
门派知识	men'pai'zhi'shi	0
蒙面巾	meng'mian'jin	0
秘籍	mi'ji	0
秘忍面罩	mi'ren'mian'zhao	0
秘神冠	mi'shen'guan	0
迷心飘香曲	mi'xin'piao'xiang'qu	0
秘隐装	mi'yin'zhuang	0
密云衫	mi'yun'shan	0
免费区	mian'fei'qu	0
妙手诀	miao'shou'jue	0
灭焰弓	mie'yan'gong	0
冥蝶发结	ming'die'fa'jie	0
明光甲衣	ming'guang'jia'yi	0
名匠鲁妙子	ming'jiang'lu'miao'zi	0
命中	ming'zhong	0
木齿束发	mu'chi'shu'fa	0
穆桂英	mu'gui'ying	0
木系初级剑法	mu'xi'chu'ji'jian'fa	0
木系高级剑法	mu'xi'gao'ji'jian'fa	0
木系中级剑意	mu'xi'zhong'ji'jian'yi	0
暮雪山庄	mu'xue'shan'zhuang	0
木栅	mu'zha	0
耐久	nai'jiu	0
南槐谷	nan'huai'gu	0
难民	nan'min	0
内防	nei'fang	0
内功	nei'gong	0
内攻	nei'gong	0
内功防御力	nei'gong'fang'yu'li	0
内力	nei'li	0
内装	nei'zhuang	0
泥犁地狱	ni'li'di'yu	0
泥鳅功	ni'qiu'gong	0
霓裳羽衣	ni'shang'yu'yi	0
逆云斗衣	ni'yun'dou'yi	0
牛皮头巾	niu'pi'tou'jin	0
农田	nong'tian	0
怒龙	nu'long	0
女杰裳	nv'jie'shang	0
欧陆忘机	ou'lu'wang'ji	0
判官笔	pan'guan'bi	0
蟠龙绣	pan'long'xiu	0
磐石发结	pan'shi'fa'jie	0
配备	pei'bei	0
配方获取	pei'fang'huo'qu	0
烹饪	peng'ren	0
批量购买	pi'liang'gou'mai	0
批量卖出	pi'liang'mai'chu	0
辟水笠	pi'shui'li	0
破军	po'jun	0
破灭神针	po'mie'shen'zhen	0
破魔咒	po'mo'zhou	0
破山刀	po'shan'dao	0
破天戟	po'tian'ji	0
破阵	po'zhen	0
普渡棍	pu'du'gun	0
普渡杖	pu'du'zhang	0
普济众生	pu'ji'zhong'sheng	0
普通攻击	pu'tong'gong'ji	0
七宝神照心法	qi'bao'shen'zhao'xin'fa	0
绮罗裳	qi'luo'shang	0
绮罗绣装	qi'luo'xiu'zhuang	0
齐眉棍	qi'mei'gun	0
奇门兵器锻造	qi'men'bing'qi'duan'zao	0
七煞天罗	qi'sha'tian'luo	0
其它地图	qi'ta'di'tu	0
乞天讨地	qi'tian'tao'di	0
七星洞	qi'xing'dong	0
七星诀	qi'xing'jue	0
七星透骨针	qi'xing'tou'gu'zhen	0
浅草绣装	qian'cao'xiu'zhuang	0
前尘往事	qian'chen'wang'shi	0
千机束额	qian'ji'shu'e	0
千斤闸	qian'jin'zha	0
乾坤诀	qian'kun'jue	0
潜龙棍	qian'long'gun	0
潜能	qian'neng	0
千忍秘装	qian'ren'mi'zhuang	0
千寻塔	qian'xun'ta	0
乔木林	qiao'mu'lin	0
亲人	qin'ren	0
秦始皇陵	qin'shi'huang'ling	0
青城山	qing'cheng'shan	0
轻甲装	qing'jia'zhuang	0
青蓝发带	qing'lan'fa'dai	0
青莲居士	qing'lian'ju'shi	0
青灵裳	qing'ling'shang	0
青龙棍	qing'long'gun	0
青冥剑	qing'ming'jian	0
青纱眼罩	qing'sha'yan'zhao	0
青霜	qing'shuang	0
青霜袍	qing'shuang'pao	0
青霜装	qing'shuang'zhuang	0
青水村	qing'shui'cun	0
青藤弓	qing'teng'gong	0
青铜发结	qing'tong'fa'jie	0
清溪洞	qing'xi'dong	0
清音洞	qing'yin'dong	0
清音梵唱	qing'yin'fan'chang	0
青云装	qing'yun'zhuang	0
秋毫明查	qiu'hao'ming'cha	0
虬髯客衣	qiu'ran'ke'yi	0
驱蛇棍法	qu'she'gun'fa	0
曲艺精通	qu'yi'jing'tong	0
泉州	quan'zhou	0
泉州俯北	quan'zhou'fu'bei	0
泉州俯西	quan'zhou'fu'xi	0
燃木刀法	ran'mu'dao'fa	0
人际交流	ren'ji'jiao'liu	0
人屠刀	ren'tu'dao	0
日冕	ri'mian	0
柔钢装	rou'gang'zhuang	0
柔云剑法	rou'yun'jian'fa	0
如来神掌	ru'lai'shen'zhang	0
入门技能	ru'men'ji'neng	0
入门迷宫	ru'men'mi'gong	0
入门武功	ru'men'wu'gong	0
入门心法	ru'men'xin'fa	0
如意装	ru'yi'zhuang	0
软金衣	ruan'jin'yi	0
弱水笠	ruo'shui'li	0
塞北西陵大草原	sai'bei'xi'ling'da'cao'yuan	0
三宝杖	san'bao'zhang	0
散花	san'hua	0
三阳手	san'yang'shou	0
杀劫装	sha'jie'zhuang	0
沙漠迷宫	sha'mo'mi'gong	0
闪避	shan'bi	0
山洞地图	shan'dong'di'tu	0
山鬼面具	shan'gui'mian'ju	0
山鬼血衣	shan'gui'xue'yi	0
珊瑚簪	shan'hu'zan	0
山间索桥	shan'jian'suo'qiao	0
山门	shan'men	0
上发冠	shang'fa'guan	0
伤狼衣	shang'lang'yi	0
上清无极功	shang'qing'wu'ji'gong	0
上线	shang'xian	0
上衣	shang'yi	0
烧酒	shao'jiu	0
少林	shao'lin	0
少林禅僧	shao'lin'chan'seng	0
少林禅僧武功	shao'lin'chan'seng'wu'gong	0
少林禅圆功	shao'lin'chan'yuan'gong	0
少林禅宗	shao'lin'chan'zong	0
少林初级禅功	shao'lin'chu'ji'chan'gong	0
少林刀法	shao'lin'dao'fa	0
少林刀系基本功法	shao'lin'dao'xi'ji'ben'gong'fa	0
少林独门心法	shao'lin'du'men'xin'fa	0
少林高级禅功	shao'lin'gao'ji'chan'gong	0
少林高级拳术	shao'lin'gao'ji'quan'shu	0
少林高级腿法	shao'lin'gao'ji'tui'fa	0
少林高级心法	shao'lin'gao'ji'xin'fa	0
少林棍法	shao'lin'gun'fa	0
少林棍系基本功法	shao'lin'gun'xi'ji'ben'gong'fa	0
少林基本禅功	shao'lin'ji'ben'chan'gong	0
少林基本刀术	shao'lin'ji'ben'dao'shu	0
少林基本棍术	shao'lin'ji'ben'gun'shu	0
少林基本拳法	shao'lin'ji'ben'quan'fa	0
少林基本腿法	shao'lin'ji'ben'tui'fa	0
少林进阶禅功	shao'lin'jin'jie'chan'gong	0
少林进阶刀术	shao'lin'jin'jie'dao'shu	0
少林进阶棍术	shao'lin'jin'jie'gun'shu	0
少林进阶拳法	shao'lin'jin'jie'quan'fa	0
少林进阶腿法	shao'lin'jin'jie'tui'fa	0
少林绝技	shao'lin'jue'ji	0
少林龙爪手	shao'lin'long'zhua'shou	0
少林罗汉功	shao'lin'luo'han'gong	0
少林秘传阵法	shao'lin'mi'chuan'zhen'fa	0
少林密室	shao'lin'mi'shi	0
少林派	shao'lin'pai	0
少林派入门任务	shao'lin'pai'ru'men'ren'wu	0
少林七十二绝技	shao'lin'qi'shi'er'jue'ji	0
少林俗家	shao'lin'su'jia	0
少林俗家弟子	shao'lin'su'jia'di'zi	0
少林俗家武功	shao'lin'su'jia'wu'gong	0
少林外家秘招	shao'lin'wai'jia'mi'zhao	0
少林武僧	shao'lin'wu'seng	0
少林武僧基本心法	shao'lin'wu'seng'ji'ben'xin'fa	0
少林武僧入门心法	shao'lin'wu'seng'ru'men'xin'fa	0
少林武僧武功	shao'lin'wu'seng'wu'gong	0
少林武宗	shao'lin'wu'zong	0
少林修心法	shao'lin'xiu'xin'fa	0
少阳诀	shao'yang'jue	0
舍身诀	she'shen'jue	0
佘太君	she'tai'jun	0
神兵初现	shen'bing'chu'xian	0
神策金甲	shen'ce'jin'jia	0
神策金盔	shen'ce'jin'kui	0
神策装	shen'ce'zhuang	0
身法	shen'fa	0
神力	shen'li	0
神门十三剑	shen'men'shi'san'jian	0
神木发带	shen'mu'fa'dai	0
神牛护甲	shen'niu'hu'jia	0
神农丹	shen'nong'dan	0
神女	shen'nv	0
神乌	shen'wu	0
神行服	shen'xing'fu	0
生活地图	sheng'huo'di'tu	0
生活技能	sheng'huo'ji'neng	0
生命	sheng'ming	0
盛世江山	sheng'shi'jiang'shan	0
声望	sheng'wang	0
尸毒术	shi'du'shu	0
尸蛊	shi'gu	0
嗜魂笔	shi'hun'bi	0
试炼果	shi'lian'guo	0
尸裂魔功	shi'lie'mo'gong	0
狮蛮绣装	shi'man'xiu'zhuang	0
石门洞	shi'men'dong	0
饰品二	shi'pin'er	0
饰品一	shi'pin'yi	0
狮子吼	shi'zi'hou	0
收费区	shou'fei'qu	0
收耕	shou'geng	0
兽头护肩	shou'tou'hu'jian	0
兽王斗衣	shou'wang'dou'yi	0
蜀道	shu'dao	0
蜀中唐门	shu'zhong'tang'men	0
水火棍	shui'huo'gun	0
水泊梁山	shui'po'liang'shan	0
水系初级剑法	shui'xi'chu'ji'jian'fa	0
水系高级剑法	shui'xi'gao'ji'jian'fa	0
水系中级剑意	shui'xi'zhong'ji'jian'yi	0
司马相如	si'ma'xiang'ru	0
四平棍	si'ping'gun	0
宋金	song'jin	0
松纹剑	song'wen'jian	0
送信	song'xin	0
宋元安	song'yuan'an	0
随意曲	sui'yi'qu	0
锁喉擒拿手	suo'hou'qin'na'shou	0
锁命针	suo'ming'zhen	0
太白金丹	tai'bai'jin'dan	0
太极神功	tai'ji'shen'gong	0
太清	tai'qing	0
太清剑气	tai'qing'jian'qi	0
太乙三清剑	tai'yi'san'qing'jian	0
太乙逍遥功	tai'yi'xiao'yao'gong	0
贪狼衣	tan'lang'yi	0
唐春	tang'chun	0
唐门	tang'men	0
唐门暗器	tang'men'an'qi	0
唐门初级技能	tang'men'chu'ji'ji'neng	0
唐门初级秘技	tang'men'chu'ji'mi'ji	0
唐门初级陷阱	tang'men'chu'ji'xian'jing	0
唐门高级暗器术	tang'men'gao'ji'an'qi'shu	0
唐门高级陷阱	tang'men'gao'ji'xian'jing	0
唐门高级心法	tang'men'gao'ji'xin'fa	0
唐门基本暗器术	tang'men'ji'ben'an'qi'shu	0
唐门基本秘技	tang'men'ji'ben'mi'ji	0
唐门姥姥	tang'men'lao'lao	0
唐门入门任务	tang'men'ru'men'ren'wu	0
唐门入门心法	tang'men'ru'men'xin'fa	0
唐门侠客	tang'men'xia'ke	0
唐门心法	tang'men'xin'fa	0
唐天啸	tang'tian'xiao	0
唐云	tang'yun	0
桃花岛	tao'hua'dao	0
桃木发簪	tao'mu'fa'zan	0
桃木簪	tao'mu'zan	0
特殊任务	te'shu'ren'wu	0
腾蛇发簪	teng'she'fa'zan	0
提出队伍	ti'chu'dui'wu	0
体力	ti'li	0
梯云纵	ti'yun'zong	0
天波杨府	tian'bo'yang'fu	0
天蚕甲衣	tian'can'jia'yi	0
天蚕绣装	tian'can'xiu'zhuang	0
天风束额	tian'feng'shu'e	0
天风装	tian'feng'zhuang	0
天佛杖	tian'fo'zhang	0
天罡装	tian'gang'zhuang	0
天工斗衣	tian'gong'dou'yi	0
天机	tian'ji	0
天机老人	tian'ji'lao'ren	0
添加物	tian'jia'wu	0
天绛袍	tian'jiang'pao	0
天狼衣	tian'lang'yi	0
天狼装	tian'lang'zhuang	0
天雷装	tian'lei'zhuang	0
天罗钗	tian'luo'chai	0
天马	tian'ma	0
天马帮	tian'ma'bang	0
天门阵	tian'men'zhen	0
天魔裳	tian'mo'shang	0
天牛手	tian'niu'shou	0
天清纯阳剑	tian'qing'chun'yang'jian	0
天煞	tian'sha	0
天蛇棍	tian'she'gun	0
天师洞	tian'shi'dong	0
天师秘境	tian'shi'mi'jing	0
天外飞仙	tian'wai'fei'xian	0
天行气功	tian'xing'qi'gong	0
天涯海角	tian'ya'hai'jiao	0
天衣	tian'yi	0
天音镇魂曲	tian'yin'zhen'hun'qu	0
铁护肩	tie'hu'jian	0
铁匠铺	tie'jiang'pu	0
铁枪	tie'qiang	0
铁锹	tie'qiao	0
铁线笠	tie'xian'li	0
通臂拳	tong'bi'quan	0
桐梓合精	tong'zi'he'jing	0
透骨枪	tou'gu'qiang	0
偷龙转凤	tou'long'zhuan'feng	0
偷天换日	tou'tian'huan'ri	0
土狼牙	tu'lang'ya	0
土系初级剑法	tu'xi'chu'ji'jian'fa	0
土系高级剑法	tu'xi'gao'ji'jian'fa	0
土系中级剑意	tu'xi'zhong'ji'jian'yi	0
退出游戏	tui'chu'you'xi	0
挖矿	wa'kuang	0
外防	wai'fang	0
外攻	wai'gong	0
外功防御力	wai'gong'fang'yu'li	0
外装	wai'zhuang	0
外装发冠	wai'zhuang'fa'guan	0
外装上衣	wai'zhuang'shang'yi	0
外装下衣	wai'zhuang'xia'yi	0
万毒夺命刀	wan'du'duo'ming'dao	0
万毒心法	wan'du'xin'fa	0
万蛊蚀天	wan'gu'shi'tian	0
万相神功	wan'xiang'shen'gong	0
王母洞	wang'mu'dong	0
王旗部落	wang'qi'bu'luo	0
望月心法	wang'yue'xin'fa	0
韦陀拳	wei'tuo'quan	0
未央剑法	wei'yang'jian'fa	0
文殊出云腿	wen'shu'chu'yun'tui	0
窝头	wo'tou	0
五彩霓裳	wu'cai'ni'chang	0
乌蚕装	wu'can'zhuang	0
无常棍法	wu'chang'gun'fa	0
武当	wu'dang	0
武当笔法	wu'dang'bi'fa	0
武当初级笔法	wu'dang'chu'ji'bi'fa	0
武当初级内功	wu'dang'chu'ji'nei'gong	0
武当道家	wu'dang'dao'jia	0
武当道家弟子	wu'dang'dao'jia'di'zi	0
武当道家武功	wu'dang'dao'jia'wu'gong	0
武当顶级笔法	wu'dang'ding'ji'bi'fa	0
武当顶级剑法	wu'dang'ding'ji'jian'fa	0
武当独门轻功	wu'dang'du'men'qing'gong	0
武当独门心法	wu'dang'du'men'xin'fa	0
武当高级笔法	wu'dang'gao'ji'bi'fa	0
武当基本笔法	wu'dang'ji'ben'bi'fa	0
武当基本剑法	wu'dang'ji'ben'jian'fa	0
武当剑法	wu'dang'jian'fa	0
武当剑经	wu'dang'jian'jing	0
武当秘传阵法	wu'dang'mi'chuan'zhen'fa	0
武当派	wu'dang'pai	0
武当派入门任务	wu'dang'pai'ru'men'ren'wu	0
武当奇经	wu'dang'qi'jing	0
武当奇特剑法	wu'dang'qi'te'jian'fa	0
武当神秘笔法	wu'dang'shen'mi'bi'fa	0
武当神秘剑意	wu'dang'shen'mi'jian'yi	0
武当俗家	wu'dang'su'jia	0
武当俗家弟子	wu'dang'su'jia'di'zi	0
武当俗家武功	wu'dang'su'jia'wu'gong	0
武当镇派心法	wu'dang'zhen'pai'xin'fa	0
武当中级笔法	wu'dang'zhong'ji'bi'fa	0
武斗裳	wu'dou'shang	0
五毒刀法	wu'du'dao'fa	0
五毒蛊师	wu'du'gu'shi	0
五毒教	wu'du'jiao	0
五毒派入门任务	wu'du'pai'ru'men'ren'wu	0
五毒邪侠	wu'du'xie'xia	0
五方鬼众	wu'fang'gui'zhong	0
武功	wu'gong	0
武功使用	wu'gong'shi'yong	0
五光石	wu'guang'shi	0
五鬼头巾	wu'gui'tou'jin	0
五虎断门刀	wu'hu'duan'men'dao	0
无回笔	wu'hui'bi	0
五雷亮银甲	wu'lei'liang'yin'jia	0
武炼裳	wu'lian'shang	0
武炼绣装	wu'lian'xiu'zhuang	0
武器	wu'qi	0
武器制造	wu'qi'zhi'zao	0
无上太极剑	wu'shang'tai'ji'jian	0
武神绣装	wu'shen'xiu'zhuang	0
武胜纱帽	wu'sheng'sha'mao	0
无双斗衣	wu'shuang'dou'yi	0
无天魔功	wu'tian'mo'gong	0
无我心法	wu'wo'xin'fa	0
巫咸	wu'xian	0
无相神功	wu'xiang'shen'gong	0
乌夜啼	wu'ye'ti	0
武夷山	wu'yi'shan	0
无影脚	wu'ying'jiao	0
无影魔蛊	wu'ying'mo'gu	0
五转指	wu'zhuan'zhi	0
西北区	xi'bei'qu	0
溪流瀑布	xi'liu'pu'bu	0
西南区	xi'nan'qu	0
洗髓经	xi'sui'jing	0
西图	xi'tu	0
吸星阵	xi'xing'zhen	0
锡杖	xi'zhang	0
下蛊秘方	xia'gu'mi'fang	0
侠少暗器	xia'shao'an'qi	0
侠少布衣	xia'shao'bu'yi	0
侠少布装	xia'shao'bu'zhuang	0
侠少棍	xia'shao'gun	0
侠少护腕	xia'shao'hu'wan	0
侠少剑	xia'shao'jian	0
侠少头带	xia'shao'tou'dai	0
侠少头巾	xia'shao'tou'jin	0
侠少衣	xia'shao'yi	0
侠少装	xia'shao'zhuang	0
下线	xia'xian	0
下衣	xia'yi	0
陷阵绣装	xian'zhen'xiu'zhuang	0
厢房	xiang'fang	0
翔凤	xiang'feng	0
香蛊	xiang'gu	0
降龙十八掌	xiang'long'shi'ba'zhang	0
襄阳	xiang'yang	0
祥云洞	xiang'yun'dong	0
小青狼	xiao'qing'lang	0
小土狼	xiao'tu'lang	0
逍遥游	xiao'yao'you	0
邪毒心法	xie'du'xin'fa	0
邪灵大法	xie'ling'da'fa	0
心蛊	xin'gu	0
信息回复	xin'xi'hui'fu	0
心眼	xin'yan	0
心印裳	xin'yin'shang	0
兴安岭	xing'an'ling	0
性感女子上衣	xing'gan'nv'zi'shang'yi	0
性感女子头饰	xing'gan'nv'zi'tou'shi	0
性感女子下衣	xing'gan'nv'zi'xia'yi	0
杏花村	xing'hua'cun	0
行云束带	xing'yun'shu'dai	0
袖里乾坤	xiu'li'qian'kun	0
修理物品	xiu'li'wu'pin	0
修罗	xiu'luo	0
玄慈	xuan'ci	0
玄电	xuan'dian	0
璇金甲装	xuan'jin'jia'zhuang	0
玄明	xuan'ming	0
玄石	xuan'shi	0
玄铁重剑	xuan'tie'zhong'jian	0
玄武剑阵	xuan'wu'jian'zhen	0
悬星洞	xuan'xing'dong	0
悬崖飞瀑	xuan'ya'fei'pu	0
轩辕谷	xuan'yuan'gu	0
血鼎功	xue'ding'gong	0
血蛊	xue'gu	0
血河鬼王铠	xue'he'gui'wang'kai	0
血河装	xue'he'zhuang	0
血杀剑	xue'sha'jian	0
雁门关	yan'men'guan	0
雁门关之战	yan'men'guan'zhi'zhan	0
掩心甲	yan'xin'jia	0
燕子洞	yan'zi'dong	0
养蛊秘术	yang'gu'mi'shu	0
阳关三叠	yang'guan'san'die	0
杨家奔狼枪	yang'jia'ben'lang'qiang	0
杨家缠云箭	yang'jia'chan'yun'jian	0
杨家倒海枪	yang'jia'dao'hai'qiang	0
杨家弓法总决	yang'jia'gong'fa'zong'jue	0
杨家弓心法	yang'jia'gong'xin'fa	0
杨家幻神诀	yang'jia'huan'shen'jue	0
杨家回龙箭	yang'jia'hui'long'jian	0
杨家连射术	yang'jia'lian'she'shu	0
杨家破风枪	yang'jia'po'feng'qiang	0
杨家奇门盾	yang'jia'qi'men'dun	0
杨家枪法总决	yang'jia'qiang'fa'zong'jue	0
杨家枪心法	yang'jia'qiang'xin'fa	0
杨家巧战诀	yang'jia'qiao'zhan'jue	0
杨家碎金箭	yang'jia'sui'jin'jian	0
杨家天衡枪	yang'jia'tian'heng'qiang	0
杨家续命诀	yang'jia'xu'ming'jue	0
杨家英雄气	yang'jia'ying'xiong'qi	0
杨家驭马术	yang'jia'yu'ma'shu	0
杨家御马术	yang'jia'yu'ma'shu	0
杨家战定诀	yang'jia'zhan'ding'jue	0
杨家阵疗术	yang'jia'zhen'liao'shu	0
杨家正气箭	yang'jia'zheng'qi'jian	0
杨门初级弓法	yang'men'chu'ji'gong'fa	0
杨门初级技能	yang'men'chu'ji'ji'neng	0
杨门初级马术	yang'men'chu'ji'ma'shu	0
杨门初级枪法	yang'men'chu'ji'qiang'fa	0
杨门高级弓法	yang'men'gao'ji'gong'fa	0
杨门高级马术	yang'men'gao'ji'ma'shu	0
杨门高级枪法	yang'men'gao'ji'qiang'fa	0
杨门高级心法	yang'men'gao'ji'xin'fa	0
杨门弓骑	yang'men'gong'qi	0
杨门弓骑兵基本心法	yang'men'gong'qi'bing'ji'ben'xin'fa	0
杨门弓骑武功	yang'men'gong'qi'wu'gong	0
杨门基本弓法	yang'men'ji'ben'gong'fa	0
杨门基本枪法	yang'men'ji'ben'qiang'fa	0
杨门枪骑	yang'men'qiang'qi	0
杨门枪骑兵基本心法	yang'men'qiang'qi'bing'ji'ben'xin'fa	0
杨门枪骑武功	yang'men'qiang'qi'wu'gong	0
杨门入门任务	yang'men'ru'men'ren'wu	0
杨门镇派枪法	yang'men'zhen'pai'qiang'fa	0
杨门中级弓法	yang'men'zhong'ji'gong'fa	0
杨门中级技能	yang'men'zhong'ji'ji'neng	0
杨门中级马术	yang'men'zhong'ji'ma'shu	0
杨门中级枪法	yang'men'zhong'ji'qiang'fa	0
杨门中级心法	yang'men'zhong'ji'xin'fa	0
阳中洞	yang'zhong'dong	0
扬州	yang'zhou	0
杨宗保	yang'zong'bao	0
妖蛊	yao'gu	0
瑶光	yao'guang	0
药品	yao'pin	0
药铺	yao'pu	0
药王洞	yao'wang'dong	0
药王谷	yao'wang'gu	0
野外	ye'wai	0
野外流氓	ye'wai'liu'mang	0
野外无赖	ye'wai'wu'lai	0
夜行装	ye'xing'zhuang	0
野猪林	ye'zhu'lin	0
衣服织造	yi'fu'zhi'zao	0
易筋经	yi'jin'jing	0
异神头巾	yi'shen'tou'jin	0
逸隐冠	yi'yin'guan	0
隐藏周围玩家	yin'cang'zhou'wei'wan'jia	0
引魂灯	yin'hun'deng	0
银铃簪	yin'ling'zan	0
银蛇枪	yin'she'qiang	0
隐身登陆	yin'shen'deng'lu	0
因陀罗雷印破	yin'tuo'luo'lei'yin'po	0
音效	yin'xiao	0
阴邪吸魂气	yin'xie'xi'hun'qi	0
音乐	yin'yue	0
盈民村	ying'min'cun	0
英雄巾	ying'xiong'jin	0
尤榕	you'rong	0
游戏社区	you'xi'she'qu	0
游戏网站	you'xi'wang'zhan	0
游侠装	you'xia'zhuang	0
尤知味	you'zhi'wei	0
羽裳	yu'chang	0
玉蜂针	yu'feng'zhen	0
御剑诀	yu'jian'jue	0
雨铃	yu'ling	0
玉女剑法	yu'nv'jian'fa	0
玉女心经	yu'nv'xin'jing	0
驭尸术	yu'shi'shu	0
余音绕梁功	yu'yin'rao'liang'gong	0
玉韵琴	yu'yun'qin	0
远足装	yuan'zu'zhuang	0
月轮杖	yue'lun'zhang	0
月蚀曲	yue'shi'qu	0
云梦钗	yun'meng'chai	0
云梦泽	yun'meng'ze	0
云霞绣装	yun'xia'xiu'zhuang	0
允许交易	yun'xu'jiao'yi	0
允许组队	yun'xu'zu'dui	0
杂货铺	za'huo'pu	0
錾银护腕	zan'yin'hu'wan	0
藏红花	zang'hong'hua	0
战场地图	zhan'chang'di'tu	0
战斗操作	zhan'dou'cao'zuo	0
战斗指引	zhan'dou'zhi'yin	0
斩金断玉	zhan'jin'duan'yu	0
斩魔刀法	zhan'mo'dao'fa	0
丈八蛇矛	zhang'ba'she'mao	0
张午阳	zhang'wu'yang	0
赵普	zhao'pu	0
折冲笔	zhe'chong'bi	0
折铁刀	zhe'tie'dao	0
镇派技能	zhen'pai'ji'neng	0
镇派武功	zhen'pai'wu'gong	0
真如师太	zhen'ru'shi'tai	0
真武七截剑	zhen'wu'qi'jie'jian	0
正两仪剑法	zheng'liang'yi'jian'fa	0
制符	zhi'fu	0
制皮	zhi'pi	0
智仁大师	zhi'ren'da'shi	0
炙阳剑气	zhi'yang'jian'qi	0
中级武功	zhong'ji'wu'gong	0
钟馗面具	zhong'kui'mian'ju	0
重量	zhong'liang	0
中原区	zhong'yuan'qu	0
周善人	zhou'shan'ren	0
铸匠大师孙岩	zhu'jiang'da'shi'sun'yan	0
竹木弓	zhu'mu'gong	0
朱雀	zhu'que	0
朱雀发结	zhu'que'fa'jie	0
朱雀束带	zhu'que'shu'dai	0
竹丝洞	zhu'si'dong	0
逐月弓	zhu'yue'gong	0
装备信息	zhuang'bei'xin'xi	0
追魂夺命	zhui'hun'duo'ming	0
追魂枪	zhui'hun'qiang	0
追心箭	zhui'xin'jian	0
追月笔	zhui'yue'bi	0
紫鹤真人	zi'he'zhen'ren	0
紫金	zi'jin	0
紫衿布衣	zi'jin'bu'yi	0
紫金丹	zi'jin'dan	0
紫金链甲	zi'jin'lian'jia	0
紫金梁	zi'jin'liang	0
紫劲衫	zi'jin'shan	0
紫禁之巅	zi'jin'zhi'dian	0
紫菱裳	zi'ling'shang	0
子母离魂箭	zi'mu'li'hun'jian	0
紫青霜华衫	zi'qing'shuang'hua'shan	0
紫绒裳	zi'rong'shang	0
紫桑山	zi'sang'shan	0
紫霞绣装	zi'xia'xiu'zhuang	0
紫竹林	zi'zhu'lin	0
组队打怪	zu'dui'da'guai	0
醉蝶	zui'die	0
