病案科	bing'an'ke	0
病理科	bing'li'ke	0
产科	chan'ke	0
超声科	chao'sheng'ke	0
车辆管理科	che'liang'guan'li'ke	0
创伤科	chuang'shang'ke	0
档案科	dang'an'ke	0
党委门诊部	dang'wei'men'zhen'bu	0
动力运营管理科	dong'li'yun'ying'guan'li'ke	0
耳鼻喉科	er'bi'hou'ke	0
放疗科	fang'liao'ke	0
放射介入诊疗科	fang'she'jie'ru'zhen'liao'ke	0
腹部创伤外科	fu'bu'chuang'shang'wai'ke	0
妇产科	fu'chan'ke	0
妇科	fu'ke	0
干部保健中心	gan'bu'bao'jian'zhong'xin	0
肝胆血管外科	gan'dan'xue'guan'wai'ke	0
肛肠外科	gang'chang'wai'ke	0
高血压诊疗研究中心	gao'xue'ya'zhen'liao'yan'jiu'zhong'xin	0
高压氧科	gao'ya'yang'ke	0
骨科中心	gu'ke'zhong'xin	0
护理部	hu'li'bu	0
呼吸内科	hu'xi'nei'ke	0
基础医学教育科	ji'chu'yi'xue'jiao'yu'ke	0
急救中心	ji'jiu'zhong'xin	0
继续教育科	ji'xu'jiao'yu'ke	0
甲状腺科	jia'zhuang'xian'ke	0
检查审计部	jian'cha'shen'ji'bu	0
康复科	kang'fu'ke	0
科教科	ke'jiao'ke	0
科研教育中心	ke'yan'jiao'yu'zhong'xin	0
科研科	ke'yan'ke	0
口腔外科	kou'qiang'wai'ke	0
临床心理科	lin'chuang'xin'li'ke	0
临床药学研究所	lin'chuang'yao'xue'yan'jiu'suo	0
临床医学研究中心	lin'chuang'yi'xue'yan'jiu'zhong'xin	0
临床营养研究所	lin'chuang'ying'yang'yan'jiu'suo	0
轮转生	lun'zhuan'sheng	0
麻醉科	ma'zui'ke	0
门诊部	men'zhen'bu	0
门诊收费科	men'zhen'shou'fei'ke	0
泌尿中心	mi'niao'zhong'xin	0
秘书科	mi'shu'ke	0
内分泌科	nei'fen'mi'ke	0
内科科室	nei'ke'ke'shi	0
皮肤性病科	pi'fu'xing'bing'ke	0
全科医疗科	quan'ke'yi'liao'ke	0
乳腺科	ru'xian'ke	0
膳食营养科	shan'shi'ying'yang'ke	0
烧伤科	shao'shang'ke	0
社工科	she'gong'ke	0
肾病科	shen'bing'ke	0
审计科	shen'ji'ke	0
神经内科	shen'jing'nei'ke	0
神经外科	shen'jing'wai'ke	0
生活服务科	sheng'huo'fu'wu'ke	0
输血科	shu'xue'ke	0
疼痛科	teng'tong'ke	0
外科科室	wai'ke'ke'shi	0
外事接待科	wai'shi'jie'dai'ke	0
网络弱电管理科	wang'luo'ruo'dian'guan'li'ke	0
胃肠外科	wei'chang'wai'ke	0
物价管理科	wu'jia'guan'li'ke	0
小儿外科	xiao'er'wai'ke	0
消化科	xiao'hua'ke	0
心电学科	xin'dian'xue'ke	0
信访科	xin'fang'ke	0
新生儿科	xin'sheng'er'ke	0
心外科	xin'wai'ke	0
信息系统管理科	xin'xi'xi'tong'guan'li'ke	0
心血管内科	xin'xue'guan'nei'ke	0
行政科室	xing'zheng'ke'shi	0
胸外科	xiong'wai'ke	0
眼科	yan'ke	0
药品采购供应科	yao'pin'cai'gou'gong'ying'ke	0
药学部	yao'xue'bu	0
医保科	yi'bao'ke	0
医疗信息统计科	yi'liao'xin'xi'tong'ji'ke	0
医疗质量控制科	yi'liao'zhi'liang'kong'zhi'ke	0
医务部	yi'wu'bu	0
胰腺外科	yi'xian'wai'ke	0
医院办公室	yi'yuan'ban'gong'shi	0
医政科	yi'zheng'ke	0
预防保健科	yu'fang'bao'jian'ke	0
院感科	yuan'gan'ke	0
招标管理办公室	zhao'biao'guan'li'ban'gong'shi	0
整形外科	zheng'xing'wai'ke	0
肿瘤科	zhong'liu'ke	0
重症医学科	zhong'zheng'yi'xue'ke	0
专科医师培训基地	zhuan'ke'yi'shi'pei'xun'ji'di	0
资产管理科	zi'chan'guan'li'ke	0
综合管理科	zong'he'guan'li'ke	0
