阿飞的小蝴蝶	a'fei'de'xiao'hu'die	0
爱的海市蜃楼忘了吧	ai'de'hai'shi'shen'lou'wang'le'ba	0
爱的警告	ai'de'jing'gao	0
爱没有聪不聪明	ai'mei'you'cong'bu'cong'ming	0
爱情来不及变老	ai'qing'lai'bu'ji'bian'lao	0
爱情有点甜	ai'qing'you'dian'tian	0
爱上你的微笑	ai'shang'ni'de'wei'xiao	0
爱像星际里传说难以预料的结果	ai'xiang'xing'ji'li'chuan'shuo'nan'yi'yu'liao'de'jie'guo	0
爱笑的眼睛	ai'xiao'de'yan'jing	0
爱要精心来雕刻	ai'yao'jing'xin'lai'diao'ke	0
爱一次梦一场思念最遥遥无期	ai'yi'ci'meng'yi'chang'si'nian'zui'yao'yao'wu'qi	0
爱一个人的纯粹	ai'yi'ge'ren'de'chun'cui	0
爱一个人希望他过更好	ai'yi'ge'ren'xi'wang'ta'guo'geng'hao	0
把烦恼都变成气泡	ba'fan'nao'dou'bian'cheng'qi'pao	0
把眼泪装在心上	ba'yan'lei'zhuang'zai'xin'shang	0
被打散的巢	bei'da'san'de'chao	0
背对背拥抱	bei'dui'bei'yong'bao	0
被利用的信任	bei'li'yong'de'xin'ren	0
悲伤一发	bei'shang'yi'fa	0
被时间捉弄了	bei'shi'jian'zhuo'nong'le	0
被我猜透	bei'wo'cai'tou	0
笨拙系上红色领带的结	ben'zhuo'ji'shang'hong'se'ling'dai'de'jie	0
闭上眼睛闻到一种芬芳	bi'shang'yan'jing'wen'dao'yi'zhong'fen'fang	0
毕业和成年的字眼	bi'ye'he'cheng'nian'de'zi'yan	0
表示从一楼到四楼的距离	biao'shi'cong'yi'lou'dao'si'lou'de'ju'li	0
别人猜不到	bie'ren'cai'bu'dao	0
不该太多考虑	bu'gai'tai'duo'kao'lv	0
不该在原地徘徊	bu'gai'zai'yuan'di'pai'huai	0
不管成功或失败一直陪着我	bu'guan'cheng'gong'huo'shi'bai'yi'zhi'pei'zhe'wo	0
不管风雨	bu'guan'feng'yu	0
不管同样的是非	bu'guan'tong'yang'de'shi'fei	0
不管有风有雨	bu'guan'you'feng'you'yu	0
不过一季的时间	bu'guo'yi'ji'de'shi'jian	0
不浪费你的爱你的美	bu'lang'fei'ni'de'ai'ni'de'mei	0
布满在你的床沿	bu'man'zai'ni'de'chuang'yan	0
不怕岁月的冲刷	bu'pa'sui'yue'de'chong'shua	0
不情愿不想见你离开我的瞬间	bu'qing'yuan'bu'xiang'jian'ni'li'kai'wo'de'shun'jian	0
不希望自己变得太成熟	bu'xi'wang'zi'ji'bian'de'tai'cheng'shu	0
不像你不藏秘密	bu'xiang'ni'bu'cang'mi'mi	0
不需要勉强虚伪	bu'xu'yao'mian'qiang'xu'wei	0
不要求回报	bu'yao'qiu'hui'bao	0
不要我的心随着大厅的钟摆	bu'yao'wo'de'xin'sui'zhe'da'ting'de'zhong'bai	0
不再留恋	bu'zai'liu'lian	0
不知道你还愿意吗	bu'zhi'dao'ni'hai'yuan'yi'ma	0
才发现从前是我太天真	cai'fa'xian'cong'qian'shi'wo'tai'tian'zhen	0
才发现你是最无法代替的	cai'fa'xian'ni'shi'zui'wu'fa'dai'ti'de	0
才能安心的说再见	cai'neng'an'xin'de'shuo'zai'jian	0
才能够算到过了天堂	cai'neng'gou'suan'dao'guo'le'tian'tang	0
才走得到远方	cai'zou'de'dao'yuan'fang	0
残存过去让它风化	can'cun'guo'qu'rang'ta'feng'hua	0
藏着童话的影子	cang'zhe'tong'hua'de'ying'zi	0
曾经抵死纠缠放空的手	ceng'jing'di'si'jiu'chan'fang'kong'de'shou	0
曾经想征服全世界	ceng'jing'xiang'zheng'fu'quan'shi'jie	0
曾经志在四方少年	ceng'jing'zhi'zai'si'fang'shao'nian	0
乘不同的列车	cheng'bu'tong'de'lie'che	0
成人的谎言太多	cheng'ren'de'huang'yan'tai'duo	0
成熟点别拉扯	cheng'shu'dian'bie'la'che	0
丑八怪	chou'ba'guai	0
出口	chu'kou	0
出没在漆黑一片的舞台	chu'mo'zai'qi'hei'yi'pian'de'wu'tai	0
穿过风又绕个弯	chuan'guo'feng'you'rao'ge'wan	0
穿上一身帅气西装	chuan'shang'yi'shen'shuai'qi'xi'zhuang	0
窗台外的衣服有没有人来收	chuang'tai'wai'de'yi'fu'you'mei'you'ren'lai'shou	0
吹啊吹啊我赤脚不害怕	chui'a'chui'a'wo'chi'jiao'bu'hai'pa	0
吹啊吹啊我的骄傲放纵	chui'a'chui'a'wo'de'jiao'ao'fang'zong	0
吹啊吹啊无所谓扰乱我	chui'a'chui'a'wu'suo'wei'rao'luan'wo	0
吹啊吹不毁我纯净花园	chui'a'chui'bu'hui'wo'chun'jing'hua'yuan	0
从此我不再撒野	cong'ci'wo'bu'zai'sa'ye	0
从此以后你就住进了我的心房	cong'ci'yi'hou'ni'jiu'zhu'jin'le'wo'de'xin'fang	0
匆匆渐行渐远	cong'cong'jian'xing'jian'yuan	0
从来都很低调	cong'lai'dou'hen'di'diao	0
答案都揭晓	da'an'dou'jie'xiao	0
打从心里暖暖的	da'cong'xin'li'nuan'nuan'de	0
搭配爱情的美妙只有我们知道	da'pei'ai'qing'de'mei'miao'zhi'you'wo'men'zhi'dao	0
呆呆地站在镜子前	dai'dai'di'zhan'zai'jing'zi'qian	0
但你不肯觉醒	dan'ni'bu'ken'jue'xing	0
但其实我明白	dan'qi'shi'wo'ming'bai	0
但这是我的选择	dan'zhe'shi'wo'de'xuan'ze	0
当缠绕爱情的帷幕落下了	dang'chan'rao'ai'qing'de'wei'mu'luo'xia'le	0
当初的愿望实现了吗	dang'chu'de'yuan'wang'shi'xian'le'ma	0
当失望逐渐将一切都掩埋	dang'shi'wang'zhu'jian'jiang'yi'qie'dou'yan'mai	0
当我唱起这首歌	dang'wo'chang'qi'zhe'shou'ge	0
当欲望开始贪杯有更多机会	dang'yu'wang'kai'shi'tan'bei'you'geng'duo'ji'hui	0
到底我该如何表达	dao'di'wo'gai'ru'he'biao'da	0
倒数一秒放下	dao'shu'yi'miao'fang'xia	0
到最后回首才发现	dao'zui'hou'hui'shou'cai'fa'xian	0
等会儿见你一定比想像美	deng'hui'er'jian'ni'yi'ding'bi'xiang'xiang'mei	0
掉进回忆的流年	diao'jin'hui'yi'de'liu'nian	0
冬天也仿佛	dong'tian'ye'fang'fu	0
都可以是真的	dou'ke'yi'shi'zhen'de	0
都可以随便的	dou'ke'yi'sui'bian'de	0
独自浪在中国外国不同地点	du'zi'lang'zai'zhong'guo'wai'guo'bu'tong'di'dian	0
对不对	dui'bu'dui	0
多少离合悲欢	duo'shao'li'he'bei'huan	0
多一点新鲜	duo'yi'dian'xin'xian	0
发现突然间触碰你指尖	fa'xian'tu'ran'jian'chu'peng'ni'zhi'jian	0
发现我还在你的世界	fa'xian'wo'hai'zai'ni'de'shi'jie	0
放不下	fang'bu'xia	0
仿佛继续闭着双眼	fang'fu'ji'xu'bi'zhe'shuang'yan	0
放纵我心里的鬼	fang'zong'wo'xin'li'de'gui	0
分享热汤	fen'xiang're'tang	0
风花雪月颜容	feng'hua'xue'yue'yan'rong	0
风决定要走	feng'jue'ding'yao'zou	0
风替我咆哮	feng'ti'wo'pao'xiao	0
覆水总难收	fu'shui'zong'nan'shou	0
改变了我们模样	gai'bian'le'wo'men'mu'yang	0
该来得躲不掉	gai'lai'de'duo'bu'diao	0
该要飞往哪去	gai'yao'fei'wang'na'qu	0
该怎么明了	gai'zen'me'ming'liao	0
敢不敢念来听听啊	gan'bu'gan'nian'lai'ting'ting'a	0
感觉你心跳	gan'jue'ni'xin'tiao	0
告别青涩和无知	gao'bie'qing'se'he'wu'zhi	0
格外扣人心弦	ge'wai'kou'ren'xin'xian	0
歌谣的歌谣	ge'yao'de'ge'yao	0
各种季风洋流都搞不懂	ge'zhong'ji'feng'yang'liu'dou'gao'bu'dong	0
各种莫名的感伤	ge'zhong'mo'ming'de'gan'shang	0
各自奔前程的身影	ge'zi'ben'qian'cheng'de'shen'ying	0
跟你借的幸福	gen'ni'jie'de'xing'fu	0
孤单的生活会更快乐	gu'dan'de'sheng'huo'hui'geng'kuai'le	0
孤单也很精采	gu'dan'ye'hen'jing'cai	0
故意讨你温柔的骂	gu'yi'tao'ni'wen'rou'de'ma	0
乖乖的拿着画笔	guai'guai'de'na'zhe'hua'bi	0
还残留在思念的落差	hai'can'liu'zai'si'nian'de'luo'cha	0
还记得那年	hai'ji'de'na'nian	0
还记得昨天那个夏天	hai'ji'de'zuo'tian'na'ge'xia'tian	0
还流动着牵挂	hai'liu'dong'zhe'qian'gua	0
还是情浅缘深	hai'shi'qing'qian'yuan'shen	0
还有机会能够感觉	hai'you'ji'hui'neng'gou'gan'jue	0
还有机会为你奉献	hai'you'ji'hui'wei'ni'feng'xian	0
还有没有情浓	hai'you'mei'you'qing'nong	0
还有新视野	hai'you'xin'shi'ye	0
还有一盏烛燃尽我	hai'you'yi'zhan'zhu'ran'jin'wo	0
孩子的孩子	hai'zi'de'hai'zi	0
好不好	hao'bu'hao	0
好想拥抱你	hao'xiang'yong'bao'ni	0
好想再回到那些年的时光	hao'xiang'zai'hui'dao'na'xie'nian'de'shi'guang	0
何必痴痴傻傻纠缠不休	he'bi'chi'chi'sha'sha'jiu'chan'bu'xiu	0
和你醉后缠绵	he'ni'zui'hou'chan'mian	0
黑板上排列组合	hei'ban'shang'pai'lie'zu'he	0
很高兴一路上	hen'gao'xing'yi'lu'shang	0
蝴蝶去向无影踪	hu'die'qu'xiang'wu'ying'zong	0
化成灰谁认得谁管他配不配	hua'cheng'hui'shui'ren'de'shui'guan'ta'pei'bu'pei	0
话总说不清楚	hua'zong'shuo'bu'qing'chu	0
化作风化作雨化作春走向你	hua'zuo'feng'hua'zuo'yu'hua'zuo'chun'zou'xiang'ni	0
化作路化作径化作情找寻你	hua'zuo'lu'hua'zuo'jing'hua'zuo'qing'zhao'xun'ni	0
化作诗化作笔化作灯写着你	hua'zuo'shi'hua'zuo'bi'hua'zuo'deng'xie'zhe'ni	0
化作烟化作泥化作云飘向你	hua'zuo'yan'hua'zuo'ni'hua'zuo'yun'piao'xiang'ni	0
幻如一丝尘土	huan'ru'yi'si'chen'tu	0
黄昏的树梢	huang'hun'de'shu'shao	0
毁不灭是我尽头的展望	hui'bu'mie'shi'wo'jin'tou'de'zhan'wang	0
回到教室座位前后	hui'dao'jiao'shi'zuo'wei'qian'hou	0
会给我一扇灯窗	hui'gei'wo'yi'shan'deng'chuang	0
会给我一扇心房	hui'gei'wo'yi'shan'xin'fang	0
会开出勇敢的花	hui'kai'chu'yong'gan'de'hua	0
会让你轻声合	hui'rang'ni'qing'sheng'he	0
挥手对我说一声四季不变	hui'shou'dui'wo'shuo'yi'sheng'si'ji'bu'bian	0
回想那些幸福的日子	hui'xiang'na'xie'xing'fu'de'ri'zi	0
回忆都是负荷	hui'yi'dou'shi'fu'he	0
回忆里满足的旋律	hui'yi'li'man'zu'de'xuan'lv	0
回忆只剩下碎片	hui'yi'zhi'sheng'xia'sui'pian	0
回音都旋绕	hui'yin'dou'xuan'rao	0
火车就要出发催促我快离开	huo'che'jiu'yao'chu'fa'cui'cu'wo'kuai'li'kai	0
极尽诱惑的一切	ji'jin'you'huo'de'yi'qie	0
寂寞城市中的每个人	ji'mo'cheng'shi'zhong'de'mei'ge'ren	0
寂寞世界中的两颗心	ji'mo'shi'jie'zhong'de'liang'ke'xin	0
寂寞唏嘘	ji'mo'xi'xu	0
纪念每一天	ji'nian'mei'yi'tian	0
记忆中你青涩的脸	ji'yi'zhong'ni'qing'se'de'lian	0
假装过头了	jia'zhuang'guo'tou'le	0
剪不断放不下舍不得忘记从前	jian'bu'duan'fang'bu'xia'she'bu'de'wang'ji'cong'qian	0
将头发梳成大人模样	jiang'tou'fa'shu'cheng'da'ren'mu'yang	0
胶片挥霍习惯的笑脸	jiao'pian'hui'huo'xi'guan'de'xiao'lian	0
紧紧抱著你	jin'jin'bao'zhu'ni	0
紧紧围绕你每分每秒	jin'jin'wei'rao'ni'mei'fen'mei'miao	0
紧紧抓着的也都是空白	jin'jin'zhua'zhe'de'ye'dou'shi'kong'bai	0
今天男孩要赴女孩最后的约	jin'tian'nan'hai'yao'fu'nv'hai'zui'hou'de'yue	0
紧握在手上	jin'wo'zai'shou'shang	0
就不怕魔鬼	jiu'bu'pa'mo'gui	0
就从那一刻开始	jiu'cong'na'yi'ke'kai'shi	0
就像好好睡了一夜直到天亮	jiu'xiang'hao'hao'shui'le'yi'ye'zhi'dao'tian'liang	0
就有多少无能为力的不舍	jiu'you'duo'shao'wu'neng'wei'li'de'bu'she	0
旧帐总翻不完	jiu'zhang'zong'fan'bu'wan	0
酒醉后的我	jiu'zui'hou'de'wo	0
举杯消愁意正浓	ju'bei'xiao'chou'yi'zheng'nong	0
沮丧时总会明显感到孤独的重量	ju'sang'shi'zong'hui'ming'xian'gan'dao'gu'du'de'zhong'liang	0
绝对会到达	jue'dui'hui'dao'da	0
开始的开始	kai'shi'de'kai'shi	0
看不见永听见离歌	kan'bu'jian'yong'ting'jian'li'ge	0
看不见终点	kan'bu'jian'zhong'dian	0
看更多美丽的风景	kan'geng'duo'mei'li'de'feng'jing	0
看那满天飘零的花朵	kan'na'man'tian'piao'ling'de'hua'duo	0
看世界多开阔天能够有多大	kan'shi'jie'duo'kai'kuo'tian'neng'gou'you'duo'da	0
看走眼	kan'zou'yan	0
可是爱情消失的那一瞬间	ke'shi'ai'qing'xiao'shi'de'na'yi'shun'jian	0
可是我不配	ke'shi'wo'bu'pei	0
渴望变成天使	ke'wang'bian'cheng'tian'shi	0
可以在疲惫的时光	ke'yi'zai'pi'bei'de'shi'guang	0
空荡荡的月台	kong'dang'dang'de'yue'tai	0
空气中的温暖不会很遥远	kong'qi'zhong'de'wen'nuan'bu'hui'hen'yao'yuan	0
哭再凶也不解我恨	ku'zai'xiong'ye'bu'jie'wo'hen	0
来不及领悟爱的解脱	lai'bu'ji'ling'wu'ai'de'jie'tuo	0
蓝色的思念	lan'se'de'si'nian	0
滥用沉默在咆哮	lan'yong'chen'mo'zai'pao'xiao	0
累觉不爱的心	lei'jue'bu'ai'de'xin	0
泪湿的衣洗干净阳光里晒干回忆	lei'shi'de'yi'xi'gan'jing'yang'guang'li'shai'gan'hui'yi	0
泪水苦涩自己尝	lei'shui'ku'se'zi'ji'chang	0
离歌	li'ge	0
离开的路口	li'kai'de'lu'kou	0
离开你我才发现自己	li'kai'ni'wo'cai'fa'xian'zi'ji	0
离开你我才找回自己	li'kai'ni'wo'cai'zhao'hui'zi'ji	0
脸发烫	lian'fa'tang	0
恋人心	lian'ren'xin	0
两个人在喜悦中散去了	liang'ge'ren'zai'xi'yue'zhong'san'qu'le	0
淋湿的昨天删去	lin'shi'de'zuo'tian'shan'qu	0
流浪的小孩	liu'lang'de'xiao'hai	0
流浪的小孩昂首向前走	liu'lang'de'xiao'hai'ang'shou'xiang'qian'zou	0
流浪的小孩对自己负责	liu'lang'de'xiao'hai'dui'zi'ji'fu'ze	0
流浪的小孩泪为自己流	liu'lang'de'xiao'hai'lei'wei'zi'ji'liu	0
流浪的小孩努力编织梦	liu'lang'de'xiao'hai'nu'li'bian'zhi'meng	0
流浪的小孩少年多挥霍	liu'lang'de'xiao'hai'shao'nian'duo'hui'huo	0
流浪的小孩笑发自心中	liu'lang'de'xiao'hai'xiao'fa'zi'xin'zhong	0
留一生遗憾	liu'yi'sheng'yi'han	0
乱了分寸的心动	luan'le'fen'cun'de'xin'dong	0
绿色的思念	lv'se'de'si'nian	0
茫然的心忍受孤独和寂寞	mang'ran'de'xin'ren'shou'gu'du'he'ji'mo	0
毛毯般的厚重感	mao'tan'ban'de'hou'zhong'gan	0
每个清晨黄昏都有你陪在左右	mei'ge'qing'chen'huang'hun'dou'you'ni'pei'zai'zuo'you	0
美丽本无罪	mei'li'ben'wu'zui	0
没说完温柔只剩离歌	mei'shuo'wan'wen'rou'zhi'sheng'li'ge	0
没想到害怕更真实存在	mei'xiang'dao'hai'pa'geng'zhen'shi'cun'zai	0
没勇气去忘记一个人的脆弱	mei'yong'qi'qu'wang'ji'yi'ge'ren'de'cui'ruo	0
没有了当年的热血	mei'you'le'dang'nian'de're'xue	0
没有你我的笑更美丽	mei'you'ni'wo'de'xiao'geng'mei'li	0
没有你以后一个人四处旅游	mei'you'ni'yi'hou'yi'ge'ren'si'chu'lv'you	0
没有人能感觉到	mei'you'ren'neng'gan'jue'dao	0
没有人能感觉到你最甜美的笑	mei'you'ren'neng'gan'jue'dao'ni'zui'tian'mei'de'xiao	0
没有人去理会我丢了爱的懦弱	mei'you'ren'qu'li'hui'wo'diu'le'ai'de'nuo'ruo	0
没有我以后	mei'you'wo'yi'hou	0
梦多难求	meng'duo'nan'qiu	0
梦镜的虚有	meng'jing'de'xu'you	0
梦如声梦如影梦是遥望的掌印	meng'ru'sheng'meng'ru'ying'meng'shi'yao'wang'de'zhang'yin	0
梦想总是遥不可及	meng'xiang'zong'shi'yao'bu'ke'ji	0
梦醒来的我	meng'xing'lai'de'wo	0
梦醒了就不在	meng'xing'le'jiu'bu'zai	0
梦也渐渐被现实夺走	meng'ye'jian'jian'bei'xian'shi'duo'zou	0
面带微笑的	mian'dai'wei'xiao'de	0
描绘美丽的天空	miao'hui'mei'li'de'tian'kong	0
模糊了眼	mo'hu'le'yan	0
默念着轻叹着那些深沉的字句	mo'nian'zhe'qing'tan'zhe'na'xie'shen'chen'de'zi'ju	0
那爱笑的眼睛流过泪	na'ai'xiao'de'yan'jing'liu'guo'lei	0
那爱笑的眼睛再见爱情	na'ai'xiao'de'yan'jing'zai'jian'ai'qing	0
那不堪一击的洁白	na'bu'kan'yi'ji'de'jie'bai	0
那个被风吹过的夏天	na'ge'bei'feng'chui'guo'de'xia'tian	0
哪里都是我梦想	na'li'dou'shi'wo'meng'xiang	0
那时候陪伴我的那颗	na'shi'hou'pei'ban'wo'de'na'ke	0
那时你说的	na'shi'ni'shuo'de	0
那时陪伴我的人哪	na'shi'pei'ban'wo'de'ren'na	0
那是我日夜思念深深爱着的人啊	na'shi'wo'ri'ye'si'nian'shen'shen'ai'zhe'de'ren'a	0
那天晚上满天星星	na'tian'wan'shang'man'tian'xing'xing	0
那些激情后的陌生	na'xie'ji'qing'hou'de'mo'sheng	0
那些年	na'xie'nian	0
那些年错过的爱情	na'xie'nian'cuo'guo'de'ai'qing	0
那些年错过的大雨	na'xie'nian'cuo'guo'de'da'yu	0
那一天发现了你的好	na'yi'tian'fa'xian'le'ni'de'hao	0
能否别把灯打开	neng'fou'bie'ba'deng'da'kai	0
你比自己更重要	ni'bi'zi'ji'geng'zhong'yao	0
你不必讶异我的笑他无法代替	ni'bu'bi'ya'yi'wo'de'xiao'ta'wu'fa'dai'ti	0
你不了解的爱	ni'bu'liao'jie'de'ai	0
你不知道在你每次转身背后	ni'bu'zhi'dao'zai'ni'mei'ci'zhuan'shen'bei'hou	0
你曾记得	ni'ceng'ji'de	0
你的声音还围绕在我耳边	ni'de'sheng'yin'hai'wei'rao'zai'wo'er'bian	0
你的双手甩开刚好的微妙	ni'de'shuang'shou'shuai'kai'gang'hao'de'wei'miao	0
你的小小情绪对我来说	ni'de'xiao'xiao'qing'xu'dui'wo'lai'shuo	0
你对我多重要	ni'dui'wo'duo'zhong'yao	0
你还记得吗	ni'hai'ji'de'ma	0
你还没玩够	ni'hai'mei'wan'gou	0
你还是选择回去	ni'hai'shi'xuan'ze'hui'qu	0
你既然无心	ni'ji'ran'wu'xin	0
你就这样闯进我的心窝	ni'jiu'zhe'yang'chuang'jin'wo'de'xin'wo	0
你看我在勇敢地去挥手啊	ni'kan'wo'zai'yong'gan'de'qu'hui'shou'a	0
你看我在勇敢地微笑	ni'kan'wo'zai'yong'gan'de'wei'xiao	0
你离开的刚好	ni'li'kai'de'gang'hao	0
你没那么重要	ni'mei'na'me'zhong'yao	0
你们如今在何方	ni'men'ru'jin'zai'he'fang	0
你骗我真的有天份	ni'pian'wo'zhen'de'you'tian'fen	0
你若看见满街的本子还是学乐先	ni'ruo'kan'jian'man'jie'de'ben'zi'hai'shi'xue'le'xian	0
你若听见	ni'ruo'ting'jian	0
你舍得解开吗	ni'she'de'jie'kai'ma	0
你是对的时间对的角色	ni'shi'dui'de'shi'jian'dui'de'jue'se	0
你是我的小蝴蝶	ni'shi'wo'de'xiao'hu'die	0
你手机藏着什么呀	ni'shou'ji'cang'zhe'shen'me'ya	0
你手掌的厚实感	ni'shou'zhang'de'hou'shi'gan	0
你说爱本就是梦境	ni'shuo'ai'ben'jiu'shi'meng'jing	0
你说的我都会相信	ni'shuo'de'wo'dou'hui'xiang'xin	0
你说的我都愿意去	ni'shuo'de'wo'dou'yuan'yi'qu	0
你说你会一直爱我会紧抱着我	ni'shuo'ni'hui'yi'zhi'ai'wo'hui'jin'bao'zhe'wo	0
你停在我的肩	ni'ting'zai'wo'de'jian	0
你问长江水淘尽心酸的滋味	ni'wen'chang'jiang'shui'tao'jin'xin'suan'de'zi'wei	0
你问西湖水偷走她的几分美	ni'wen'xi'hu'shui'tou'zou'ta'de'ji'fen'mei	0
你心慌	ni'xin'huang	0
你心里藏着什么呀	ni'xin'li'cang'zhe'shen'me'ya	0
你也轻轻的附和	ni'ye'qing'qing'de'fu'he	0
你有专属的味道	ni'you'zhuan'shu'de'wei'dao	0
你自己却不知道	ni'zi'ji'que'bu'zhi'dao	0
你自然的就接下一段	ni'zi'ran'de'jiu'jie'xia'yi'duan	0
年少的心有勇气追求	nian'shao'de'xin'you'yong'qi'zhui'qiu	0
努力拼凑了一整夜	nu'li'pin'cou'le'yi'zheng'ye	0
暖暖	nuan'nuan	0
陪我直到永远	pei'wo'zhi'dao'yong'yuan	0
平行时空下的约定	ping'xing'shi'kong'xia'de'yue'ding	0
其实见多就不怪	qi'shi'jian'duo'jiu'bu'guai	0
其实我并不在意	qi'shi'wo'bing'bu'zai'yi	0
其实我很美	qi'shi'wo'hen'mei	0
牵着你到处瞎逛	qian'zhe'ni'dao'chu'xia'guang	0
强悍的是命运	qiang'han'de'shi'ming'yun	0
琴声一曲相送	qin'sheng'yi'qu'xiang'song	0
情缘似流水	qing'yuan'si'liu'shui	0
秋天的雨更碎	qiu'tian'de'yu'geng'sui	0
去思念	qu'si'nian	0
曲终人散	qu'zhong'ren'san	0
劝自己别浪费时间	quan'zi'ji'bie'lang'fei'shi'jian	0
却又飘散的勇气	que'you'piao'san'de'yong'qi	0
却又重小的勇气	que'you'zhong'xiao'de'yong'qi	0
然后怎么了	ran'hou'zen'me'le	0
然后战火再燃烧	ran'hou'zhan'huo'zai'ran'shao	0
让你有安全感	rang'ni'you'an'quan'gan	0
让你知道	rang'ni'zhi'dao	0
让我让我无所畏惧	rang'wo'rang'wo'wu'suo'wei'ju	0
让我勇敢前行	rang'wo'yong'gan'qian'xing	0
任风吹	ren'feng'chui	0
任岁月风干理想再也	ren'sui'yue'feng'gan'li'xiang'zai'ye	0
任它乱	ren'ta'luan	0
任性错过的人	ren'xing'cuo'guo'de'ren	0
认真我就输了	ren'zhen'wo'jiu'shu'le	0
如果不是那镜子	ru'guo'bu'shi'na'jing'zi	0
如果骄傲没被现实大海冷冷拍下	ru'guo'jiao'ao'mei'bei'xian'shi'da'hai'leng'leng'pai'xia	0
如果剧本写好	ru'guo'ju'ben'xie'hao	0
如果梦想不曾坠落悬崖千钧一发	ru'guo'meng'xiang'bu'ceng'zhui'luo'xuan'ya'qian'jun'yi'fa	0
如果世界漆黑	ru'guo'shi'jie'qi'hei	0
如果像你一样	ru'guo'xiang'ni'yi'yang	0
如果真的遇见你	ru'guo'zhen'de'yu'jian'ni	0
如今风依旧在吹	ru'jin'feng'yi'jiu'zai'chui	0
入秋微凉的海	ru'qiu'wei'liang'de'hai	0
如同奔流的江河	ru'tong'ben'liu'de'jiang'he	0
若是有缘再见也要学会笑着问候	ruo'shi'you'yuan'zai'jian'ye'yao'xue'hui'xiao'zhe'wen'hou	0
若是再见只会让人更难受	ruo'shi'zai'jian'zhi'hui'rang'ren'geng'nan'shou	0
晒过太阳熟悉的安全感	shai'guo'tai'yang'shu'xi'de'an'quan'gan	0
伤痕累累才懂	shang'hen'lei'lei'cai'dong	0
舍不得	she'bu'de	0
舍不得并不是没有把握	she'bu'de'bing'bu'shi'mei'you'ba'wo	0
舍不得是不是爱你太多	she'bu'de'shi'bu'shi'ai'ni'tai'duo	0
深红的眼	shen'hong'de'yan	0
什么困难都觉得有希望	shen'me'kun'nan'dou'jue'de'you'xi'wang	0
什么也不会	shen'me'ye'bu'hui	0
身在这一个混沌的世界	shen'zai'zhe'yi'ge'hun'dun'de'shi'jie	0
剩半颗恋人心唤不回	sheng'ban'ke'lian'ren'xin'huan'bu'hui	0
生活像一把无情刻刀	sheng'huo'xiang'yi'ba'wu'qing'ke'dao	0
生气时嘴嘟着撒娇	sheng'qi'shi'zui'du'zhe'sa'jiao	0
是不是应该放弃	shi'bu'shi'ying'gai'fang'qi	0
事到如今只好祭奠吗	shi'dao'ru'jin'zhi'hao'ji'dian'ma	0
是否会更深刻	shi'fou'hui'geng'shen'ke	0
时光一去不再信誓旦旦留给谁	shi'guang'yi'qu'bu'zai'xin'shi'dan'dan'liu'gei'shui	0
时间的沙	shi'jian'de'sha	0
时间的沙化作浮尘落下	shi'jian'de'sha'hua'zuo'fu'chen'luo'xia	0
时间的沙让爱散去光华	shi'jian'de'sha'rang'ai'san'qu'guang'hua	0
失落的心忍受时间的蹉跎	shi'luo'de'xin'ren'shou'shi'jian'de'cuo'tuo	0
是你吗	shi'ni'ma	0
是你呀	shi'ni'ya	0
是情深缘浅	shi'qing'shen'yuan'qian	0
是上天放纵了悲欢离合	shi'shang'tian'fang'zong'le'bei'huan'li'he	0
视听都混淆	shi'ting'dou'hun'xiao	0
是我想得太多	shi'wo'xiang'de'tai'duo	0
实现了真的渴望	shi'xian'le'zhen'de'ke'wang	0
守护每一夜	shou'hu'mei'yi'ye	0
手拉手我们走过三个春夏秋冬	shou'la'shou'wo'men'zou'guo'san'ge'chun'xia'qiu'dong	0
熟悉的脸又会浮现在眼前	shu'xi'de'lian'you'hui'fu'xian'zai'yan'qian	0
谁比谁高贵	shui'bi'shui'gao'gui	0
谁才能给我安心呐	shui'cai'neng'gei'wo'an'xin'na	0
谁给我答案	shui'gei'wo'da'an	0
谁听得到	shui'ting'de'dao	0
谁无过错	shui'wu'guo'cuo	0
谁无理取闹	shui'wu'li'qu'nao	0
谁又能轻易得到解脱	shui'you'neng'qing'yi'de'dao'jie'tuo	0
谁与谁坐他又爱著她	shui'yu'shui'zuo'ta'you'ai'zhu'ta	0
说好不会再想念	shuo'hao'bu'hui'zai'xiang'nian	0
似乎吹翻一切	si'hu'chui'fan'yi'qie	0
思如海恋如城思念最遥不可及	si'ru'hai'lian'ru'cheng'si'nian'zui'yao'bu'ke'ji	0
送到你的手中帮你解渴	song'dao'ni'de'shou'zhong'bang'ni'jie'ke	0
算了吧	suan'le'ba	0
随风轻飘地在狂舞	sui'feng'qing'piao'de'zai'kuang'wu	0
随风自由地在狂舞	sui'feng'zi'you'de'zai'kuang'wu	0
他刺痛你的心	ta'ci'tong'ni'de'xin	0
他的心比世界还宽容	ta'de'xin'bi'shi'jie'hai'kuan'rong	0
它还伸展枝桠	ta'hai'shen'zhan'zhi'ya	0
她会接受我吗	ta'hui'jie'shou'wo'ma	0
踏着力气踩着梦	ta'zhe'li'qi'cai'zhe'meng	0
太多的诗颂	tai'duo'de'shi'song	0
抬头仰望这漫天星河	tai'tou'yang'wang'zhe'man'tian'xing'he	0
天空已破晓	tian'kong'yi'po'xiao	0
听不见是非	ting'bu'jian'shi'fei	0
停留在原地感慨	ting'liu'zai'yuan'di'gan'kai	0
痛的初体验	tong'de'chu'ti'yan	0
童丽	tong'li	0
突然演变成了阳光的夏天	tu'ran'yan'bian'cheng'le'yang'guang'de'xia'tian	0
吞咽着心酸啊	tun'yan'zhe'xin'suan'a	0
往事都在绕	wang'shi'dou'zai'rao	0
未曾绽放就要枯萎吗	wei'ceng'zhan'fang'jiu'yao'ku'wei'ma	0
伟大的是感情	wei'da'de'shi'gan'qing	0
微风把脚下的树叶都吹开	wei'feng'ba'jiao'xia'de'shu'ye'dou'chui'kai	0
微风吹过的一瞬间	wei'feng'chui'guo'de'yi'shun'jian	0
为何还放不下	wei'he'hai'fang'bu'xia	0
未来在哪里平凡啊	wei'lai'zai'na'li'ping'fan'a	0
围绕着我的卑微	wei'rao'zhe'wo'de'bei'wei	0
我把玫瑰全都染黑	wo'ba'mei'gui'quan'dou'ran'hei	0
我不存在才意外	wo'bu'cun'zai'cai'yi'wai	0
我曾经爱过的人啊	wo'ceng'jing'ai'guo'de'ren'a	0
我的存在不意外	wo'de'cun'zai'bu'yi'wai	0
我的存在像意外	wo'de'cun'zai'xiang'yi'wai	0
我的伤口就难以愈合	wo'de'shang'kou'jiu'nan'yi'yu'he	0
我的手被温暖过幸福了	wo'de'shou'bei'wen'nuan'guo'xing'fu'le	0
我的心已超载	wo'de'xin'yi'chao'zai	0
我的心走在爱情的公路	wo'de'xin'zou'zai'ai'qing'de'gong'lu	0
我嘟的一声切的比你说分手彻底	wo'du'de'yi'sheng'qie'de'bi'ni'shuo'fen'shou'che'di	0
我还不肯相信	wo'hai'bu'ken'xiang'xin	0
我还剩下什么	wo'hai'sheng'xia'shen'me	0
我还想和你	wo'hai'xiang'he'ni	0
我还站在你离开	wo'hai'zhan'zai'ni'li'kai	0
我和从前的我	wo'he'cong'qian'de'wo	0
我很喜欢你安静的时候	wo'hen'xi'huan'ni'an'jing'de'shi'hou	0
我很喜欢你开心的时候	wo'hen'xi'huan'ni'kai'xin'de'shi'hou	0
我哼着歌	wo'heng'zhe'ge	0
我会变成巨人	wo'hui'bian'cheng'ju'ren	0
我回想着过去每秒	wo'hui'xiang'zhe'guo'qu'mei'miao	0
我仅有的一切	wo'jin'you'de'yi'qie	0
我绝不会食言	wo'jue'bu'hui'shi'yan	0
我看破	wo'kan'po	0
我看破被风吹过的夏天	wo'kan'po'bei'feng'chui'guo'de'xia'tian	0
我可以为你改变	wo'ke'yi'wei'ni'gai'bian	0
我们背对背拥抱	wo'men'bei'dui'bei'yong'bao	0
我们穿上西装假装成长	wo'men'chuan'shang'xi'zhuang'jia'zhuang'cheng'zhang	0
我们的默契那么长	wo'men'de'mo'qi'na'me'chang	0
我们的缘分刚好不许别人打扰	wo'men'de'yuan'fen'gang'hao'bu'xu'bie'ren'da'rao	0
我们都很快乐	wo'men'dou'hen'kuai'le	0
我们都是孩子	wo'men'dou'shi'hai'zi	0
我们即将分别	wo'men'ji'jiang'fen'bie	0
我们两支汤匙一个碗	wo'men'liang'zhi'tang'chi'yi'ge'wan	0
我们天作之合	wo'men'tian'zuo'zhi'he	0
我们相遇相拥	wo'men'xiang'yu'xiang'yong	0
我们有很多美好的回忆	wo'men'you'hen'duo'mei'hao'de'hui'yi	0
我们终于来到了这一天	wo'men'zhong'yu'lai'dao'le'zhe'yi'tian	0
我们最初见面的时候	wo'men'zui'chu'jian'mian'de'shi'hou	0
我其实很明白	wo'qi'shi'hen'ming'bai	0
我是米开朗基罗	wo'shi'mi'kai'lang'ji'luo	0
我是你的小阿飞	wo'shi'ni'de'xiao'a'fei	0
我说我的小蝴蝶	wo'shuo'wo'de'xiao'hu'die	0
我想默默地看着你等你回头	wo'xiang'mo'mo'de'kan'zhe'ni'deng'ni'hui'tou	0
我想努力给你温暖	wo'xiang'nu'li'gei'ni'wen'nuan	0
我想说其实你很好	wo'xiang'shuo'qi'shi'ni'hen'hao	0
我相信我们都有该去的未来	wo'xiang'xin'wo'men'dou'you'gai'qu'de'wei'lai	0
我心越荡	wo'xin'yue'dang	0
我要把你刺在我的心弦	wo'yao'ba'ni'ci'zai'wo'de'xin'xian	0
我要出去走一走	wo'yao'chu'qu'zou'yi'zou	0
我要的爱	wo'yao'de'ai	0
我要的爱出没在漆黑一片的舞台	wo'yao'de'ai'chu'mo'zai'qi'hei'yi'pian'de'wu'tai	0
我要兑现我的承诺	wo'yao'dui'xian'wo'de'cheng'nuo	0
我要深埋心头上秉持	wo'yao'shen'mai'xin'tou'shang'bing'chi	0
我要握紧手中坚定	wo'yao'wo'jin'shou'zhong'jian'ding	0
我也不知为何伤口还没愈合	wo'ye'bu'zhi'wei'he'shang'kou'hai'mei'yu'he	0
我也该放手	wo'ye'gai'fang'shou	0
我也希望变更好	wo'ye'xi'wang'bian'geng'hao	0
我已爱上你	wo'yi'ai'shang'ni	0
我一定让自己让自己决定	wo'yi'ding'rang'zi'ji'rang'zi'ji'jue'ding	0
我有过梦想	wo'you'guo'meng'xiang	0
我又想起你了	wo'you'xiang'qi'ni'le	0
我再不用把别人寻找	wo'zai'bu'yong'ba'bie'ren'xun'zhao	0
我在哭着	wo'zai'ku'zhe	0
我知道暖暖就在胸膛	wo'zhi'dao'nuan'nuan'jiu'zai'xiong'tang	0
我只能沉默以对	wo'zhi'neng'chen'mo'yi'dui	0
我只能还你	wo'zhi'neng'huan'ni	0
无可取代的你	wu'ke'qu'dai'de'ni	0
无人宠	wu'ren'chong	0
无数回忆连结	wu'shu'hui'yi'lian'jie	0
无所谓	wu'suo'wei	0
习惯人群中找你的影子	xi'guan'ren'qun'zhong'zhao'ni'de'ying'zi	0
细腻的喜欢	xi'ni'de'xi'huan	0
羡慕南飞的雁	xian'mu'nan'fei'de'yan	0
现实却那么残忍	xian'shi'que'na'me'can'ren	0
现在的我却是孤单着	xian'zai'de'wo'que'shi'gu'dan'zhe	0
现在你的另一半呢	xian'zai'ni'de'ling'yi'ban'ne	0
像尘埃一样的无畏	xiang'chen'ai'yi'yang'de'wu'wei	0
像冬天的可可	xiang'dong'tian'de'ke'ke	0
像躲不过的暴风雨	xiang'duo'bu'guo'de'bao'feng'yu	0
相互猜测怀疑	xiang'hu'cai'ce'huai'yi	0
像巨人一样的无畏	xiang'ju'ren'yi'yang'de'wu'wei	0
想留不能留才最寂寞	xiang'liu'bu'neng'liu'cai'zui'ji'mo	0
想起你那可爱模样	xiang'qi'ni'na'ke'ai'mu'yang	0
像夏天的可乐	xiang'xia'tian'de'ke'le	0
想永远在你身边	xiang'yong'yuan'zai'ni'shen'bian	0
想与你分享拥抱	xiang'yu'ni'fen'xiang'yong'bao	0
想在晴天与你紧靠	xiang'zai'qing'tian'yu'ni'jin'kao	0
小火车摆动的旋律	xiao'huo'che'bai'dong'de'xuan'lv	0
笑我不知道	xiao'wo'bu'zhi'dao	0
小熊和情人节的鲜花	xiao'xiong'he'qing'ren'jie'de'xian'hua	0
心比世界还宽容	xin'bi'shi'jie'hai'kuan'rong	0
心还连着像往常一样	xin'hai'lian'zhe'xiang'wang'chang'yi'yang	0
心紧紧依靠	xin'jin'jin'yi'kao	0
心里满满的苦涩	xin'li'man'man'de'ku'se	0
心碎前一秒	xin'sui'qian'yi'miao	0
心像风一样自由	xin'xiang'feng'yi'yang'zi'you	0
心绪还在没落	xin'xu'hai'zai'mo'luo	0
心中的热却不退	xin'zhong'de're'que'bu'tui	0
幸福越来越遥远	xing'fu'yue'lai'yue'yao'yuan	0
星期六的影院门口有你才热闹	xing'qi'liu'de'ying'yuan'men'kou'you'ni'cai're'nao	0
星期天夜晚带你去看夜景	xing'qi'tian'ye'wan'dai'ni'qu'kan'ye'jing	0
绚烂的夜	xuan'lan'de'ye	0
沿海地带	yan'hai'di'dai	0
眼泪不听话了	yan'lei'bu'ting'hua'le	0
眼泪肆意滑落	yan'lei'si'yi'hua'luo	0
眼神坚定着我们的选择	yan'shen'jian'ding'zhe'wo'men'de'xuan'ze	0
要更自由自在	yao'geng'zi'you'zi'zai	0
也见证了我和你	ye'jian'zheng'le'wo'he'ni	0
也没有人愿意收留	ye'mei'you'ren'yuan'yi'shou'liu	0
也许会有挫折	ye'xu'hui'you'cuo'zhe	0
也许能消退	ye'xu'neng'xiao'tui	0
也许永远都不会跟她说出那句话	ye'xu'yong'yuan'dou'bu'hui'gen'ta'shuo'chu'na'ju'hua	0
野子	ye'zi	0
一般人	yi'ban'ren	0
一辈子怨偶	yi'bei'zi'yuan'ou	0
一边微笑一边流泪	yi'bian'wei'xiao'yi'bian'liu'lei	0
一封信一年时间都略过	yi'feng'xin'yi'nian'shi'jian'dou'lve'guo	0
一个人	yi'ge'ren	0
一个人少喝点酒	yi'ge'ren'shao'he'dian'jiu	0
一个人守在风中等承诺	yi'ge'ren'shou'zai'feng'zhong'deng'cheng'nuo	0
以后的以后	yi'hou'de'yi'hou	0
以后的以后你是谁的某某某	yi'hou'de'yi'hou'ni'shi'shui'de'mou'mou'mou	0
以后的以后我牵着别人衣袖	yi'hou'de'yi'hou'wo'qian'zhe'bie'ren'yi'xiu	0
已经分开很远很远	yi'jing'fen'kai'hen'yuan'hen'yuan	0
已经约定过一起过下个周末	yi'jing'yue'ding'guo'yi'qi'guo'xia'ge'zhou'mo	0
一开始我只相信	yi'kai'shi'wo'zhi'xiang'xin	0
一颗心消受两人的寂寞	yi'ke'xin'xiao'shou'liang'ren'de'ji'mo	0
一路就向下坠	yi'lu'jiu'xiang'xia'zhui	0
一去不回来不及道别	yi'qu'bu'hui'lai'bu'ji'dao'bie	0
依偎在我耳边	yi'wei'zai'wo'er'bian	0
一直爱你不管风雨	yi'zhi'ai'ni'bu'guan'feng'yu	0
一直爱你我会一直爱你	yi'zhi'ai'ni'wo'hui'yi'zhi'ai'ni	0
一直爱你直到永久	yi'zhi'ai'ni'zhi'dao'yong'jiu	0
一直陪着我	yi'zhi'pei'zhe'wo	0
一直往大风吹的方向走过去	yi'zhi'wang'da'feng'chui'de'fang'xiang'zou'guo'qu	0
一字一句像圈套	yi'zi'yi'ju'xiang'quan'tao	0
因为我完全信任你	yin'wei'wo'wan'quan'xin'ren'ni	0
因为我已经找到	yin'wei'wo'yi'jing'zhao'dao	0
应该要往那里走	ying'gai'yao'wang'na'li'zou	0
拥抱错过的勇气	yong'bao'cuo'guo'de'yong'qi	0
用力的相拥着沉默	yong'li'de'xiang'yong'zhe'chen'mo	0
用轻快的步伐	yong'qing'kuai'de'bu'fa	0
用时间	yong'shi'jian	0
用思念把旧爱写成歌	yong'si'nian'ba'jiu'ai'xie'cheng'ge	0
用心刻画最幸福的风格	yong'xin'ke'hua'zui'xing'fu'de'feng'ge	0
用心跳送你辛酸离歌	yong'xin'tiao'song'ni'xin'suan'li'ge	0
用心跳辛酸离歌	yong'xin'tiao'xin'suan'li'ge	0
拥有隐形翅牓	yong'you'yin'xing'chi'bang	0
用最浪漫的副歌	yong'zui'lang'man'de'fu'ge	0
有多少无人能懂的不快乐	you'duo'shao'wu'ren'neng'dong'de'bu'kuai'le	0
有很多机会	you'hen'duo'ji'hui	0
又回到最初的起点	you'hui'dao'zui'chu'de'qi'dian	0
又能边走着边哼着歌	you'neng'bian'zou'zhao'bian'heng'zhe'ge	0
有你就是最好	you'ni'jiu'shi'zui'hao	0
有你闹有你笑的生活	you'ni'nao'you'ni'xiao'de'sheng'huo	0
有人丢掉称谓	you'ren'diu'diao'cheng'wei	0
有人用一滴泪会红颜祸水	you'ren'yong'yi'di'lei'hui'hong'yan'huo'shui	0
有人在说那些奇怪的语言	you'ren'zai'shuo'na'xie'qi'guai'de'yu'yan	0
犹如飞蛾扑火那么冲动	you'ru'fei'e'pu'huo'na'me'chong'dong	0
又如一丝消沙	you'ru'yi'si'xiao'sha	0
有谁会记得这世界他来过	you'shui'hui'ji'de'zhe'shi'jie'ta'lai'guo	0
有些梦做着做着就醒了	you'xie'meng'zuo'zhe'zuo'zhe'jiu'xing'le	0
有些人想着想着就忘了	you'xie'ren'xiang'zhe'xiang'zhe'jiu'wang'le	0
有些人走着走着就散了	you'xie'ren'zou'zhe'zou'zhe'jiu'san'le	0
有些事看着看着就淡了	you'xie'shi'kan'zhe'kan'zhe'jiu'dan'le	0
又再回到从前	you'zai'hui'dao'cong'qian	0
又怎会懂得要多努力	you'zen'hui'dong'de'yao'duo'nu'li	0
又怎会晓得执着的人	you'zen'hui'xiao'de'zhi'zhuo'de'ren	0
又怎么不对	you'zen'me'bu'dui	0
遇见你我才知道	yu'jian'ni'wo'cai'zhi'dao	0
与清风把酒相送	yu'qing'feng'ba'jiu'xiang'song	0
原来爱是种任性	yuan'lai'ai'shi'zhong'ren'xing	0
原来只剩伤痕不停地蔓延	yuan'lai'zhi'sheng'shang'hen'bu'ting'de'man'yan	0
原来只有三年	yuan'lai'zhi'you'san'nian	0
月色正朦胧	yue'se'zheng'meng'long	0
云怎么挽留	yun'zen'me'wan'liu	0
在爱情里面进退	zai'ai'qing'li'mian'jin'tui	0
再唱着这首歌会是在哪一个角落	zai'chang'zhe'zhe'shou'ge'hui'shi'zai'na'yi'ge'jiao'luo	0
在某时某地交上三两个朋友	zai'mou'shi'mou'di'jiao'shang'san'liang'ge'peng'you	0
在是什么模样	zai'shi'shen'me'mu'yang	0
再踏进这校园会是哪片落叶	zai'ta'jin'zhe'xiao'yuan'hui'shi'na'pian'luo'ye	0
在沿海地带放逐我的爱	zai'yan'hai'di'dai'fang'zhu'wo'de'ai	0
在沿海地带我远远离开	zai'yan'hai'di'dai'wo'yuan'yuan'li'kai	0
再一次相遇我会紧紧抱著你	zai'yi'ci'xiang'yu'wo'hui'jin'jin'bao'zhu'ni	0
再一点时间	zai'yi'dian'shi'jian	0
在这暧昧的时代	zai'zhe'ai'mei'de'shi'dai	0
在最美丽的时刻凋谢	zai'zui'mei'li'de'shi'ke'diao'xie	0
葬送在烽火的玩笑	zang'song'zai'feng'huo'de'wan'xiao	0
早已将思念唱得沙哑	zao'yi'jiang'si'nian'chang'de'sha'ya	0
怎么大风越狠	zen'me'da'feng'yue'hen	0
怎么能在半路就返航	zen'me'neng'zai'ban'lu'jiu'fan'hang	0
怎么拼凑重好	zen'me'pin'cou'zhong'hao	0
怎么只有这首歌	zen'me'zhi'you'zhe'shou'ge	0
摘一颗苹果等你从门前经过	zhai'yi'ke'ping'guo'deng'ni'cong'men'qian'jing'guo	0
找不到出口	zhao'bu'dao'chu'kou	0
找不回真的我	zhao'bu'hui'zhen'de'wo	0
找到一个地方属于我	zhao'dao'yi'ge'di'fang'shu'yu'wo	0
这爱的城市虽然拥挤	zhe'ai'de'cheng'shi'sui'ran'yong'ji	0
这次算我看走眼	zhe'ci'suan'wo'kan'zou'yan	0
折好了伤心明天起只和快乐出去	zhe'hao'le'shang'xin'ming'tian'qi'zhi'he'kuai'le'chu'qu	0
这世界滴滴点点全部都是你	zhe'shi'jie'di'di'dian'dian'quan'bu'dou'shi'ni	0
这是我们的时代	zhe'shi'wo'men'de'shi'dai	0
这心愿不会变	zhe'xin'yuan'bu'hui'bian	0
这里的故事你是否还记得	zhei'li'de'gu'shi'ni'shi'fou'hai'ji'de	0
真的很美好	zhen'de'hen'mei'hao	0
真话兜着圈子乱乱绕	zhen'hua'dou'zhe'quan'zi'luan'luan'rao	0
真是可恨啊	zhen'shi'ke'hen'a	0
真心的对我好	zhen'xin'de'dui'wo'hao	0
只好把眼泪当做纪念	zhi'hao'ba'yan'lei'dang'zuo'ji'nian	0
稚嫩的我不好意思的向你点点头	zhi'nen'de'wo'bu'hao'yi'si'de'xiang'ni'dian'dian'tou	0
只能独自一人承受寂寞	zhi'neng'du'zi'yi'ren'cheng'shou'ji'mo	0
只剩风陪着鸟	zhi'sheng'feng'pei'zhe'niao	0
只剩寂寞肯沉淀	zhi'sheng'ji'mo'ken'chen'dian	0
只剩下麻木的我	zhi'sheng'xia'ma'mu'de'wo	0
只是还挣扎着不让他离开	zhi'shi'hai'zheng'zha'zhe'bu'rang'ta'li'kai	0
只是想让你知道	zhi'shi'xiang'rang'ni'zhi'dao	0
只是想让我知道	zhi'shi'xiang'rang'wo'zhi'dao	0
只说句嘻嘻一些	zhi'shuo'ju'xi'xi'yi'xie	0
只要你愿意给	zhi'yao'ni'yuan'yi'gei	0
只要你足够虚伪	zhi'yao'ni'zu'gou'xu'wei	0
只有愿不愿意	zhi'you'yuan'bu'yuan'yi	0
注定我要浪迹天涯	zhu'ding'wo'yao'lang'ji'tian'ya	0
专属味道	zhuan'shu'wei'dao	0
转眼过去多年世间	zhuan'yan'guo'qu'duo'nian'shi'jian	0
桌垫下的老照片	zhuo'dian'xia'de'lao'zhao'pian	0
自信心不高	zi'xin'xin'bu'gao	0
总感觉我们还会再相见	zong'gan'jue'wo'men'hai'hui'zai'xiang'jian	0
纵使不让幸福发芽	zong'shi'bu'rang'xing'fu'fa'ya	0
纵使心头除掉花	zong'shi'xin'tou'chu'diao'hua	0
总有人谄媚	zong'you'ren'chan'mei	0
走着走着就散了	zou'zhe'zou'zhe'jiu'san'le	0
最初的梦想	zui'chu'de'meng'xiang	0
最多被消费	zui'duo'bei'xiao'fei	0
最后的最后	zui'hou'de'zui'hou	0
最后我无力的看清	zui'hou'wo'wu'li'de'kan'qing	0
醉清风	zui'qing'feng	0
醉生梦死也空	zui'sheng'meng'si'ye'kong	0
最甜美的笑	zui'tian'mei'de'xiao	0
最想要去的地方	zui'xiang'yao'qu'de'di'fang	0
左心房暖暖的好饱满	zuo'xin'fang'nuan'nuan'de'hao'bao'man	0
