阿弗它性口炎	a'fu'ta'xing'kou'yan	0
癌前病变	ai'qian'bing'bian	0
艾滋病	ai'zi'bing	0
拔牙禁忌症	ba'ya'jin'ji'zheng	0
拔牙适应症	ba'ya'shi'ying'zheng	0
白塞病	bai'sai'bing	0
白色海绵状斑痣	bai'se'hai'mian'zhuang'ban'zhi	0
瘢痕性类天疱疮	ban'hen'xing'lei'tian'pao'chuang	0
北京口腔医学	bei'jing'kou'qiang'yi'xue	0
贝氏口创	bei'shi'kou'chuang	0
鼻唇囊肿	bi'chun'nang'zhong	0
鼻腭囊肿	bi'e'nang'zhong	0
鼻骨骨折	bi'gu'gu'zhe	0
铋中毒	bi'zhong'du	0
扁平苔藓癣	bian'ping'tai'xian'xuan	0
边缘性颌骨骨髓炎	bian'yuan'xing'he'gu'gu'sui'yan	0
表面麻醉	biao'mian'ma'zui	0
部分冠	bu'fen'guan	0
部各种缺损和缺失的科学	bu'ge'zhong'que'sun'he'que'shi'de'ke'xue	0
不洁性龈炎	bu'jie'xing'yin'yan	0
常规修正因素	chang'gui'xiu'zheng'yin'su	0
超微结构	chao'wei'jie'gou	0
初戴	chu'dai	0
创伤弹道	chuang'shang'dan'dao	0
创伤性溃疡	chuang'shang'xing'kui'yang	0
创伤性血疱及溃疡	chuang'shang'xing'xue'pao'ji'kui'yang	0
唇癌	chun'ai	0
唇腭裂	chun'e'lie	0
唇舌系带修整术	chun'she'ji'dai'xiu'zheng'shu	0
唇炎	chun'yan	0
瓷熔附金属全冠	ci'rong'fu'jin'shu'quan'guan	0
大仑丁性牙龈增生	da'lun'ding'xing'ya'yin'zeng'sheng	0
戴牙须知	dai'ya'xu'zhi	0
带状疱疹	dai'zhuang'pao'zhen	0
单纯疱疹病毒	dan'chun'pao'zhen'bing'du	0
单根牙拔牙窝内种植	dan'gen'ya'ba'ya'wo'nei'zhong'zhi	0
单颌全口义齿	dan'he'quan'kou'yi'chi	0
单颗后牙位点的种植修复	dan'ke'hou'ya'wei'dian'de'zhong'zhi'xiu'fu	0
单颗前牙位点的种植修复	dan'ke'qian'ya'wei'dian'de'zhong'zhi'xiu'fu	0
地图舌	di'tu'she	0
多根牙拔牙窝内种植	duo'gen'ya'ba'ya'wo'nei'zhong'zhi	0
多形渗出性红肿	duo'xing'shen'chu'xing'hong'zhong	0
恶性多形性腺瘤	e'xing'duo'xing'xing'xian'liu	0
儿童牙外伤	er'tong'ya'wai'shang	0
儿童牙周组织病	er'tong'ya'zhou'zu'zhi'bing	0
放射性骨坏死	fang'she'xing'gu'huai'si	0
放射性口炎	fang'she'xing'kou'yan	0
分类的决定因素	fen'lei'de'jue'ding'yin'su	0
复发坏死性粘液腺周围炎	fu'fa'huai'si'xing'nian'ye'xian'zhou'wei'yan	0
复发性口疮	fu'fa'xing'kou'chuang	0
覆盖全口义齿	fu'gai'quan'kou'yi'chi	0
氟牙症	fu'ya'zheng	0
复诊	fu'zhen	0
盖髓术	gai'sui'shu	0
干槽症	gan'cao'zheng	0
干髓术	gan'sui'shu	0
根管治疗术	gen'guan'zhi'liao'shu	0
根尖囊肿	gen'jian'nang'zhong	0
根尖切除术	gen'jian'qie'chu'shu	0
根尖诱导成形术	gen'jian'you'dao'cheng'xing'shu	0
根尖周病	gen'jian'zhou'bing	0
根尖周炎	gen'jian'zhou'yan	0
耿威	geng'wei	0
汞中毒	gong'zhong'du	0
沟纹舌	gou'wen'she	0
固定可摘联合义齿	gu'ding'ke'zhai'lian'he'yi'chi	0
固定义齿	gu'ding'yi'chi	0
骨隆突修整术	gu'long'tu'xiu'zheng'shu	0
固位体	gu'wei'ti	0
固位稳定原理	gu'wei'wen'ding'yuan'li	0
骨纤维异常增殖症	gu'xian'wei'yi'chang'zeng'zhi'zheng	0
固有层	gu'you'ceng	0
骨折愈合的机理	gu'zhe'yu'he'de'ji'li	0
骨折愈合的特点	gu'zhe'yu'he'de'te'dian	0
骨种植体接触	gu'zhong'zhi'ti'jie'chu	0
骨种植体界面	gu'zhong'zhi'ti'jie'mian	0
关节外强直	guan'jie'wai'qiang'zhi	0
冠周炎	guan'zhou'yan	0
灌注模型	guan'zhu'mo'xing	0
国际口腔医学杂志	guo'ji'kou'qiang'yi'xue'za'zhi	0
国外医学口腔医学分册	guo'wai'yi'xue'kou'qiang'yi'xue'fen'ce	0
焊接技术	han'jie'ji'shu	0
颌骨结核梅毒	he'gu'jie'he'mei'du	0
颌骨育畸形	he'gu'yu'ji'xing	0
合理的排牙有利于固位的形态	he'li'de'pai'ya'you'li'yu'gu'wei'de'xing'tai	0
颌面部放线菌病	he'mian'bu'fang'xian'jun'bing	0
颌面部火器伤的致伤因素	he'mian'bu'huo'qi'shang'de'zhi'shang'yin'su	0
颌面部间隙感染	he'mian'bu'jian'xi'gan'ran	0
颌面部缺损修复	he'mian'bu'que'sun'xiu'fu	0
颌面部整复手术	he'mian'bu'zheng'fu'shou'shu	0
颌位关系的记录	he'wei'guan'xi'de'ji'lu	0
颌位关系的转移	he'wei'guan'xi'de'zhuan'yi	0
颌下腺	he'xia'xian	0
颌周间隙感染	he'zhou'jian'xi'gan'ran	0
化脓性根尖周炎	hua'nong'xing'gen'jian'zhou'yan	0
化脓性颌骨骨髓炎	hua'nong'xing'he'gu'gu'sui'yan	0
华西口腔医学杂志	hua'xi'kou'qiang'yi'xue'za'zhi	0
坏死性龈口炎	huai'si'xing'yin'kou'yan	0
基础医学	ji'chu'yi'xue	0
基底膜复合物	ji'di'mo'fu'he'wu	0
肌上皮瘤	ji'shang'pi'liu	0
即时全口义齿	ji'shi'quan'kou'yi'chi	0
基托	ji'tuo	0
基托范围	ji'tuo'fan'wei	0
急性根尖周炎	ji'xing'gen'jian'zhou'yan	0
急性化脓性腮腺炎	ji'xing'hua'nong'xing'sai'xian'yan	0
急性假膜型	ji'xing'jia'mo'xing	0
急性淋巴结炎	ji'xing'lin'ba'jie'yan	0
急性萎缩型	ji'xing'wei'suo'xing	0
急性牙髓炎	ji'xing'ya'sui'yan	0
基牙	ji'ya	0
间接贴面粘结修复的基本技术	jian'jie'tie'mian'nian'jie'xiu'fu'de'ji'ben'ji'shu	0
尖锐湿疣	jian'rui'shi'you	0
接触性口炎	jie'chu'xing'kou'yan	0
禁忌症	jin'ji'zheng	0
菌斑	jun'ban	0
卡它性龈炎	ka'ta'xing'yin'yan	0
烤瓷修复体的制作技术	kao'ci'xiu'fu'ti'de'zhi'zuo'ji'shu	0
可摘部分义齿	ke'zhai'bu'fen'yi'chi	0
口底	kou'di	0
口呼吸增生性龈炎	kou'hu'xi'zeng'sheng'xing'yin'yan	0
口角炎	kou'jiao'yan	0
口腔白斑病	kou'qiang'bai'ban'bing	0
口腔白色角化病	kou'qiang'bai'se'jiao'hua'bing	0
口腔本部	kou'qiang'ben'bu	0
口腔扁平苔癣	kou'qiang'bian'ping'tai'xuan	0
口腔材料器械杂志	kou'qiang'cai'liao'qi'xie'za'zhi	0
口腔单纯疱疹	kou'qiang'dan'chun'pao'zhen	0
口腔颌面部的囊肿	kou'qiang'he'mian'bu'de'nang'zhong	0
口腔颌面部感染	kou'qiang'he'mian'bu'gan'ran	0
口腔颌面部后天资畸形和缺损	kou'qiang'he'mian'bu'hou'tian'zi'ji'xing'he'que'sun	0
口腔颌面部局麻操作方法	kou'qiang'he'mian'bu'ju'ma'cao'zuo'fang'fa	0
口腔颌面部囊肿	kou'qiang'he'mian'bu'nang'zhong	0
口腔颌面部损伤	kou'qiang'he'mian'bu'sun'shang	0
口腔颌面部损伤的急救处理原则	kou'qiang'he'mian'bu'sun'shang'de'ji'jiu'chu'li'yuan'ze	0
口腔颌面部肿瘤	kou'qiang'he'mian'bu'zhong'liu	0
口腔颌面材料麻醉与镇痛	kou'qiang'he'mian'cai'liao'ma'zui'yu'zhen'tong	0
口腔颌面外科学	kou'qiang'he'mian'wai'ke'xue	0
口腔颌面外科杂志	kou'qiang'he'mian'wai'ke'za'zhi	0
口腔颌面外临床检查	kou'qiang'he'mian'wai'lin'chuang'jian'cha	0
口腔颌面修复学杂志	kou'qiang'he'mian'xiu'fu'xue'za'zhi	0
口腔红斑病	kou'qiang'hong'ban'bing	0
口腔结核	kou'qiang'jie'he	0
口腔解剖生理学	kou'qiang'jie'pou'sheng'li'xue	0
口腔局部麻醉技术	kou'qiang'ju'bu'ma'zui'ji'shu	0
口腔囊肿摘除术	kou'qiang'nang'zhong'zhai'chu'shu	0
口腔粘膜癌	kou'qiang'nian'mo'ai	0
口腔粘膜斑纹类疾病	kou'qiang'nian'mo'ban'wen'lei'ji'bing	0
口腔粘膜变态反应疾病	kou'qiang'nian'mo'bian'tai'fan'ying'ji'bing	0
口腔粘膜病	kou'qiang'nian'mo'bing	0
口腔粘膜大疱类疾病	kou'qiang'nian'mo'da'pao'lei'ji'bing	0
口腔粘膜大疱性类天疱疮	kou'qiang'nian'mo'da'pao'xing'lei'tian'pao'chuang	0
口腔粘膜的屏障功能	kou'qiang'nian'mo'de'ping'zhang'gong'neng	0
口腔粘膜肉芽肿性疾病	kou'qiang'nian'mo'rou'ya'zhong'xing'ji'bing	0
口腔粘膜色素异常	kou'qiang'nian'mo'se'su'yi'chang	0
口腔粘膜上皮组织	kou'qiang'nian'mo'shang'pi'zu'zhi	0
口腔念珠菌病	kou'qiang'nian'zhu'jun'bing	0
口腔前庭	kou'qiang'qian'ting	0
口腔上颌窦瘘修补术	kou'qiang'shang'he'dou'lou'xiu'bu'shu	0
口腔修复学	kou'qiang'xiu'fu'xue	0
口腔医学	kou'qiang'yi'xue	0
口腔医学研究	kou'qiang'yi'xue'yan'jiu	0
口腔预备	kou'qiang'yu'bei	0
口腔正畸学	kou'qiang'zheng'ji'xue	0
口腔种植的分子生物学基础	kou'qiang'zhong'zhi'de'fen'zi'sheng'wu'xue'ji'chu	0
口腔种植手术	kou'qiang'zhong'zhi'shou'shu	0
口腔组织病理学	kou'qiang'zu'zhi'bing'li'xue	0
眶底骨折	kuang'di'gu'zhe	0
扩散途径	kuo'san'tu'jing	0
蕾状期	lei'zhuang'qi	0
冷冻麻醉	leng'dong'ma'zui	0
李一弗病	li'yi'fu'bing	0
连接体	lian'jie'ti	0
淋巴管瘤	lin'ba'guan'liu	0
淋巴上皮病	lin'ba'shang'pi'bing	0
临床口腔医学杂志	lin'chuang'kou'qiang'yi'xue'za'zhi	0
磷中毒	lin'zhong'du	0
鳞状细胞癌	lin'zhuang'xi'bao'ai	0
菱形舌	ling'xing'she	0
铝核瓷全冠	lv'he'ci'quan'guan	0
慢性肥厚型	man'xing'fei'hou'xing	0
慢性根尖周炎	man'xing'gen'jian'zhou'yan	0
慢性淋巴结炎的诊断及鉴别诊断	man'xing'lin'ba'jie'yan'de'zhen'duan'ji'jian'bie'zhen'duan	0
慢性涎腺炎	man'xing'xian'xian'yan	0
慢性牙髓炎	man'xing'ya'sui'yan	0
毛舌	mao'she	0
帽状期	mao'zhuang'qi	0
美学修正因素	mei'xue'xiu'zheng'yin'su	0
萌出性龈炎	meng'chu'xing'yin'yan	0
面肌抽搐	mian'ji'chou'chu	0
内源性色素沉着	nei'yuan'xing'se'su'chen'zhuo	0
粘结桥	nian'jie'qiao	0
粘膜下层	nian'mo'xia'ceng	0
年轻恒牙	nian'qing'heng'ya	0
粘液表皮样癌	nian'ye'biao'pi'yang'ai	0
粘液囊肿	nian'ye'nang'zhong	0
颞颌关节成形术	nie'he'guan'jie'cheng'xing'shu	0
颞颌关节内强直	nie'he'guan'jie'nei'qiang'zhi	0
颞颌关节前脱位	nie'he'guan'jie'qian'tuo'wei	0
颞颌关节紊乱病	nie'he'guan'jie'wen'luan'bing	0
颞下颌关节	nie'xia'he'guan'jie	0
颞下颌关节疾病	nie'xia'he'guan'jie'ji'bing	0
盘状红斑狼疮	pan'zhuang'hong'ban'lang'chuang	0
嵌体	qian'ti	0
前庭沟加深术	qian'ting'gou'jia'shen'shu	0
铅中毒	qian'zhong'du	0
切髓术	qie'sui'shu	0
青春发育期龈炎	qing'chun'fa'yu'qi'yin'yan	0
青少年牙周炎	qing'shao'nian'ya'zhou'yan	0
球菌性口角炎	qiu'jun'xing'kou'jiao'yan	0
球菌性口炎	qiu'jun'xing'kou'yan	0
球状上颌囊肿	qiu'zhuang'shang'he'nang'zhong	0
龋病	qu'bing	0
去髓术	qu'sui'shu	0
颧骨颧弓骨折	quan'gu'quan'gong'gu'zhe	0
全口义齿修复	quan'kou'yi'chi'xiu'fu	0
全身并发症	quan'shen'bing'fa'zheng	0
人工牙	ren'gong'ya	0
人工牙的排列	ren'gong'ya'de'pai'lie	0
人造冠的设计	ren'zao'guan'de'she'ji	0
人造冠修复	ren'zao'guan'xiu'fu	0
日本口腔学会杂志	ri'ben'kou'qiang'xue'hui'za'zhi	0
肉瘤	rou'liu	0
乳头状瘤	ru'tou'zhuang'liu	0
乳牙	ru'ya	0
乳牙生理性牙根吸收	ru'ya'sheng'li'xing'ya'gen'xi'shou	0
软组织伤清创术	ruan'zu'zhi'shang'qing'chuang'shu	0
腮腺	sai'xian	0
上海口腔医学	shang'hai'kou'qiang'yi'xue	0
上颌骨骨折	shang'he'gu'gu'zhe	0
舌癌	she'ai	0
舌疾病	she'ji'bing	0
舌乳头炎	she'ru'tou'yan	0
舌痛症	she'tong'zheng	0
舌下腺	she'xia'xian	0
舌下腺囊肿	she'xia'xian'nang'zhong	0
舌咽神经痛	she'yan'shen'jing'tong	0
深龋再矿化治疗	shen'qu'zai'kuang'hua'zhi'liao	0
生物材料学	sheng'wu'cai'liao'xue	0
生物力学等	sheng'wu'li'xue'deng	0
生物力学分析	sheng'wu'li'xue'fen'xi	0
适应症	shi'ying'zheng	0
实用口腔医学杂志	shi'yong'kou'qiang'yi'xue'za'zhi	0
手术同意书上签字	shou'shu'tong'yi'shu'shang'qian'zi	0
手足口病	shou'zu'kou'bing	0
术前准备	shu'qian'zhun'bei	0
四环素牙	si'huan'su'ya	0
宿玉成	su'yu'cheng	0
随意皮瓣	sui'yi'pi'ban	0
特异性颌骨感染	te'yi'xing'he'gu'gan'ran	0
贴面修复技术	tie'mian'xiu'fu'ji'shu	0
外科修正因素	wai'ke'xiu'zheng'yin'su	0
外源性色素沉着	wai'yuan'xing'se'su'chen'zhuo	0
萎缩性舌炎	wei'suo'xing'she'yan	0
无菌操作技术	wu'jun'cao'zuo'ji'shu	0
无牙颌的解剖标志	wu'ya'he'de'jie'pou'biao'zhi	0
无牙颌的解剖生理特点	wu'ya'he'de'jie'pou'sheng'li'te'dian	0
系统疾病的口腔表现	xi'tong'ji'bing'de'kou'qiang'biao'xian	0
下颌骨骨折	xia'he'gu'gu'zhe	0
下颌下	xia'he'xia	0
现代口腔医学杂志	xian'dai'kou'qiang'yi'xue'za'zhi	0
现代口腔种植学	xian'dai'kou'qiang'zhong'zhi'xue	0
腺淋巴瘤	xian'lin'ba'liu	0
涎石病	xian'shi'bing	0
先天性单侧裂修补术	xian'tian'xing'dan'ce'lie'xiu'bu'shu	0
涎腺	xian'xian	0
涎腺多形性腺瘤	xian'xian'duo'xing'xing'xian'liu	0
腺样囊性癌	xian'yang'nang'xing'ai	0
橡皮圈性急性牙周炎	xiang'pi'quan'xing'ji'xing'ya'zhou'yan	0
修复分类的原则	xiu'fu'fen'lei'de'yuan'ze	0
修复前的基本准备	xiu'fu'qian'de'ji'ben'zhun'bei	0
修复修正因素	xiu'fu'xiu'zheng'yin'su	0
修正因素	xiu'zheng'yin'su	0
血管瘤	xue'guan'liu	0
血管神经水肿	xue'guan'shen'jing'shui'zhong	0
牙本质龋	ya'ben'zhi'qu	0
牙槽骨	ya'cao'gu	0
牙槽骨修整术	ya'cao'gu'xiu'zheng'shu	0
牙槽嵴	ya'cao'ji	0
牙槽嵴增高术	ya'cao'ji'zeng'gao'shu	0
牙槽脓肿	ya'cao'nong'zhong	0
牙齿的发育	ya'chi'de'fa'yu	0
牙齿脱位	ya'chi'tuo'wei	0
牙齿折断	ya'chi'zhe'duan	0
牙齿撞伤	ya'chi'zhuang'shang	0
牙骨质龋	ya'gu'zhi'qu	0
牙颌面畸形	ya'he'mian'ji'xing	0
牙及牙槽骨损伤	ya'ji'ya'cao'gu'sun'shang	0
牙及牙槽外科	ya'ji'ya'cao'wai'ke	0
牙列拥挤性龈炎	ya'lie'yong'ji'xing'yin'yan	0
牙胚	ya'pei	0
牙髓病	ya'sui'bing	0
牙髓充血	ya'sui'chong'xue	0
牙髓坏死	ya'sui'huai'si	0
牙髓炎	ya'sui'yan	0
牙体缺损病因	ya'ti'que'sun'bing'yin	0
牙体缺损的修复	ya'ti'que'sun'de'xiu'fu	0
牙体牙周支持组织的应力分析	ya'ti'ya'zhou'zhi'chi'zu'zhi'de'ying'li'fen'xi	0
牙龈	ya'yin	0
牙龈病	ya'yin'bing	0
牙龈瘤	ya'yin'liu	0
牙源性囊肿	ya'yuan'xing'nang'zhong	0
牙源性腺样瘤	ya'yuan'xing'xian'yang'liu	0
牙种植学	ya'zhong'zhi'xue	0
牙周变性	ya'zhou'bian'xing	0
牙周创伤	ya'zhou'chuang'shang	0
牙周膜	ya'zhou'mo	0
牙周炎	ya'zhou'yan	0
牙周组织病	ya'zhou'zu'zhi'bing	0
颜部疖痈的临床特点及治疗原则	yan'bu'jie'yong'de'lin'chuang'te'dian'ji'zhi'liao'yuan'ze	0
严格树立无菌观念	yan'ge'shu'li'wu'jun'guan'nian	0
颜面疼痛	yan'mian'teng'tong	0
咬合关系	yao'he'guan'xi	0
咬肌间隙感染	yao'ji'jian'xi'gan'ran	0
药物过敏性口炎	yao'wu'guo'min'xing'kou'yan	0
义齿支架的弯制技术	yi'chi'zhi'jia'de'wan'zhi'ji'shu	0
遗传性牙龈纤维瘤	yi'chuan'xing'ya'yin'xian'wei'liu	0
营养不良性口角炎	ying'yang'bu'liang'xing'kou'jiao'yan	0
婴幼儿创伤性溃疡	ying'you'er'chuang'shang'xing'kui'yang	0
婴幼儿颌骨骨髓炎	ying'you'er'he'gu'gu'sui'yan	0
游离皮片	you'li'pi'pian	0
釉质发育不全	you'zhi'fa'yu'bu'quan	0
釉质龋	you'zhi'qu	0
原发性三叉神经痛	yuan'fa'xing'san'cha'shen'jing'tong	0
原位癌	yuan'wei'ai	0
暂时冠	zan'shi'guan	0
造釉细胞瘤	zao'you'xi'bao'liu	0
真菌性口角炎	zhen'jun'xing'kou'jiao'yan	0
正确地恢复形态与功能	zheng'que'di'hui'fu'xing'tai'yu'gong'neng	0
智齿冠周炎	zhi'chi'guan'zhou'yan	0
治疗程序	zhi'liao'cheng'xu	0
制取印模	zhi'qu'yin'mo	0
支托	zhi'tuo	0
制作印模和模型的技术	zhi'zuo'yin'mo'he'mo'xing'de'ji'shu	0
中国口腔颌面外科杂志	zhong'guo'kou'qiang'he'mian'wai'ke'za'zhi	0
中国口腔医学继续教育杂志	zhong'guo'kou'qiang'yi'xue'ji'xu'jiao'yu'za'zhi	0
中国口腔种植学杂志	zhong'guo'kou'qiang'zhong'zhi'xue'za'zhi	0
中华口腔医学杂志	zhong'hua'kou'qiang'yi'xue'za'zhi	0
中华老年口腔医学杂志	zhong'hua'lao'nian'kou'qiang'yi'xue'za'zhi	0
中温和高温铸造技术	zhong'wen'he'gao'wen'zhu'zao'ji'shu	0
种植手术的并发症	zhong'zhi'shou'shu'de'bing'fa'zheng	0
种植外科	zhong'zhi'wai'ke	0
种植学	zhong'zhi'xue	0
种植义齿的成功术标准	zhong'zhi'yi'chi'de'cheng'gong'shu'biao'zhun	0
种植义齿的生理学基础	zhong'zhi'yi'chi'de'sheng'li'xue'ji'chu	0
种植义齿的修复方法和步骤	zhong'zhi'yi'chi'de'xiu'fu'fang'fa'he'bu'zhou	0
种植义齿的优缺点和适应症	zhong'zhi'yi'chi'de'you'que'dian'he'shi'ying'zheng	0
钟状期	zhong'zhuang'qi	0
周围性面瘫	zhou'wei'xing'mian'tan	0
铸造金属全冠	zhu'zao'jin'shu'quan'guan	0
转移颌位关系	zhuan'yi'he'wei'guan'xi	0
桩冠	zhuang'guan	0
自体免疫性疾病	zi'ti'mian'yi'xing'ji'bing	0
阻生牙	zu'sheng'ya	0
阻生牙拔除术	zu'sheng'ya'ba'chu'shu	0
组织移植	zu'zhi'yi'zhi	0
最权威的口腔种植学论著	zui'quan'wei'de'kou'qiang'zhong'zhi'xue'lun'zhu	0
