阿不福思	a'bu'fu'si	0
阿不福思邓不利多	a'bu'fu'si'deng'bu'li'duo	0
阿不思	a'bu'si	0
阿不思邓不利多	a'bu'si'deng'bu'li'duo	0
阿德里安普塞	a'de'li'an'pu'sai	0
阿拉巴种马	a'la'ba'zhong'ma	0
阿拉戈克	a'la'ge'ke	0
阿拉霍洞开	a'la'huo'dong'kai	0
阿拉斯托	a'la'si'tuo	0
阿拉斯托穆迪	a'la'si'tuo'mu'di	0
阿芒多迪佩特	a'mang'duo'di'pei'te	0
阿莫斯	a'mo'si	0
阿尼玛格斯	a'ni'ma'ge'si	0
阿尼麦米兰	a'ni'mai'mi'lan	0
阿瑞娜邓布利多	a'rui'na'deng'bu'li'duo	0
阿瑟	a'se	0
阿瓦达索命	a'wa'da'suo'ming	0
阿魏拉	a'wei'la	0
阿兹卡班	a'zi'ka'ban	0
艾博	ai'bo	0
爱尔兰小矮妖	ai'er'lan'xiao'ai'yao	0
埃莉诺布兰斯通	ai'li'nuo'bu'lan'si'tong	0
艾丽娅	ai'li'ya	0
艾丽娅斯平内特	ai'li'ya'si'ping'nei'te	0
爱洛伊斯米德根	ai'luo'yi'si'mi'de'gen	0
埃玛多布斯	ai'ma'duo'bu'si	0
艾玛沃特森	ai'ma'wo'te'sen	0
安德鲁柯克	an'de'lu'ke'ke	0
安东尼戈德斯坦	an'dong'ni'ge'de'si'tan	0
安吉利娜	an'ji'li'na	0
安吉利娜约翰逊	an'ji'li'na'yue'han'xun	0
奥菲利娅	ao'fei'li'ya	0
奥拉奎克	ao'la'kui'ke	0
奥利凡德	ao'li'fan'de	0
奥利弗	ao'li'fu	0
奥利弗伍德	ao'li'fu'wu'de	0
傲罗	ao'luo	0
傲罗指挥部	ao'luo'zhi'hui'bu	0
奥斯里克	ao'si'li'ke	0
巴蒂	ba'di	0
巴蒂克劳奇	ba'di'ke'lao'qi	0
巴费醒脑剂	ba'fei'xing'nao'ji	0
巴格曼	ba'ge'man	0
巴克比克	ba'ke'bi'ke	0
八眼巨蛛	ba'yan'ju'zhu	0
白金荣耀	bai'jin'rong'yao	0
白鲜	bai'xian	0
白鲜香精	bai'xian'xiang'jing	0
斑斑	ban'ban	0
保护神奇生物	bao'hu'shen'qi'sheng'wu	0
贝恩	bei'en	0
贝尔	bei'er	0
贝拉特里克斯	bei'la'te'li'ke'si	0
贝拉特里克斯莱斯特兰奇	bei'la'te'li'ke'si'lai'si'te'lan'qi	0
被迫献出	bei'po'xian'chu	0
比比多味豆	bi'bi'duo'wei'dou	0
彼得	bi'de	0
比尔	bi'er	0
闭耳塞听	bi'er'sai'ting	0
比尔韦斯莱	bi'er'wei'si'lai	0
鼻涕虫	bi'ti'chong	0
变出一桌成盛宴	bian'chu'yi'zhuo'cheng'sheng'yan	0
变身水	bian'shen'shui	0
变形课	bian'xing'ke	0
变形术	bian'xing'shu	0
标记显现	biao'ji'xian'xian	0
标准咒语	biao'zhun'zhou'yu	0
冰糕球	bing'gao'qiu	0
波尔	bo'er	0
博格特	bo'ge'te	0
拨开迷雾看未来	bo'kai'mi'wu'kan'wei'lai	0
波洛涅斯	bo'luo'nie'si	0
勃那多	bo'na'duo	0
伯莎	bo'sha	0
伯斯德	bo'si'de	0
波特	bo'te	0
不可标绘	bu'ke'biao'hui	0
不可饶恕咒	bu'ke'rao'shu'zhou	0
布拉德利	bu'la'de'li	0
布莱克	bu'lai'ke	0
布莱克家族	bu'lai'ke'jia'zu	0
布莱斯扎比尼	bu'lai'si'zha'bi'ni	0
布朗	bu'lang	0
布斯巴顿	bu'si'ba'dun	0
补血药	bu'xue'yao	0
草药	cao'yao	0
草药课	cao'yao'ke	0
差点没头的尼克	cha'dian'mei'tou'de'ni'ke	0
查理	cha'li	0
唱唱反调	chang'chang'fan'diao	0
长袍	chang'pao	0
长袍专卖店	chang'pao'zhuan'mai'dian	0
长生不老药	chang'sheng'bu'lao'yao	0
超级吹宝泡泡糖	chao'ji'chui'bao'pao'pao'tang	0
赤胆忠心咒	chi'dan'zhong'xin'zhou	0
虫尾巴	chong'wei'ba	0
仇敌的血	chou'di'de'xue	0
雏黄甜奶油和阳光	chu'huang'tian'nai'you'he'yang'guang	0
除你武器	chu'ni'wu'qi	0
初学变形指南	chu'xue'bian'xing'zhi'nan	0
处子鉴定	chu'zi'jian'ding	0
词典飞来	ci'dian'fei'lai	0
从孵蛋到涅磐	cong'fu'dan'dao'nie'pan	0
达达小心肝	da'da'xiao'xin'gan	0
达芙尼格林格拉斯	da'fu'ni'ge'lin'ge'la'si	0
打嗝水	da'ge'shui	0
大脚板	da'jiao'ban	0
达力	da'li	0
大脑飞来	da'nao'fei'lai	0
大脑封闭术	da'nao'feng'bi'shu	0
打人柳	da'ren'liu	0
戴维斯	dai'wei'si	0
蛋奶酒	dan'nai'jiu	0
丹尼尔雷德克里夫	dan'ni'er'lei'de'ke'li'fu	0
丹尼斯	dan'ni'si	0
丹尼斯克里维	dan'ni'si'ke'li'wei	0
淡水普利姆莱汤	dan'shui'pu'li'mu'lai'tang	0
当代著名魔法家名录	dang'dai'zhu'ming'mo'fa'jia'ming'lu	0
倒挂金钟	dao'gua'jin'zhong	0
德拉科	de'la'ke	0
德拉科马尔福	de'la'ke'ma'er'fu	0
德拉库尔	de'la'ku'er	0
德利克	de'li'ke	0
德米尔扎罗宾斯	de'mi'er'zha'luo'bin'si	0
德姆斯特朗	de'mu'si'te'lang	0
德瑞	de'rui	0
德斯礼	de'si'li	0
邓不利多	deng'bu'li'duo	0
邓布利多	deng'bu'li'duo	0
邓布利多军	deng'bu'li'duo'jun	0
邓万里	deng'wan'li	0
迪安	di'an	0
迪安托马斯	di'an'tuo'ma'si	0
迪戈里	di'ge'li	0
地精	di'jing	0
定向咒	ding'xiang'zhou	0
洞听	dong'ting	0
斗篷	dou'peng	0
毒参茄	du'can'qie	0
独角兽	du'jiao'shou	0
毒菌大全	du'jun'da'quan	0
对角巷	dui'jiao'xiang	0
对学校特殊贡献奖	dui'xue'xiao'te'shu'gong'xian'jiang	0
多比	duo'bi	0
夺魂咒	duo'hun'zhou	0
多毛咒	duo'mao'zhou	0
厄里斯魔镜	e'li'si'mo'jing	0
厄尼	e'ni	0
恶作剧完毕	e'zuo'ju'wan'bi	0
二十世纪的大巫师	er'shi'shi'ji'de'da'wu'shi	0
二十世纪重要魔法事件	er'shi'shi'ji'zhong'yao'mo'fa'shi'jian	0
二小丑	er'xiao'chou	0
翻倒巷	fan'dao'xiang	0
放气水	fang'qi'shui	0
防水防湿	fang'shui'fang'shi	0
防雨防湿	fang'yu'fang'shi	0
费尔奇	fei'er'qi	0
飞来飞去	fei'lai'fei'qu	0
飞来咒	fei'lai'zhou	0
费雷德韦斯莱	fei'lei'de'wei'si'lai	0
飞路粉	fei'lu'fen	0
飞路网	fei'lu'wang	0
费伦泽	fei'lun'ze	0
飞马	fei'ma	0
斐尼甘	fei'ni'gan	0
菲尼亚斯奈杰勒斯	fei'ni'ya'si'nai'jie'le'si	0
飞鸟群群	fei'niao'qun'qun	0
飞沙走石	fei'sha'zou'shi	0
肥舌太妃糖	fei'she'tai'fei'tang	0
飞天扫帚	fei'tian'sao'zhou	0
飞天扫帚护理手册	fei'tian'sao'zhou'hu'li'shou'ce	0
飞行	fei'xing	0
飞行课	fei'xing'ke	0
芬列里	fen'lie'li	0
粉身碎骨	fen'shen'sui'gu	0
粪石	fen'shi	0
粉碎咒	fen'sui'zhou	0
分体	fen'ti	0
分院帽	fen'yuan'mao	0
凤凰	feng'huang	0
凤凰社	feng'huang'she	0
疯麻瓜马丁米格历险记	feng'ma'gua'ma'ding'mi'ge'li'xian'ji	0
蜂蜜公爵	feng'mi'gong'jue	0
蜂蜜公爵糖果店	feng'mi'gong'jue'tang'guo'dian	0
疯眼汉	feng'yan'han	0
疯眼汉穆迪	feng'yan'han'mu'di	0
伏地魔	fu'di'mo	0
福丁布拉斯	fu'ding'bu'la'si	0
复方汤剂	fu'fang'tang'ji	0
复活石	fu'huo'shi	0
福吉	fu'ji	0
福克斯	fu'ke'si	0
弗兰西斯科	fu'lan'xi'si'ke	0
弗雷德	fu'lei'de	0
弗雷德韦斯莱	fu'lei'de'wei'si'lai	0
弗立维	fu'li'wei	0
弗林特	fu'lin'te	0
福灵剂	fu'ling'ji	0
弗洛伯毛虫	fu'luo'bo'mao'chong	0
弗农	fu'nong	0
弗农德思礼	fu'nong'de'si'li	0
父亲的骨	fu'qin'de'gu	0
芙蓉	fu'rong	0
附身	fu'shen	0
伏提曼德	fu'ti'man'de	0
福西特	fu'xi'te	0
复制成双	fu'zhi'cheng'shuang	0
甘草魔杖	gan'cao'mo'zhang	0
坩埚	gan'guo	0
坩埚蛋糕	gan'guo'dan'gao	0
高布石	gao'bu'shi	0
高布石游戏	gao'bu'shi'you'xi	0
高尔	gao'er	0
高锥克山谷	gao'zhui'ke'shan'gu	0
戈巴洛特第三定律	ge'ba'luo'te'di'san'ding'lv	0
戈德里克	ge'de'li'ke	0
戈德里克格兰芬多	ge'de'li'ke'ge'lan'fen'duo	0
戈德里克山谷	ge'de'li'ke'shan'gu	0
格兰芬多	ge'lan'fen'duo	0
格兰芬多公共休息室	ge'lan'fen'duo'gong'gong'xiu'xi'shi	0
格兰芬多塔楼	ge'lan'fen'duo'ta'lou	0
格兰杰	ge'lan'jie	0
格兰普兰	ge'lan'pu'lan	0
格雷厄姆普里乍得	ge'lei'e'mu'pu'li'zha'de	0
格雷戈里高尔	ge'lei'ge'li'gao'er	0
格里莫广场	ge'li'mo'guang'chang	0
格里莫广场号	ge'li'mo'guang'chang'hao	0
格林迪洛	ge'lin'di'luo	0
格洛普	ge'luo'pu	0
胳肢魔咒	ge'zhi'mo'zhou	0
给你的奶酪施上魔法	gei'ni'de'nai'lao'shi'shang'mo'fa	0
给我指路	gei'wo'zhi'lu	0
公共休息室	gong'gong'xiu'xi'shi	0
古代魔文	gu'dai'mo'wen	0
古代魔文研究	gu'dai'mo'wen'yan'jiu	0
古老魔法和咒语	gu'lao'mo'fa'he'zhou'yu	0
古灵阁	gu'ling'ge	0
怪兽及其产地	guai'shou'ji'qi'chan'di	0
光亮咒	guang'liang'zhou	0
光轮	guang'lun	0
光荣之手	guang'rong'zhi'shou	0
鬼飞球	gui'fei'qiu	0
国际魔法合作司	guo'ji'mo'fa'he'zuo'si	0
锅形蛋糕	guo'xing'dan'gao	0
哈利	ha'li	0
哈利波特	ha'li'bo'te	0
哈利波特与阿兹卡班的囚徒	ha'li'bo'te'yu'a'zi'ka'ban'de'qiu'tu	0
哈利波特与凤凰社	ha'li'bo'te'yu'feng'huang'she	0
哈利波特与混血王子	ha'li'bo'te'yu'hun'xue'wang'zi	0
哈利波特与火焰杯	ha'li'bo'te'yu'huo'yan'bei	0
哈利波特与密室	ha'li'bo'te'yu'mi'shi	0
哈利波特与魔法石	ha'li'bo'te'yu'mo'fa'shi	0
哈利波特与死圣	ha'li'bo'te'yu'si'sheng	0
哈利波特与死亡圣器	ha'li'bo'te'yu'si'wang'sheng'qi	0
哈利詹姆波特	ha'li'zhan'mu'bo'te	0
哈罗德丁戈	ha'luo'de'ding'ge	0
哈珀	ha'po	0
海德薇	hai'de'wei	0
海格	hai'ge	0
汉娜	han'na	0
汉娜艾宝	han'na'ai'bao	0
豪猪刺	hao'zhu'ci	0
赫尔加	he'er'jia	0
赫尔加赫奇帕奇	he'er'jia'he'qi'pa'qi	0
和火炮队一起飞翔	he'huo'pao'dui'yi'qi'fei'xiang	0
赫敏	he'min	0
赫敏格兰杰	he'min'ge'lan'jie	0
赫敏简格兰杰	he'min'jian'ge'lan'jie	0
赫敏韦斯莱	he'min'wei'si'lai	0
赫奇帕奇	he'qi'pa'qi	0
赫奇帕奇公共休息室	he'qi'pa'qi'gong'gong'xiu'xi'shi	0
黑暗力量	hei'an'li'liang	0
黑湖	hei'hu	0
黑魔标记	hei'mo'biao'ji	0
黑魔法	hei'mo'fa	0
黑魔法的兴衰	hei'mo'fa'de'xing'shuai	0
黑魔法防御	hei'mo'fa'fang'yu	0
黑魔法防御术	hei'mo'fa'fang'yu'shu	0
黑魔王	hei'mo'wang	0
黑巫师	hei'wu'shi	0
横扫星	heng'sao'xing	0
吼叫信	hou'jiao'xin	0
胡话饮料	hu'hua'yin'liao	0
狐媚子灭剂	hu'mei'zi'mie'ji	0
呼神护卫	hu'shen'hu'wei	0
护神护卫	hu'shen'hu'wei	0
滑道平平	hua'dao'ping'ping	0
滑稽滑稽	hua'ji'hua'ji	0
华丽与污痕书店	hua'li'yu'wu'hen'shu'dian	0
缓和剂	huan'he'ji	0
幻身咒	huan'shen'zhou	0
欢欣剂	huan'xin'ji	0
幻影石板	huan'ying'shi'ban	0
幻影显形	huan'ying'xian'xing	0
幻影移行	huan'ying'yi'hang	0
黄油啤酒	huang'you'pi'jiu	0
恢复如初	hui'fu'ru'chu	0
会尖叫的糖耗子	hui'jian'jiao'de'tang'hao'zi	0
会魔法的我	hui'mo'fa'de'wo	0
回生石	hui'sheng'shi	0
昏昏倒地	hun'hun'dao'di	0
魂魄出窍	hun'po'chu'qiao	0
魂器	hun'qi	0
混淆视听	hun'xiao'shi'ting	0
活点地图	huo'dian'di'tu	0
霍格莫德	huo'ge'mo'de	0
霍格沃茨	huo'ge'wo'ci	0
霍格沃茨城堡	huo'ge'wo'ci'cheng'bao	0
霍格沃茨特快列车	huo'ge'wo'ci'te'kuai'lie'che	0
霍格沃次特快列车	huo'ge'wo'ci'te'kuai'lie'che	0
火烤热辣辣	huo'kao're'la'la	0
霍拉斯斯拉格霍恩	huo'la'si'si'la'ge'huo'en	0
霍拉旭	huo'la'xu	0
火弩箭	huo'nu'jian	0
火弩箭飞来	huo'nu'jian'fei'lai	0
火螃蟹	huo'pang'xie	0
霍琦夫人	huo'qi'fu'ren	0
火蜥蜴	huo'xi'yi	0
火星棒	huo'xing'bang	0
火焰杯	huo'yan'bei	0
火焰熊熊	huo'yan'xiong'xiong	0
吉德罗	ji'de'luo	0
吉德罗洛哈特	ji'de'luo'luo'ha'te	0
吉尔登斯吞	ji'er'deng'si'tun	0
急急现形	ji'ji'xian'xing	0
吉米珀克斯	ji'mi'po'ke'si	0
击球手	ji'qiu'shou	0
记忆球	ji'yi'qiu	0
级长	ji'zhang	0
级长徽章	ji'zhang'hui'zhang	0
级长怎样获得权力	ji'zhang'zen'yang'huo'de'quan'li	0
加隆	jia'long	0
家禽还是怪兽	jia'qin'hai'shi'guai'shou	0
贾斯廷	jia'si'ting	0
贾斯廷芬列里	jia'si'ting'fen'lie'li	0
家养小精灵	jia'yang'xiao'jing'ling	0
家养小精灵权益促进会	jia'yang'xiao'jing'ling'quan'yi'cu'jin'hui	0
尖叫棚屋	jian'jiao'peng'wu	0
尖头叉子	jian'tou'cha'zi	0
见证人	jian'zheng'ren	0
奖杯飞来	jiang'bei'fei'lai	0
杰佛瑞胡珀	jie'fo'rui'hu'po	0
杰克斯劳珀	jie'ke'si'lao'po	0
近代巫术发展研究	jin'dai'wu'shu'fa'zhan'yan'jiu	0
禁忌森林	jin'ji'sen'lin	0
禁林	jin'lin	0
金妮	jin'ni	0
金妮韦斯莱	jin'ni'wei'si'lai	0
金色飞贼	jin'se'fei'zei	0
金斯莱	jin'si'lai	0
金斯莱沙克尔	jin'si'lai'sha'ke'er	0
金丝雀饼干	jin'si'que'bing'gan	0
禁止滥用麻瓜物品司	jin'zhi'lan'yong'ma'gua'wu'pin'si	0
禁止滥用魔法司	jin'zhi'lan'yong'mo'fa'si	0
金钟落地	jin'zhong'luo'di	0
九又四分之三月台	jiu'you'si'fen'zhi'san'yue'tai	0
九又四分之三站台	jiu'you'si'fen'zhi'san'zhan'tai	0
巨怪	ju'guai	0
巨人	ju'ren	0
卡多根爵士	ka'duo'gen'jue'shi	0
卡卡洛夫	ka'ka'luo'fu	0
凯蒂	kai'di	0
凯蒂贝尔	kai'di'bei'er	0
凯文惠特比	kai'wen'hui'te'bi	0
康奈利	kang'nai'li	0
康奈利奥斯瓦尔德福吉	kang'nai'li'ao'si'wa'er'de'fu'ji	0
考迈克麦克拉根	kao'mai'ke'mai'ke'la'gen	0
烤面包的魔法	kao'mian'bao'de'mo'fa	0
考尼律斯	kao'ni'lv'si	0
克劳狄斯	ke'lao'di'si	0
克劳奇	ke'lao'qi	0
克里瓦特	ke'li'wa'te	0
克里维	ke'li'wei	0
科林	ke'lin	0
科林克里维	ke'lin'ke'li'wei	0
克鲁克山	ke'lu'ke'shan	0
克鲁姆	ke'lu'mu	0
可使你的敌人复活	ke'shi'ni'de'di'ren'fu'huo	0
可使你的儿子再生	ke'shi'ni'de'er'zi'zai'sheng	0
可使你的主人重生	ke'shi'ni'de'zhu'ren'chong'sheng	0
肯尼斯托勒	ken'ni'si'tuo'le	0
苦艾	ku'ai	0
哭泣的桃金娘	ku'qi'de'tao'jin'niang	0
快快复苏	kuai'kuai'fu'su	0
快快禁锢	kuai'kuai'jin'gu	0
魁地奇	kui'di'qi	0
魁地奇溯源	kui'di'qi'su'yuan	0
盔甲护身	kui'jia'hu'shen	0
窥镜	kui'jing	0
拉环	la'huan	0
拉文德	la'wen'de	0
拉文德布朗	la'wen'de'bu'lang	0
拉文克劳	la'wen'ke'lao	0
拉文克劳公共休息室	la'wen'ke'lao'gong'gong'xiu'xi'shi	0
莱姆斯卢平	lai'mu'si'lu'ping	0
来去屋	lai'qu'wu	0
莱斯特兰奇	lai'si'te'lan'qi	0
兰花盛开	lan'hua'sheng'kai	0
狼毒药剂	lang'du'yao'ji	0
狼人	lang'ren	0
牢不可破誓言	lao'bu'ke'po'shi'yan	0
老化药	lao'hua'yao	0
劳拉马德莱	lao'la'ma'de'lai	0
老魔杖	lao'mo'zhang	0
勒梅	le'mei	0
雷奈尔多	lei'nai'er'duo	0
雷欧提斯	lei'ou'ti'si	0
里德尔	li'de'er	0
丽痕书店	li'hen'shu'dian	0
莉莉	li'li	0
莉莉波特	li'li'bo'te	0
莉莉伊万斯	li'li'yi'wan'si	0
李乔丹	li'qiao'dan	0
里切古特	li'qie'gu'te	0
莉莎杜平	li'sha'du'ping	0
力松劲泄	li'song'jin'xie	0
力松劲泻	li'song'jin'xie	0
丽塔	li'ta	0
炼金术	lian'jin'shu	0
梁凯蒂	liang'kai'di	0
烈火熊熊	lie'huo'xiong'xiong	0
咧嘴呼啦啦	lie'zui'hu'la'la	0
琳妮	lin'ni	0
灵魂伴侣	ling'hun'ban'lv	0
灵魂复苏	ling'hun'fu'su	0
隆巴顿	long'ba'dun	0
陋居	lou'ju	0
鲁伯	lu'bo	0
鲁伯海格	lu'bo'hai'ge	0
鲁伯特格林特	lu'bo'te'ge'lin'te	0
卢多	lu'duo	0
卢娜	lu'na	0
卢娜洛夫古德	lu'na'luo'fu'gu'de	0
卢平	lu'ping	0
路威	lu'wei	0
卢修斯	lu'xiu'si	0
卢修斯马尔福	lu'xiu'si'ma'er'fu	0
罗恩	luo'en	0
罗恩韦斯莱	luo'en'wei'si'lai	0
洛夫古德	luo'fu'gu'de	0
洛哈特	luo'ha'te	0
罗杰	luo'jie	0
罗杰达维	luo'jie'da'wei	0
罗琳	luo'lin	0
罗米达万尼	luo'mi'da'wan'ni	0
罗南	luo'nan	0
罗森格兰兹	luo'sen'ge'lan'zi	0
罗伊纳	luo'yi'na	0
罗伊纳拉文克劳	luo'yi'na'la'wen'ke'lao	0
马尔福	ma'er'fu	0
麻瓜	ma'gua	0
麻瓜屏蔽	ma'gua'ping'bi	0
麻瓜研究	ma'gua'yan'jiu	0
马康巴达克	ma'kang'ba'da'ke	0
马克西姆夫人	ma'ke'xi'mu'fu'ren	0
马库斯	ma'ku'si	0
马库斯弗林特	ma'ku'si'fu'lin'te	0
玛丽埃塔艾克莫	ma'li'ai'ta'ai'ke'mo	0
马人	ma'ren	0
马西勒斯	ma'xi'le'si	0
迈尔斯布莱奇	mai'er'si'bu'lai'qi	0
麦格	mai'ge	0
迈克尔科纳	mai'ke'er'ke'na	0
麦克米兰	mai'ke'mi'lan	0
麦芽威士忌	mai'ya'wei'shi'ji	0
曼德拉草	man'de'la'cao	0
曼德拉草恢复剂	man'de'la'cao'hui'fu'ji	0
曼蒂布洛贺	man'di'bu'luo'he	0
猫头鹰食	mao'tou'ying'shi	0
猫头鹰屋	mao'tou'ying'wu	0
猫头鹰邮递	mao'tou'ying'you'di	0
魅力俱乐部	mei'li'ju'le'bu	0
媚娃	mei'wa	0
门托斯	men'tuo'si	0
门牙赛大棒	men'ya'sai'da'bang	0
门牙塞大棒	men'ya'sai'da'bang	0
门钥匙	men'yao'shi	0
蒙塔古	meng'ta'gu	0
蜜蜂公爵	mi'feng'gong'jue	0
迷魂药	mi'hun'yao	0
米勒娃	mi'le'wa	0
米勒娃麦格	mi'le'wa'mai'ge	0
米里森	mi'li'sen	0
米莉森布洛德	mi'li'sen'bu'luo'de	0
迷乱药	mi'luan'yao	0
迷情剂	mi'qing'ji	0
密室	mi'shi	0
冥想盆	ming'xiang'pen	0
莫恩	mo'en	0
魔法部	mo'fa'bu	0
魔法理论	mo'fa'li'lun	0
魔法伤病医院	mo'fa'shang'bing'yi'yuan	0
魔法生物	mo'fa'sheng'wu	0
魔法史	mo'fa'shi	0
魔法石	mo'fa'shi	0
魔法兄弟喷泉	mo'fa'xiong'di'pen'quan	0
魔法学校	mo'fa'xue'xiao	0
魔法药剂与药水	mo'fa'yao'ji'yu'yao'shui	0
摩金夫人	mo'jin'fu'ren	0
莫拉格麦克道格	mo'la'ge'mai'ke'dao'ge	0
莫丽	mo'li	0
莫莉韦斯莱	mo'li'wei'si'lai	0
魔苹果	mo'ping'guo	0
莫萨格	mo'sa'ge	0
魔药	mo'yao	0
魔药课	mo'yao'ke	0
魔杖	mo'zhang	0
魔杖飞来	mo'zhang'fei'lai	0
魔咒	mo'zhou	0
魔咒课	mo'zhou'ke	0
穆迪	mu'di	0
牡鹿	mu'lu	0
娜妲莉麦唐纳	na'da'li'mai'tang'na	0
纳特	na'te	0
纳威	na'wei	0
纳维	na'wei	0
纳威隆巴顿	na'wei'long'ba'dun	0
纳西莎布莱克马尔福	na'xi'sha'bu'lai'ke'ma'er'fu	0
泥巴种	ni'ba'zhong	0
尼法朵拉	ni'fa'duo'la	0
尼法朵拉卢平	ni'fa'duo'la'lu'ping	0
尼法朵拉唐克斯	ni'fa'duo'la'tang'ke'si	0
尼可	ni'ke	0
诺伯	nuo'bo	0
诺克斯	nuo'ke'si	0
诺特	nuo'te	0
挪威脊背龙	nuo'wei'ji'bei'long	0
女贞街	nv'zhen'jie	0
欧文考德韦尔	ou'wen'kao'de'wei'er	0
帕翠霞斯廷森	pa'cui'xia'si'ting'sen	0
帕德玛	pa'de'ma	0
帕德玛帕蒂尔	pa'de'ma'pa'di'er	0
帕笛芙夫人	pa'di'fu'fu'ren	0
帕金森	pa'jin'sen	0
帕特里夏石蒂森	pa'te'li'xia'shi'di'sen	0
帕瓦蒂	pa'wa'di	0
帕瓦蒂帕蒂尔	pa'wa'di'pa'di'er	0
拍拍木	pai'pai'mu	0
潘西	pan'xi	0
潘西帕金森	pan'xi'pa'jin'sen	0
庞弗雷夫人	pang'fu'lei'fu'ren	0
胖修士	pang'xiu'shi	0
泡泡茎	pao'pao'jing	0
佩蒂尔	pei'di'er	0
佩内洛	pei'nei'luo	0
佩内洛克里瓦特	pei'nei'luo'ke'li'wa'te	0
佩妮	pei'ni	0
佩妮德思礼	pei'ni'de'si'li	0
佩皮鲁	pei'pi'lu	0
佩斯奇皮克西佩斯诺米	pei'si'qi'pi'ke'xi'pei'si'nuo'mi	0
膨豆荚	peng'dou'jia	0
膨胀药水	peng'zhang'yao'shui	0
披风	pi'feng	0
皮皮鬼	pi'pi'gui	0
漂浮咒	piao'fu'zhou	0
平安镇守	ping'an'zhen'shou	0
苹果饼	ping'guo'bing	0
平斯夫人	ping'si'fu'ren	0
破釜酒吧	po'fu'jiu'ba	0
珀西	po'xi	0
珀西韦斯莱	po'xi'wei'si'lai	0
珀西伊格内修斯韦斯莱	po'xi'yi'ge'nei'xiu'si'wei'si'lai	0
仆人的肉	pu'ren'de'rou	0
奇洛	qi'luo	0
骑士公共汽车	qi'shi'gong'gong'qi'che	0
钱伯斯	qian'bo'si	0
乾荨麻	qian'qian'ma	0
强奸药剂	qiang'jian'yao'ji	0
强力药剂	qiang'li'yao'ji	0
乔丹	qiao'dan	0
乔金斯	qiao'jin'si	0
巧克力坩埚	qiao'ke'li'gan'guo	0
巧克力蛙	qiao'ke'li'wa	0
悄声细语	qiao'sheng'xi'yu	0
乔特鲁德	qiao'te'lu'de	0
乔治	qiao'zhi	0
乔治韦斯莱	qiao'zhi'wei'si'lai	0
亲时代	qin'shi'dai	0
清咳喘	qing'ke'chuan	0
清理一新	qing'li'yi'xin	0
清水如泉	qing'shui'ru'quan	0
青蛙飞来	qing'wa'fei'lai	0
秋张	qiu'zhang	0
驱逐麻瓜咒	qu'zhu'ma'gua'zhou	0
热火威士忌	re'huo'wei'shi'ji	0
人头狮身龙尾兽	ren'tou'shi'shen'long'wei'shou	0
人头狮身蝎尾兽	ren'tou'shi'shen'xie'wei'shou	0
人形显身	ren'xing'xian'shen	0
人鱼	ren'yu	0
软腿咒	ruan'tui'zhou	0
瑞典短鼻龙	rui'dian'duan'bi'long	0
萨拉查	sa'la'cha	0
萨拉查斯莱特林	sa'la'cha'si'lai'te'lin	0
塞德里克	sai'de'li'ke	0
塞德里克迪戈里	sai'de'li'ke'di'ge'li	0
三把扫帚	san'ba'sao'zhou	0
三强争霸赛	san'qiang'zheng'ba'sai	0
扫帚	sao'zhou	0
傻呼呼的肥老鼠变黄	sha'hu'hu'de'fei'lao'shu'bian'huang	0
莎莉安波克斯	sha'li'an'bo'ke'si	0
闪光咒	shan'guang'zhou	0
闪回前咒	shan'hui'qian'zhou	0
闪回咒	shan'hui'zhou	0
闪闪	shan'shan	0
蛇怪	she'guai	0
摄魂怪	she'hun'guai	0
摄魂取念	she'hun'qu'nian	0
蛇佬腔	she'lao'qiang	0
摄神取念	she'shen'qu'nian	0
神锋无影	shen'feng'wu'ying	0
神符马	shen'fu'ma	0
神秘事务司	shen'mi'shi'wu'si	0
神秘事物司	shen'mi'shi'wu'si	0
神奇生物	shen'qi'sheng'wu	0
圣布鲁斯安全中心少年犯学校	sheng'bu'lu'si'an'quan'zhong'xin'shao'nian'fan'xue'xiao	0
生骨水	sheng'gu'shui	0
生骨药	sheng'gu'yao	0
生姜蝾螺饼干	sheng'jiang'rong'luo'bing'gan	0
圣芒戈	sheng'mang'ge	0
生死水	sheng'si'shui	0
声音洪亮	sheng'yin'hong'liang	0
史都华艾克利	shi'du'hua'ai'ke'li	0
尸骨再现	shi'gu'zai'xian	0
石化	shi'hua	0
时间转换器	shi'jian'zhuan'huan'qi	0
试卷飞来	shi'juan'fei'lai	0
室内乐	shi'nei'yue	0
石墙高中	shi'qiang'gao'zhong	0
狮身鹰首兽	shi'shen'ying'shou'shou	0
食尸鬼	shi'shi'gui	0
食死徒	shi'si'tu	0
使者及侍从	shi'zhe'ji'shi'cong	0
十柱滚木球戏	shi'zhu'gun'mu'qiu'xi	0
守护神	shou'hu'shen	0
守护神咒	shou'hu'shen'zhou	0
收拾	shou'shi	0
水火不侵	shui'huo'bu'qin	0
水仙	shui'xian	0
四分五裂	si'fen'wu'lie	0
斯基特	si'ji'te	0
四巨头中最伟大的一个	si'ju'tou'zhong'zui'wei'da'de'yi'ge	0
斯莱特林	si'lai'te'lin	0
斯莱特林公共休息室	si'lai'te'lin'gong'gong'xiu'xi'shi	0
司梅汀中学	si'mei'ting'zhong'xue	0
斯梅廷中学	si'mei'ting'zhong'xue	0
斯内普	si'nei'pu	0
斯平内特	si'ping'nei'te	0
斯普劳特	si'pu'lao'te	0
死圣	si'sheng	0
死亡圣器	si'wang'sheng'qi	0
死亡预兆	si'wang'yu'zhao	0
死咒	si'zhou	0
速记笔	su'ji'bi	0
苏珊波恩	su'shan'bo'en	0
速速变大	su'su'bian'da	0
速速禁锢	su'su'jin'gu	0
速速锁禁	su'su'suo'jin	0
速速缩小	su'su'suo'xiao	0
酸棒糖	suan'bang'tang	0
算术占卜	suan'shu'zhan'bu	0
随从显形	sui'cong'xian'xing	0
锁舌封喉	suo'she'feng'hou	0
缩身药剂	suo'shen'yao'ji	0
锁腿咒	suo'tui'zhou	0
塔朗泰拉舞	ta'lang'tai'la'wu	0
泰德唐克斯	tai'de'tang'ke'si	0
泰瑞布特	tai'rui'bu'te	0
唐克斯	tang'ke'si	0
汤姆	tang'mu	0
汤姆里德尔	tang'mu'li'de'er	0
汤姆马沃罗里德尔	tang'mu'ma'wo'luo'li'de'er	0
特里劳妮	te'li'lao'ni	0
特伦斯希金斯	te'lun'si'xi'jin'si	0
嚏根草糖浆	ti'gen'cao'tang'jiang	0
天平	tian'ping	0
天文学	tian'wen'xue	0
跳跳根	tiao'tiao'gen	0
铁甲咒	tie'jia'zhou	0
统统加护	tong'tong'jia'hu	0
统统石化	tong'tong'shi'hua	0
吐真剂	tu'zhen'ji	0
腿部石化咒	tui'bu'shi'hua'zhou	0
腿立僵停死	tui'li'jiang'ting'si	0
托马斯	tuo'ma'si	0
瓦迪瓦西	wa'di'wa'xi	0
万弹齐发	wan'dan'qi'fa	0
弯角鼾兽	wan'jiao'han'shou	0
威尔士绿龙	wei'er'shi'lv'long	0
威基泰克罗斯	wei'ji'tai'ke'luo'si	0
威克多尔	wei'ke'duo'er	0
威克多尔克鲁姆	wei'ke'duo'er'ke'lu'mu	0
维琪弗罗比舍	wei'qi'fu'luo'bi'she	0
韦斯莱	wei'si'lai	0
韦斯莱魔法把戏	wei'si'lai'mo'fa'ba'xi	0
韦斯莱双胞胎	wei'si'lai'shuang'bao'tai	0
韦斯莱兄弟	wei'si'lai'xiong'di	0
文森特	wen'sen'te	0
文森特克拉布	wen'sen'te'ke'la'bu	0
我庄严宣誓我没干好事	wo'zhuang'yan'xuan'shi'wo'mei'gan'hao'shi	0
伍德	wu'de	0
乌龙出洞	wu'long'chu'dong	0
乌姆里奇	wu'mu'li'qi	0
乌姆里奇综合症	wu'mu'li'qi'zong'he'zheng	0
无声无息	wu'sheng'wu'xi	0
无声咒	wu'sheng'zhou	0
巫师棋	wu'shi'qi	0
巫师银行	wu'shi'yin'hang	0
乌头	wu'tou	0
无意中捐出	wu'yi'zhong'juan'chu	0
西弗	xi'fu	0
西弗勒斯	xi'fu'le'si	0
西弗勒斯斯内普	xi'fu'le'si'si'nei'pu	0
西可	xi'ke	0
西里斯	xi'li'si	0
西里斯布莱克	xi'li'si'bu'lai'ke	0
西莫	xi'mo	0
西莫斐尼甘	xi'mo'fei'ni'gan	0
吸血鬼	xi'xue'gui	0
现代魔法的重大发现	xian'dai'mo'fa'de'zhong'da'fa'xian	0
现代魔法史	xian'dai'mo'fa'shi	0
显形粉	xian'xing'fen	0
降敌陷阱	xiang'di'xian'jing	0
箱子移动	xiang'zi'yi'dong	0
小矮星	xiao'ai'xing	0
小矮星彼得	xiao'ai'xing'bi'de	0
小矮妖	xiao'ai'yao	0
小巴蒂克劳奇	xiao'ba'di'ke'lao'qi	0
笑喘呼啦啦	xiao'chuan'hu'la'la	0
消失柜	xiao'shi'gui	0
小天狼星	xiao'tian'lang'xing	0
小天狼星布莱克	xiao'tian'lang'xing'bu'lai'ke	0
消隐无踪	xiao'yin'wu'zong	0
小猪朱薇琼	xiao'zhu'zhu'wei'qiong	0
谢农费里厄斯洛夫古德	xie'nong'fei'li'e'si'luo'fu'gu'de	0
辛尼斯塔	xin'ni'si'ta	0
幸运剂	xing'yun'ji	0
匈牙利树蜂	xiong'ya'li'shu'feng	0
匈牙利树锋龙	xiong'ya'li'shu'feng'long	0
修复如初	xiu'fu'ru'chu	0
旋风扫净	xuan'feng'sao'jing	0
悬浮咒	xuan'fu'zhou	0
血人巴罗	xue'ren'ba'luo	0
血缘魔法	xue'yuan'mo'fa	0
哑炮	ya'pao	0
亚瑟	ya'se	0
亚瑟韦斯莱	ya'se'wei'si'lai	0
牙牙	ya'ya	0
岩皮饼	yan'pi'bing	0
鼹鼠皮大衣	yan'shu'pi'da'yi	0
养龙指南	yang'long'zhi'nan	0
羊皮纸	yang'pi'zhi	0
妖怪们的妖怪书	yao'guai'men'de'yao'guai'shu	0
妖精	yao'jing	0
夜骐	ye'qi	0
一段校史	yi'duan'xiao'shi	0
伊戈尔	yi'ge'er	0
咿啦猫头鹰商店	yi'la'mao'tou'ying'shang'dian	0
一千种神奇药草与菌类	yi'qian'zhong'shen'qi'yao'cao'yu'jun'lei	0
易容马格斯	yi'rong'ma'ge'si	0
一忘皆空	yi'wang'jie'kong	0
移形幻影	yi'xing'huan'ying	0
银箭	yin'jian	0
隐身粉	yin'shen'fen	0
隐身衣	yin'shen'yi	0
阴尸	yin'shi	0
隐形术的隐形书	yin'xing'shu'de'yin'xing'shu	0
隐形衣	yin'xing'yi	0
荧光闪烁	ying'guang'shan'shuo	0
英国使臣	ying'guo'shi'chen	0
鹰头马身有翼兽	ying'tou'ma'shen'you'yi'shou	0
尤安爱波	you'an'ai'bo	0
有求必应屋	you'qiu'bi'ying'wu	0
游走球	you'zou'qiu	0
愈合如初	yu'he'ru'chu	0
羽加迪姆勒维奥萨	yu'jia'di'mu'le'wei'ao'sa	0
与狼人一起流浪	yu'lang'ren'yi'qi'liu'lang	0
羽落咒	yu'luo'zhou	0
羽毛笔	yu'mao'bi	0
与母夜叉一起度假	yu'mu'ye'cha'yi'qi'du'jia	0
鱼鳃草	yu'sai'cao	0
与山怪共游	yu'shan'guai'gong'you	0
与食尸鬼同游	yu'shi'shi'gui'tong'you	0
与吸血鬼同船旅行	yu'xi'xue'gui'tong'chuan'lv'xing	0
与西藏雪人在一起的一年	yu'xi'zang'xue'ren'zai'yi'qi'de'yi'nian	0
预言家日报	yu'yan'jia'ri'bao	0
预言球飞来	yu'yan'qiu'fei'lai	0
原形立现	yuan'xing'li'xian	0
月长石粉	yue'chang'shi'fen	0
约翰逊	yue'han'xun	0
月亮脸	yue'liang'lian	0
云咒撤回	yun'zhou'che'hui	0
增强剂	zeng'qiang'ji	0
扎卡赖斯史密斯	zha'ka'lai'si'shi'mi'si	0
炸尾螺	zha'wei'luo	0
占卜	zhan'bu	0
詹姆	zhan'mu	0
詹姆波特	zhan'mu'bo'te	0
占星塔	zhan'xing'ta	0
障碍重重	zhang'ai'chong'chong	0
障碍咒	zhang'ai'zhou	0
蟑螂嘎吱多味豆	zhang'lang'ga'zhi'duo'wei'dou	0
长老魔杖	zhang'lao'mo'zhang	0
找球手	zhao'qiu'shou	0
镇定剂	zhen'ding'ji	0
指路咒	zhi'lu'zhou	0
中国火球龙	zhong'guo'huo'qiu'long	0
众伶人	zhong'ling'ren	0
中世纪巫术指南	zhong'shi'ji'wu'shu'zhi'nan	0
咒立停	zhou'li'ting	0
猪头酒吧	zhu'tou'jiu'ba	0
朱薇琼	zhu'wei'qiong	0
追球手	zhui'qiu'shou	0
自动答题羽毛笔	zi'dong'da'ti'yu'mao'bi	0
自卫指南	zi'wei'zhi'nan	0
自愿捐出	zi'yuan'juan'chu	0
诅咒与反诅咒	zu'zhou'yu'fan'zu'zhou	0
钻心腕骨	zuan'xin'wan'gu	0
钻心剜骨	zuan'xin'wan'gu	0
钻心咒	zuan'xin'zhou	0
佐科玩笑商店	zuo'ke'wan'xiao'shang'dian	0
左右分离	zuo'you'fen'li	0
左右为难	zuo'you'wei'nan	0
