把大学生思想政治教育	ba'da'xue'sheng'si'xiang'zheng'zhi'jiao'yu	0
把马克思主义作为	ba'ma'ke'si'zhu'yi'zuo'wei	0
把培养德智体美	ba'pei'yang'de'zhi'ti'mei	0
把树立正确的世界观	ba'shu'li'zheng'que'de'shi'jie'guan	0
摆上党和	bai'shang'dang'he	0
必须把大学生	bi'xu'ba'da'xue'sheng	0
必须坚持和发展	bi'xu'jian'chi'he'fa'zhan	0
大学生思想政治教育	da'xue'sheng'si'xiang'zheng'zhi'jiao'yu	0
大学生思想政治教育方面	da'xue'sheng'si'xiang'zheng'zhi'jiao'yu'fang'mian	0
的基础工程	de'ji'chu'gong'cheng	0
的文件	de'wen'jian	0
的希望工程	de'xi'wang'gong'cheng	0
的重要经验	de'zhong'yao'jing'yan	0
根本指针	gen'ben'zhi'zhen	0
国务院名义下发加强	guo'wu'yuan'ming'yi'xia'fa'jia'qiang	0
和改进大学生思想政治教育	he'gai'jin'da'xue'sheng'si'xiang'zheng'zhi'jiao'yu	0
合格建设者	he'ge'jian'she'zhe	0
和可靠接班人	he'ke'kao'jie'ban'ren	0
积累了许多重要经验	ji'lei'le'xu'duo'zhong'yao'jing'yan	0
具有里程碑意义	ju'you'li'cheng'bei'yi'yi	0
命运的战略工程	ming'yun'de'zhan'lve'gong'cheng	0
全面发展的社会主义	quan'mian'fa'zhan'de'she'hui'zhu'yi	0
是第一次	shi'di'yi'ci	0
实现中华民族伟大复兴	shi'xian'zhong'hua'min'zu'wei'da'fu'xing	0
思想政治教育	si'xiang'zheng'zhi'jiao'yu	0
我们党开展	wo'men'dang'kai'zhan	0
我们党在	wo'men'dang'zai	0
以党中央	yi'dang'zhong'yang	0
在我们党和国家历史上	zai'wo'men'dang'he'guo'jia'li'shi'shang	0
政府工作的重要位置	zheng'fu'gong'zuo'de'zhong'yao'wei'zhi	0
作为根本目标	zuo'wei'gen'ben'mu'biao	0
作为全面建设小康社会	zuo'wei'quan'mian'jian'she'xiao'kang'she'hui	0
作为事关国家前途	zuo'wei'shi'guan'guo'jia'qian'tu	0
作为推进现代化建设	zuo'wei'tui'jin'xian'dai'hua'jian'she	0
