板壁的厚度	ban'bi'de'hou'du	0
半径	ban'jing	0
表面粗糙度参数	biao'mian'cu'cao'du'can'shu	0
标准	biao'zhun	0
部件	bu'jian	0
长度	chang'du	0
抽样方案	chou'yang'fang'an	0
抽样检验	chou'yang'jian'yan	0
初期支护	chu'qi'zhi'hu	0
地下防水工程	di'xia'fang'shui'gong'cheng	0
地下工程防水等级标准	di'xia'gong'cheng'fang'shui'deng'ji'biao'zhun	0
地下工程质量防水等级	di'xia'gong'cheng'zhi'liang'fang'shui'deng'ji	0
垫层	dian'ceng	0
盾构法隧道	dun'gou'fa'sui'dao	0
返工	fan'gong	0
返修	fan'xiu	0
防水等级	fang'shui'deng'ji	0
刚性防水层	gang'xing'fang'shui'ceng	0
高强度螺栓初柠扭矩	gao'qiang'du'luo'shuan'chu'ning'niu'ju	0
高强度螺栓检查扭矩	gao'qiang'du'luo'shuan'jian'cha'niu'ju	0
高强度螺栓连接副	gao'qiang'du'luo'shuan'lian'jie'fu	0
高强度螺栓设计预拉力	gao'qiang'du'luo'shuan'she'ji'yu'la'li	0
高强度螺栓预拉力的损失值	gao'qiang'du'luo'shuan'yu'la'li'de'sun'shi'zhi	0
高强度螺栓终柠扭矩	gao'qiang'du'luo'shuan'zhong'ning'niu'ju	0
高压喷射注浆地基	gao'ya'pen'she'zhu'jiang'di'ji	0
隔离层	ge'li'ceng	0
各楼层高度	ge'lou'ceng'gao'du	0
构件	gou'jian	0
观感质量	guan'gan'zhi'liang	0
焊钉	han'ding	0
合成材料地基	he'cheng'cai'liao'di'ji	0
横向缩缝	heng'xiang'suo'feng	0
环境温度	huan'jing'wen'du	0
混凝土结构	hun'ning'tu'jie'gou	0
基层	ji'ceng	0
几何参数	ji'he'can'shu	0
计量检验	ji'liang'jian'yan	0
计数检验	ji'shu'jian'yan	0
基土	ji'tu	0
假缝	jia'feng	0
间距	jian'ju	0
检验	jian'yan	0
检验批	jian'yan'pi	0
见证取样检测	jian'zheng'qu'yang'jian'ce	0
建筑地面	jian'zhu'di'mian	0
建筑工程	jian'zhu'gong'cheng	0
建筑工程质量	jian'zhu'gong'cheng'zhi'liang	0
角焊缝计算厚度	jiao'han'feng'ji'suan'hou'du	0
交接检验	jiao'jie'jian'yan	0
结构性能检验	jie'gou'xing'neng'jian'yan	0
结合层	jie'he'ceng	0
截面高度	jie'mian'gao'du	0
进场验收	jin'chang'yan'shou	0
抗滑移系数	kang'hua'yi'xi'shu	0
空间刚度单元	kong'jian'gang'du'dan'yuan	0
跨度	kua'du	0
宽度或板的自由外伸宽度	kuan'du'huo'ban'de'zi'you'wai'shen'kuan'du	0
零件	ling'jian	0
轮廓算术平均偏差	lun'kuo'suan'shu'ping'jun'pian'cha	0
锚杆静压桩	mao'gan'jing'ya'zhuang	0
面层	mian'ceng	0
挠度弯曲矢高	nao'du'wan'qu'shi'gao	0
配筋砌体	pei'jin'qi'ti	0
偏心距	pian'xin'ju	0
其他地下工程	qi'ta'di'xia'gong'cheng	0
强夯地基	qiang'hang'di'ji	0
缺陷	que'xian	0
柔性防水层	rou'xing'fang'shui'ceng	0
伸缝	shen'feng	0
施工缝	shi'gong'feng	0
施工质量控制等级	shi'gong'zhi'liang'kong'zhi'deng'ji	0
栓钉焊接	shuan'ding'han'jie	0
水泥粉煤灰	shui'ni'fen'mei'hui	0
水泥土搅拌桩地基	shui'ni'tu'jiao'ban'zhuang'di'ji	0
碎石桩	sui'shi'zhuang	0
缩缝	suo'feng	0
填充层	tian'chong'ceng	0
通缝	tong'feng	0
土工合成材料	tu'gong'he'cheng'cai'liao	0
土与灰土挤密桩地基	tu'yu'hui'tu'ji'mi'zhuang'di'ji	0
系数	xi'shu	0
现浇结构	xian'jiao'jie'gou	0
小拼单元	xiao'pin'dan'yuan	0
芯柱	xin'zhu	0
型式检验	xing'shi'jian'yan	0
验收	yan'shou	0
严重缺陷	yan'zhong'que'xian	0
一般缺陷	yi'ban'que'xian	0
一般项目	yi'ban'xiang'mu	0
预拼装	yu'pin'zhuang	0
预压地基	yu'ya'di'ji	0
原位检测	yuan'wei'jian'ce	0
增量	zeng'liang	0
找平层	zhao'ping'ceng	0
直径	zhi'jing	0
重锤夯实地基	zhong'chui'hang'shi'di'ji	0
中拼单元	zhong'pin'dan'yuan	0
柱高度	zhu'gao'du	0
注浆地基	zhu'jiang'di'ji	0
主控项目	zhu'kong'xiang'mu	0
装配式结构	zhuang'pei'shi'jie'gou	0
纵向缩缝	zong'xiang'suo'feng	0
