别那么天真了好吗	bie'na'me'tian'zhen'le'hao'ma	0
传说已经破灭神话从新打造	chuan'shuo'yi'jing'po'mie'shen'hua'cong'xin'da'zao	0
你不觉得你现在像个跳梁小丑	ni'bu'jue'de'ni'xian'zai'xiang'ge'tiao'liang'xiao'chou	0
你到底是个什么什么东西	ni'dao'di'shi'ge'shen'me'shen'me'dong'xi	0
你到底为什么怎么这么败类呢	ni'dao'di'wei'shen'me'zen'me'zhe'me'bai'lei'ne	0
你看看你那窝囊废的形象	ni'kan'kan'ni'na'wo'nang'fei'de'xing'xiang	0
你看你那无力的语句	ni'kan'ni'na'wu'li'de'yu'ju	0
你看我是软件吗	ni'kan'wo'shi'ruan'jian'ma	0
你那零零星星的词汇	ni'na'ling'ling'xing'xing'de'ci'hui	0
你难以抵挡我平平淡淡的语言了	ni'nan'yi'di'dang'wo'ping'ping'dan'dan'de'yu'yan'le	0
你能不能别泛滥了	ni'neng'bu'neng'bie'fan'lan'le	0
你能不能纠正一下自己的心态	ni'neng'bu'neng'jiu'zheng'yi'xia'zi'ji'de'xin'tai	0
你能选择的只有落荒而逃明白吗	ni'neng'xuan'ze'de'zhi'you'luo'huang'er'tao'ming'bai'ma	0
你速度的告诉告诉我	ni'su'du'de'gao'su'gao'su'wo	0
你为什么总是这么傻	ni'wei'shen'me'zong'shi'zhe'me'sha	0
你现在是什么处境呢	ni'xian'zai'shi'shen'me'chu'jing'ne	0
请你不要那么风趣幽默好吗	qing'ni'bu'yao'na'me'feng'qu'you'mo'hao'ma	0
请你停止你的苟延残喘	qing'ni'ting'zhi'ni'de'gou'yan'can'chuan	0
请停止你舞动在键盘上的手好吗	qing'ting'zhi'ni'wu'dong'zai'jian'pan'shang'de'shou'hao'ma	0
让你无处可逃了你相信么	rang'ni'wu'chu'ke'tao'le'ni'xiang'xin'me	0
我看你是痴人说梦异想天开了吧	wo'kan'ni'shi'chi'ren'shuo'meng'yi'xiang'tian'kai'le'ba	0
我一针见血的说到了你的脸皮厚	wo'yi'zhen'jian'xue'de'shuo'dao'le'ni'de'lian'pi'hou	0
