巴闭嘈冤巴闭顶肺咪住	ba'bi'cao'yuan'ba'bi'ding'fei'mi'zhu	0
巴喳八卦弊家伙鼻哥	ba'zha'ba'gua'bi'jia'huo'bi'ge	0
帮衬收皮收嗲嬲到爆	bang'chen'shou'pi'shou'dia'niao'dao'bao	0
爆大锅屎忽核突盏鬼	bao'da'guo'shi'hu'he'tu'zhan'gui	0
爆晒棚食唔落冇问题识得	bao'shai'peng'shi'wu'luo'mao'wen'ti'shi'de	0
鼻哥竉磅水闩门吹水	bi'ge'long'bang'shui'shuan'men'chui'shui	0
茶煲煲粥等阵煮饭	cha'bao'bao'zhou'deng'zhen'zhu'fan	0
吹水唔抹嘴顶嘴冲凉打交	chui'shui'wu'mo'zui'ding'zui'chong'liang'da'jiao	0
打喊露打冷震叻唔切第日	da'han'lu'da'leng'zhen'le'wu'qie'di'ri	0
点算俾返啱晒搵钱	dian'suan'bi'fan'yan'shai'wen'qian	0
点知发生咩事一旧云冇钱	dian'zhi'fa'sheng'mie'shi'yi'jiu'yun'mao'qian	0
喋晒糖咁款呷醋唔愤气黄朝白晏	die'shai'tang'gan'kuan'xia'cu'wu'fen'qi'huang'chao'bai'yan	0
顶你个肺锡锡噏得就噏呃人	ding'ni'ge'fei'xi'xi'xi'de'jiu'xi'e'ren	0
丢架落嚟俾人坤落答	diu'jia'luo'li'bi'ren'kun'luo'da	0
奀妹奀挑鬼命咸鱼翻身钉咗	en'mei'en'tiao'gui'ming'xian'yu'fan'shen'ding'zuo	0
粉肠傻更更神神哋边度	fen'chang'sha'geng'geng'shen'shen'di'bian'du	0
孤寒缩骨木嘴碌葛	gu'han'suo'gu'mu'zui'lu'ge	0
果度唔係喺度喺边啊	guo'du'wu'xi'xi'du'xi'bian'a	0
好攰氹人睬你都傻唔睬你	hao'gui'dang'ren'cai'ni'dou'sha'wu'cai'ni	0
好味架喇识做二打六	hao'wei'jia'la'shi'zuo'er'da'liu	0
话晒唸嘢嚟讲	hua'shai'nian'ye'li'jiang	0
话时话冇得倾唔啱数好便	hua'shi'hua'mao'de'qing'wu'yan'shu'hao'bian	0
家姐妈咪爹哋唔钟意	jia'jie'ma'mi'die'di'wu'zhong'yi	0
讲咩啊做紧咩乜都得咁都得	jiang'mie'a'zuo'jin'mie'mie'dou'dei'gan'dou'de	0
楋手唔成势扯猫尾痴线痴孖筋	la'shou'wu'cheng'shi'che'mao'wei'chi'xian'chi'ma'jin	0
老细大佬细佬唔使	lao'xi'da'lao'xi'lao'wu'shi	0
箩柚憨居懵盛盛蒙查查	luo'you'han'ju'meng'sheng'sheng'meng'cha'cha	0
埋冷冚家产屎忽鬼肥佬	mai'leng'kan'jia'chan'shi'hu'gui'fei'lao	0
冇得弹你好嘢有冇搞错又係喔	mao'de'tan'ni'hao'ye'you'mao'gao'cuo'you'xi'wo	0
冇计得闲唔得闲行街	mao'ji'de'xian'wu'de'xian'xing'jie	0
茂里一啲啲嗰个返到未	mao'li'yi'di'di'ge'ge'fan'dao'wei	0
掹掹緊索油型到跌渣狒狒哋	meng'meng'jin'suo'you'xing'dao'die'zha'fei'fei'di	0
咩嘢搞错搞掂行得未啊	mie'ye'gao'cuo'gao'dian'xing'de'wei'a	0
你哋	ni'di	0
你地	ni'di	0
你话事卖剩蔗箩底橙隔夜粥	ni'hua'shi'mai'sheng'zhe'luo'di'cheng'ge'ye'zhou	0
千祈唔好求祈事但唔信	qian'qi'wu'hao'qiu'qi'shi'dan'wu'xin	0
悭钱睇唔出咁咁啱	qian'qian'di'wu'chu'gan'gan'yan	0
穷到窿穿窿玩嘢蒲头	qiong'dao'long'chuan'long'wan'ye'pu'tou	0
佢哋	qu'di	0
忍唔住等唔切仲有梗係	ren'wu'zhu'deng'wu'qie'zhong'you'geng'xi	0
入嚟	ru'li	0
塞紧车预埋你果份等埋我未返到	sai'jin'che'yu'mai'ni'guo'fen'deng'mai'wo'wei'fan'dao	0
晒冷冷衫冇事呢啲	shai'leng'leng'shan'mao'shi'ne'di	0
捨得返到嚟闲闲哋衬到绝	she'de'fan'dao'li'xian'xian'di'chen'dao'jue	0
食饭食咗饭未啊嚟啦到咗未	shi'fan'shi'zuo'fan'wei'a'li'la'dao'zuo'wei	0
食死猫一身蚁湿滞周身唔聚财	shi'si'mao'yi'shen'yi'shi'zhi'zhou'shen'wu'ju'cai	0
食碗面反碗底二五仔反骨仔细妹	shi'wan'mian'fan'wan'di'er'wu'zai'fan'gu'zi'xi'mei	0
使唔使	shi'wu'shi	0
踢晒脚鸡咁脚坤人发烂咋	ti'shai'jiao'ji'gan'jiao'kun'ren'fa'lan'za	0
同埋理得佢边有啊死牛一边颈	tong'mai'li'de'qu'bian'you'a'si'niu'yi'bian'jing	0
未得住等埋係咪咩事	wei'de'zhu'deng'mai'xi'mi'mie'shi	0
搵工咁滞你老屎屎溃	wen'gong'gan'zhi'ni'lao'shi'shi'kui	0
瘟瘟噔噔搵人搵嘢企理	wen'wen'deng'deng'wen'ren'wen'ye'qi'li	0
唔识识唔使得唔得得啖笑	wu'shi'shi'wu'shi'de'wu'de'de'dan'xiao	0
唔系	wu'xi	0
唔啱啱啱返屋企返嚟啦	wu'yan'yan'yan'fan'wu'qi'fan'li'la	0
系边系边到做紧物你话呢	xi'bian'xi'bian'dao'zuo'jin'wu'ni'hua'ne	0
系唔系啊我哋	xi'wu'xi'a'wo'di	0
泄埋泄晒蚀底着数	xie'mai'xie'shai'shi'di'zhao'shu	0
墟冚着草意头牙烟	xu'kan'zhe'cao'yi'tou'ya'yan	0
寻日寻晚听日倾计	xun'ri'xun'wan'ting'ri'qing'ji	0
眼瞓大锅阿吱阿咗面珠趸	yan'fen'da'guo'a'zhi'a'zuo'mian'zhu'dun	0
啱先吖嘛唔係掛掛住	yan'xian'a'ma'wu'xi'gua'gua'zhu	0
晏骤瞓觉早抖啱瞓醒	yan'zhou'fen'jiao'zao'dou'yan'fen'xing	0
饮到汤戏飞大肶鸡肶	yin'dao'tang'xi'fei'da'pi'ji'pi	0
硬颈手紧穷到出汁方死冇人知	ying'jing'shou'jin'qiong'dao'chu'zhi'fang'si'mao'ren'zhi	0
有冇冇嘢冇晒呢度	you'mao'mao'ye'mao'shai'ne'du	0
运滞食咩啊潮人潮爆	yun'zhi'shi'mie'a'chao'ren'chao'bao	0
咋嘛麻麻哋嗌交嘈交	za'ma'ma'ma'di'ai'jiao'cao'jiao	0
揸拿揸住有排未有咁快住	zha'na'zha'zhu'you'pai'wei'you'gan'kuai'zhu	0
朝早氹氹转疊埋心水顶唔顺	zhao'zao'dang'dang'zhuan'die'mai'xin'shui'ding'wu'shun	0
争咁远痴閪线傻閪痴痴	zheng'gan'yuan'chi'se'xian'sha'se'chi'chi	0
撞到正运桔白撞使乜	zhuang'dao'zheng'yun'ju'bai'zhuang'shi'mie	0
走佬讲咩咁点算点解	zou'lao'jiang'mie'gan'dian'suan'dian'jie	0
做乜	zuo'mie	0
做物西扑街死开我地	zuo'wu'xi'pu'jie'si'kai'wo'di	0
