版面语言	ban'mian'yu'yan	0
报道计划	bao'dao'ji'hua	0
报道思想	bao'dao'si'xiang	0
报道提示	bao'dao'ti'shi	0
报道意图	bao'dao'yi'tu	0
报刊综述	bao'kan'zong'shu	0
报章体	bao'zhang'ti	0
本埠新闻	ben'bu'xin'wen	0
本地新闻	ben'di'xin'wen	0
本馆论说	ben'guan'lun'shuo	0
本质真实	ben'zhi'zhen'shi	0
比拟式标题	bi'ni'shi'biao'ti	0
笔谈	bi'tan	0
比喻式标题	bi'yu'shi'biao'ti	0
编辑部文章	bian'ji'bu'wen'zhang	0
边题	bian'ti	0
驳论式评论	bo'lun'shi'ping'lun	0
采访	cai'fang	0
采访的任务	cai'fang'de'ren'wu	0
采访的准备	cai'fang'de'zhun'bei	0
采访记录	cai'fang'ji'lu	0
采访日记	cai'fang'ri'ji	0
采访随感录	cai'fang'sui'gan'lu	0
采访提纲	cai'fang'ti'gang	0
采访札记	cai'fang'zha'ji	0
侧记	ce'ji	0
层递式标题	ceng'di'shi'biao'ti	0
阐述型评论	chan'shu'xing'ping'lun	0
长篇连载	chang'pian'lian'zai	0
常驻采访	chang'zhu'cai'fang	0
陈述型导语	chen'shu'xing'dao'yu	0
成语性标题	cheng'yu'xing'biao'ti	0
吃透两头	chi'tou'liang'tou	0
传播学	chuan'bo'xue	0
传学	chuan'xue	0
纯新闻	chun'xin'wen	0
答读者问	da'du'zhe'wen	0
答记者问	da'ji'zhe'wen	0
代论	dai'lun	0
单式标题	dan'shi'biao'ti	0
单元素导语	dan'yuan'su'dao'yu	0
单元素消息	dan'yuan'su'xiao'xi	0
倒金字塔	dao'jin'zi'ta	0
导语	dao'yu	0
倒装式标题	dao'zhuang'shi'biao'ti	0
第二手材料	di'er'shou'cai'liao	0
地方新闻	di'fang'xin'wen	0
第三种社论	di'san'zhong'she'lun	0
第一手材料	di'yi'shou'cai'liao	0
电视新闻	dian'shi'xin'wen	0
电讯	dian'xun	0
电讯稿	dian'xun'gao	0
调查附记	diao'cha'fu'ji	0
调查会	diao'cha'hui	0
调查性报道	diao'cha'xing'bao'dao	0
顶针式标题	ding'zhen'shi'biao'ti	0
动态新闻	dong'tai'xin'wen	0
独家新闻	du'jia'xin'wen	0
读者来信	du'zhe'lai'xin	0
读者来信综述	du'zhe'lai'xin'zong'shu	0
读者需要	du'zhe'xu'yao	0
短评	duan'ping	0
短讯	duan'xun	0
对偶式标题	dui'ou'shi'biao'ti	0
对外报道	dui'wai'bao'dao	0
对照式标题	dui'zhao'shi'biao'ti	0
蹲点	dun'dian	0
多行题	duo'hang'ti	0
多元素导语	duo'yuan'su'dao'yu	0
多元素新闻	duo'yuan'su'xin'wen	0
反复式标题	fan'fu'shi'biao'ti	0
反语式标题	fan'yu'shi'biao'ti	0
访问	fang'wen	0
非故意性失实	fei'gu'yi'xing'shi'shi	0
风貌通讯	feng'mao'tong'xun	0
复叠式标题	fu'die'shi'biao'ti	0
复式标题	fu'shi'biao'ti	0
概括型导语	gai'kuo'xing'dao'yu	0
概貌通讯	gai'mao'tong'xun	0
感叹式标题	gan'tan'shi'biao'ti	0
纲要题	gang'yao'ti	0
歌谣性标题	ge'yao'xing'biao'ti	0
更正	geng'zheng	0
公报式新闻	gong'bao'shi'xin'wen	0
共同关注	gong'tong'guan'zhu	0
共同兴趣	gong'tong'xing'qu	0
工作通讯	gong'zuo'tong'xun	0
工作研究	gong'zuo'yan'jiu	0
故意性失实	gu'yi'xing'shi'shi	0
观察家评论	guan'cha'jia'ping'lun	0
关系的代表性	guan'xi'de'dai'biao'xing	0
关系的对等性	guan'xi'de'dui'deng'xing	0
关系的双向性	guan'xi'de'shuang'xiang'xing	0
广播对话	guang'bo'dui'hua	0
广播稿	guang'bo'gao	0
广播评论	guang'bo'ping'lun	0
广播新闻	guang'bo'xin'wen	0
广播语言	guang'bo'yu'yan	0
国际新闻	guo'ji'xin'wen	0
国际新闻评论	guo'ji'xin'wen'ping'lun	0
国内新闻	guo'nei'xin'wen	0
海外新闻	hai'wai'xin'wen	0
合理想象	he'li'xiang'xiang	0
核实	he'shi	0
呼告式标题	hu'gao'shi'biao'ti	0
花絮	hua'xu	0
回文式标题	hui'wen'shi'biao'ti	0
会议新闻	hui'yi'xin'wen	0
集纳	ji'na	0
纪念型评论	ji'nian'xing'ping'lun	0
纪事	ji'shi	0
技术性失实	ji'shu'xing'shi'shi	0
记者来信	ji'zhe'lai'xin	0
记者述评	ji'zhe'shu'ping	0
间接性材料	jian'jie'xing'cai'liao	0
间接性导语	jian'jie'xing'dao'yu	0
简明新闻	jian'ming'xin'wen	0
见闻型导语	jian'wen'xing'dao'yu	0
简讯	jian'xun	0
建议型评论	jian'yi'xing'ping'lun	0
剪影	jian'ying	0
交叉采访	jiao'cha'cai'fang	0
揭丑新闻	jie'chou'xin'wen	0
借代式标题	jie'dai'shi'biao'ti	0
接近性	jie'jin'xing	0
结论型导语	jie'lun'xing'dao'yu	0
解释性报道	jie'shi'xing'bao'dao	0
解释性导语	jie'shi'xing'dao'yu	0
金字塔	jin'zi'ta	0
经济报道	jing'ji'bao'dao	0
经济新闻	jing'ji'xin'wen	0
经济新闻评论	jing'ji'xin'wen'ping'lun	0
军事报道	jun'shi'bao'dao	0
军事通讯	jun'shi'tong'xun	0
军事新闻	jun'shi'xin'wen	0
军事新闻评论	jun'shi'xin'wen'ping'lun	0
刊头	kan'tou	0
客观报道	ke'guan'bao'dao	0
科技报道	ke'ji'bao'dao	0
科技新闻	ke'ji'xin'wen	0
客里空	ke'li'kong	0
口头新闻	kou'tou'xin'wen	0
口语性标题	kou'yu'xing'biao'ti	0
来函照登	lai'han'zhao'deng	0
来论	lai'lun	0
栏题	lan'ti	0
立论式评论	li'lun'shi'ping'lun	0
理论宣传	li'lun'xuan'chuan	0
连续报道	lian'xu'bao'dao	0
联珠式标题	lian'zhu'shi'biao'ti	0
零讯	ling'xun	0
录音报道	lu'yin'bao'dao	0
录音访问	lu'yin'fang'wen	0
录音剪辑	lu'yin'jian'ji	0
录音特写	lu'yin'te'xie	0
录音通讯	lu'yin'tong'xun	0
录音新闻	lu'yin'xin'wen	0
旅行通讯	lv'xing'tong'xun	0
旅游通讯	lv'you'tong'xun	0
描述型导语	miao'shu'xing'dao'yu	0
描写型导语	miao'xie'xing'dao'yu	0
摹状式标题	mo'zhuang'shi'biao'ti	0
内参	nei'can	0
排比式标题	pai'bi'shi'biao'ti	0
判断型评论	pan'duan'xing'ping'lun	0
配图新闻	pei'tu'xin'wen	0
评论型导语	ping'lun'xing'dao'yu	0
评论员文章	ping'lun'yuan'wen'zhang	0
评述型导语	ping'shu'xing'dao'yu	0
普遍兴趣	pu'bian'xing'qu	0
铺张式标题	pu'zhang'shi'biao'ti	0
情况反映	qing'kuang'fan'ying	0
人物访问记	ren'wu'fang'wen'ji	0
人物通讯	ren'wu'tong'xun	0
人物专访	ren'wu'zhuan'fang	0
散记	san'ji	0
社会新闻评论	she'hui'xin'wen'ping'lun	0
社论	she'lun	0
社评	she'ping	0
社说	she'shuo	0
设问式标题	she'wen'shi'biao'ti	0
深度报道	shen'du'bao'dao	0
诗词性标题	shi'ci'xing'biao'ti	0
事件通讯	shi'jian'tong'xun	0
事件新闻	shi'jian'xin'wen	0
时间性	shi'jian'xing	0
实况广播	shi'kuang'guang'bo	0
实况录音剪辑	shi'kuang'lu'yin'jian'ji	0
诗配画	shi'pei'hua	0
时评	shi'ping	0
时务体	shi'wu'ti	0
时务文章	shi'wu'wen'zhang	0
时新性	shi'xin'xing	0
实用新闻学	shi'yong'xin'wen'xue	0
手抄新闻	shou'chao'xin'wen	0
受众学	shou'zhong'xue	0
述评新闻	shu'ping'xin'wen	0
双关式标题	shuang'guan'shi'biao'ti	0
四捷	si'jie	0
四能	si'neng	0
思想评论	si'xiang'ping'lun	0
踏勘	ta'kan	0
谈话记	tan'hua'ji	0
特稿	te'gao	0
特约通讯	te'yue'tong'xun	0
提示题	ti'shi'ti	0
提问	ti'wen	0
提问型导语	ti'wen'xing'dao'yu	0
提要题	ti'yao'ti	0
提要型导语	ti'yao'xing'dao'yu	0
体育报道	ti'yu'bao'dao	0
体育新闻	ti'yu'xin'wen	0
通栏标题	tong'lan'biao'ti	0
通讯	tong'xun	0
通讯的结构	tong'xun'de'jie'gou	0
通讯中的描写	tong'xun'zhong'de'miao'xie	0
通讯中的抒情	tong'xun'zhong'de'shu'qing	0
通讯中的叙述	tong'xun'zhong'de'xu'shu	0
通讯中的议论	tong'xun'zhong'de'yi'lun	0
突发新闻	tu'fa'xin'wen	0
突击采访	tu'ji'cai'fang	0
外论	wai'lun	0
微型评论	wei'xing'ping'lun	0
文教报道	wen'jiao'bao'dao	0
文教新闻	wen'jiao'xin'wen	0
问题讨论	wen'ti'tao'lun	0
析字式标题	xi'zi'shi'biao'ti	0
现场观察	xian'chang'guan'cha	0
显著性	xian'zhu'xing	0
小故事	xiao'gu'shi	0
小通讯	xiao'tong'xun	0
消息	xiao'xi	0
消息的结构	xiao'xi'de'jie'gou	0
小言论	xiao'yan'lun	0
新民体	xin'min'ti	0
新闻	xin'wen	0
新闻背景	xin'wen'bei'jing	0
新闻鼻	xin'wen'bi	0
新闻编辑	xin'wen'bian'ji	0
新闻编辑学	xin'wen'bian'ji'xue	0
新闻标题	xin'wen'biao'ti	0
新闻采访学	xin'wen'cai'fang'xue	0
新闻材料	xin'wen'cai'liao	0
新闻出处	xin'wen'chu'chu	0
新闻道德	xin'wen'dao'de	0
新闻的按语	xin'wen'de'an'yu	0
新闻的插题	xin'wen'de'cha'ti	0
新闻的大标题	xin'wen'de'da'biao'ti	0
新闻的分题	xin'wen'de'fen'ti	0
新闻的风格	xin'wen'de'feng'ge	0
新闻的副题	xin'wen'de'fu'ti	0
新闻的肩题	xin'wen'de'jian'ti	0
新闻的阶级性	xin'wen'de'jie'ji'xing	0
新闻的节奏	xin'wen'de'jie'zou	0
新闻的可读性	xin'wen'de'ke'du'xing	0
新闻的客观性	xin'wen'de'ke'guan'xing	0
新闻的立体化	xin'wen'de'li'ti'hua	0
新闻的眉题	xin'wen'de'mei'ti	0
新闻的趣味性	xin'wen'de'qu'wei'xing	0
新闻的商品性	xin'wen'de'shang'pin'xing	0
新闻的实题	xin'wen'de'shi'ti	0
新闻的思想性	xin'wen'de'si'xiang'xing	0
新闻的文采	xin'wen'de'wen'cai	0
新闻的现场感	xin'wen'de'xian'chang'gan	0
新闻的小标题	xin'wen'de'xiao'biao'ti	0
新闻的虚实题	xin'wen'de'xu'shi'ti	0
新闻的虚题	xin'wen'de'xu'ti	0
新闻的引题	xin'wen'de'yin'ti	0
新闻的真实性	xin'wen'de'zhen'shi'xing	0
新闻的正题	xin'wen'de'zheng'ti	0
新闻的指导性	xin'wen'de'zhi'dao'xing	0
新闻的知识性	xin'wen'de'zhi'shi'xing	0
新闻的重要性	xin'wen'de'zhong'yao'xing	0
新闻电头	xin'wen'dian'tou	0
新闻法规	xin'wen'fa'gui	0
新闻概括	xin'wen'gai'kuo	0
新闻稿件配置	xin'wen'gao'jian'pei'zhi	0
新闻稿件修改	xin'wen'gao'jian'xiu'gai	0
新闻稿件选择	xin'wen'gao'jian'xuan'ze	0
新闻根据	xin'wen'gen'ju	0
新闻公报	xin'wen'gong'bao	0
新闻公告	xin'wen'gong'gao	0
新闻集锦	xin'wen'ji'jin	0
新闻价值	xin'wen'jia'zhi	0
新闻角度	xin'wen'jiao'du	0
新闻结尾	xin'wen'jie'wei	0
新闻来源	xin'wen'lai'yuan	0
新闻敏感	xin'wen'min'gan	0
新闻评论	xin'wen'ping'lun	0
新闻评论学	xin'wen'ping'lun'xue	0
新闻散文化	xin'wen'san'wen'hua	0
新闻失实	xin'wen'shi'shi	0
新闻述评	xin'wen'shu'ping	0
新闻素材	xin'wen'su'cai	0
新闻特写	xin'wen'te'xie	0
新闻题材	xin'wen'ti'cai	0
新闻体裁	xin'wen'ti'cai	0
新闻图片说明	xin'wen'tu'pian'shuo'ming	0
新闻文体	xin'wen'wen'ti	0
新闻五要素	xin'wen'wu'yao'su	0
新闻线索	xin'wen'xian'suo	0
新闻写作	xin'wen'xie'zuo	0
新闻心理学	xin'wen'xin'li'xue	0
新闻嗅觉	xin'wen'xiu'jue	0
新闻宣传纪律	xin'wen'xuan'chuan'ji'lv	0
新闻学	xin'wen'xue	0
新闻由头	xin'wen'you'tou	0
新闻语言	xin'wen'yu'yan	0
新闻政策	xin'wen'zheng'ce	0
新闻职能	xin'wen'zhi'neng	0
新闻中的数字	xin'wen'zhong'de'shu'zi	0
新闻中的细节	xin'wen'zhong'de'xi'jie	0
新闻中的引语	xin'wen'zhong'de'yin'yu	0
新闻主题	xin'wen'zhu'ti	0
新闻主体	xin'wen'zhu'ti	0
新闻资料	xin'wen'zi'liao	0
新闻自由	xin'wen'zi'you	0
袖珍评论	xiu'zhen'ping'lun	0
宣传	xuan'chuan	0
宣传价值	xuan'chuan'jia'zhi	0
悬念型导语	xuan'nian'xing'dao'yu	0
巡回采访	xun'hui'cai'fang	0
巡礼	xun'li	0
延缓型导语	yan'huan'xing'dao'yu	0
延缓性新闻	yan'huan'xing'xin'wen	0
谚语性标题	yan'yu'xing'biao'ti	0
易地采访	yi'di'cai'fang	0
移就式标题	yi'jiu'shi'biao'ti	0
译论	yi'lun	0
议论型导语	yi'lun'xing'dao'yu	0
易碎品	yi'sui'pin	0
一行题	yi'xing'ti	0
印刷新闻	yin'shua'xin'wen	0
隐性采访	yin'xing'cai'fang	0
引用式标题	yin'yong'shi'biao'ti	0
映衬式标题	ying'chen'shi'biao'ti	0
用事实说话	yong'shi'shi'shuo'hua	0
有闻必录	you'wen'bi'lu	0
域内新闻	yu'nei'xin'wen	0
域外新闻	yu'wai'xin'wen	0
远生通讯	yuan'sheng'tong'xun	0
战地通讯	zhan'di'tong'xun	0
战争通讯	zhan'zheng'tong'xun	0
政策宣传	zheng'ce'xuan'chuan	0
政论	zheng'lun	0
政治报道	zheng'zhi'bao'dao	0
政治新闻	zheng'zhi'xin'wen	0
直接性材料	zhi'jie'xing'cai'liao	0
直接性导语	zhi'jie'xing'dao'yu	0
专电	zhuan'dian	0
专栏评论	zhuan'lan'ping'lun	0
专论	zhuan'lun	0
专题评论	zhuan'ti'ping'lun	0
专题讨论	zhuan'ti'tao'lun	0
自由式结构	zi'you'shi'jie'gou	0
综合新闻	zong'he'xin'wen	0
综合型导语	zong'he'xing'dao'yu	0
