阿胶片	a'jiao'pian	0
阿卡波糖片	a'ka'bo'tang'pian	0
阿莫西林分散片	a'mo'xi'lin'fen'san'pian	0
阿莫西林干混悬剂	a'mo'xi'lin'gan'hun'xuan'ji	0
阿莫西林胶囊	a'mo'xi'lin'jiao'nang	0
阿莫西林克拉维酸钾片	a'mo'xi'lin'ke'la'wei'suan'jia'pian	0
阿莫西林颗粒	a'mo'xi'lin'ke'li	0
阿奇霉素分散片	a'qi'mei'su'fen'san'pian	0
阿奇霉素颗粒	a'qi'mei'su'ke'li	0
阿奇霉素片	a'qi'mei'su'pian	0
阿斯利康制药有限公司	a'si'li'kang'zhi'yao'you'xian'gong'si	0
阿司匹林肠溶片	a'si'pi'lin'chang'rong'pian	0
阿司匹林肠溶片大	a'si'pi'lin'chang'rong'pian'da	0
阿替洛尔片	a'ti'luo'er'pian	0
阿托伐他汀钙片	a'tuo'fa'ta'ting'gai'pian	0
阿昔洛韦滴眼液	a'xi'luo'wei'di'yan'ye	0
阿昔洛韦片	a'xi'luo'wei'pian	0
阿西洛韦片	a'xi'luo'wei'pian	0
阿昔洛韦乳膏	a'xi'luo'wei'ru'gao	0
艾附暖宫丸	ai'fu'nuan'gong'wan	0
爱人坊	ai'ren'fang	0
埃索美拉唑镁肠溶片	ai'suo'mei'la'zuo'mei'chang'rong'pian	0
氨茶碱片	an'cha'jian'pian	0
氨茶碱注射液	an'cha'jian'zhu'she'ye	0
氨酚待因片	an'fen'dai'yin'pian	0
氨酚咖黄烷胺片	an'fen'ka'huang'wan'an'pian	0
氨酚咖那敏片唯金诺	an'fen'ka'na'min'pian'wei'jin'nuo	0
氨酚咖匹林片	an'fen'ka'pi'lin'pian	0
氨酚羟考酮片	an'fen'qiang'kao'tong'pian	0
安宫牛黄丸	an'gong'niu'huang'wan	0
安徽方达药械有限公司	an'hui'fang'da'yao'xie'you'xian'gong'si	0
安徽丰原药业有限公司	an'hui'feng'yuan'yao'ye'you'xian'gong'si	0
安徽鸿基伟业医疗器械有限公司	an'hui'hong'ji'wei'ye'yi'liao'qi'xie'you'xian'gong'si	0
安徽华佗国药股份有限公司	an'hui'hua'tuo'guo'yao'gu'fen'you'xian'gong'si	0
安徽济丰药业有限公司	an'hui'ji'feng'yao'ye'you'xian'gong'si	0
安徽金太阳生化药业有限公司	an'hui'jin'tai'yang'sheng'hua'yao'ye'you'xian'gong'si	0
安徽精方药业股份有限公司	an'hui'jing'fang'yao'ye'gu'fen'you'xian'gong'si	0
安徽联谊药业股份有限公司	an'hui'lian'yi'yao'ye'gu'fen'you'xian'gong'si	0
安徽孟仁寿制药有限公司	an'hui'meng'ren'shou'zhi'yao'you'xian'gong'si	0
安徽省天康药业有限公司	an'hui'sheng'tian'kang'yao'ye'you'xian'gong'si	0
安徽省皖北药业股份有限公司	an'hui'sheng'wan'bei'yao'ye'gu'fen'you'xian'gong'si	0
安徽省先锋制药有限公司	an'hui'sheng'xian'feng'zhi'yao'you'xian'gong'si	0
安徽双鹤药业	an'hui'shuang'he'yao'ye	0
安徽天洋药业有限公司	an'hui'tian'yang'yao'ye'you'xian'gong'si	0
安徽威尔曼制药有限公司	an'hui'wei'er'man'zhi'yao'you'xian'gong'si	0
氨基比林咖啡因片	an'ji'bi'lin'ka'fei'yin'pian	0
氨基葡萄糖硫酸软骨	an'ji'pu'tao'tang'liu'suan'ruan'gu	0
氨甲苯酸注射液	an'jia'ben'suan'zhu'she'ye	0
氨加黄敏胶囊	an'jia'huang'min'jiao'nang	0
氨咖黄敏胶囊	an'ka'huang'min'jiao'nang	0
氨咖黄敏片	an'ka'huang'min'pian	0
安康正大制药有限公司	an'kang'zheng'da'zhi'yao'you'xian'gong'si	0
安乐片	an'le'pian	0
安络痛片	an'luo'tong'pian	0
安眠补脑糖浆	an'mian'bu'nao'tang'jiang	0
按摩捶七头白色	an'mo'chui'qi'tou'bai'se	0
按摩捶穴位红色	an'mo'chui'xue'wei'hong'se	0
安乃近片	an'nai'jin'pian	0
安脑牛黄片	an'nao'niu'huang'pian	0
安神补脑片	an'shen'bu'nao'pian	0
安神补脑液	an'shen'bu'nao'ye	0
安神胶囊	an'shen'jiao'nang	0
安神丸	an'shen'wan	0
安睡胶囊	an'shui'jiao'nang	0
氨糖美辛肠溶片	an'tang'mei'xin'chang'rong'pian	0
安稳免调码血糖试纸采血针	an'wen'mian'tiao'ma'xue'tang'shi'zhi'cai'xue'zhen	0
安稳血糖仪	an'wen'xue'tang'yi	0
氨溴索右美沙芬片	an'xiu'suo'you'mei'sha'fen'pian	0
安阳九州药业有限责任公司	an'yang'jiu'zhou'yao'ye'you'xian'ze'ren'gong'si	0
安阳市华安药业有限责任公司	an'yang'shi'hua'an'yao'ye'you'xian'ze'ren'gong'si	0
奥美拉唑肠溶胶囊	ao'mei'la'zuo'chang'rong'jiao'nang	0
奥美拉唑肠溶片	ao'mei'la'zuo'chang'rong'pian	0
奥硝唑氯化钠注射液	ao'xiao'zuo'lv'hua'na'zhu'she'ye	0
奥硝唑片	ao'xiao'zuo'pian	0
奥新妮超值装	ao'xin'ni'chao'zhi'zhuang	0
奥扎格雷钠注射液	ao'zha'ge'lei'na'zhu'she'ye	0
八味小檗皮散	ba'wei'xiao'bo'pi'san	0
八珍益母丸	ba'zhen'yi'mu'wan	0
百邦牌金诺钙咀嚼片儿童型	bai'bang'pai'jin'nuo'gai'ju'jue'pian'er'tong'xing	0
百补增力丸	bai'bu'zeng'li'wan	0
白城市亿正药业有限公司	bai'cheng'shi'yi'zheng'yao'ye'you'xian'gong'si	0
拜耳医药保健有限公司	bai'er'yi'yao'bao'jian'you'xian'gong'si	0
白凡士林	bai'fan'shi'lin	0
百合固金丸	bai'he'gu'jin'wan	0
百花蜜	bai'hua'mi	0
白求恩医科大学制药厂	bai'qiu'en'yi'ke'da'xue'zhi'yao'chang	0
白山健宁药业有限公司	bai'shan'jian'ning'yao'ye'you'xian'gong'si	0
白山市吉品土特产有限公司	bai'shan'shi'ji'pin'tu'te'chan'you'xian'gong'si	0
白山市神农源生物科技有限公司	bai'shan'shi'shen'nong'yuan'sheng'wu'ke'ji'you'xian'gong'si	0
百癣夏塔热片	bai'xuan'xia'ta're'pian	0
百正药业有限公司	bai'zheng'yao'ye'you'xian'gong'si	0
柏栀祛湿洗液	bai'zhi'qu'shi'xi'ye	0
柏子养心丸	bai'zi'yang'xin'wan	0
板兰根颗粒	ban'lan'gen'ke'li	0
板蓝根颗粒	ban'lan'gen'ke'li	0
宝宝草本护臀霜	bao'bao'cao'ben'hu'tun'shuang	0
宝宝肤专家	bao'bao'fu'zhuan'jia	0
鲍勃趣味套奔放型	bao'bo'qu'wei'tao'ben'fang'xing	0
鲍勃趣味套活力型	bao'bo'qu'wei'tao'huo'li'xing	0
鲍勃趣味套激情型	bao'bo'qu'wei'tao'ji'qing'xing	0
保定天浩制药有限公司	bao'ding'tian'hao'zhi'yao'you'xian'gong'si	0
保妇康栓	bao'fu'kang'shuan	0
保和丸	bao'he'wan	0
宝咳宁颗粒	bao'ke'ning'ke'li	0
胞磷胆碱钠注射液	bao'lin'dan'jian'na'zhu'she'ye	0
保胎灵片	bao'tai'ling'pian	0
保胎丸	bao'tai'wan	0
保心宁胶囊	bao'xin'ning'jiao'nang	0
保心宁片	bao'xin'ning'pian	0
保心片	bao'xin'pian	0
北豆根胶囊	bei'dou'gen'jiao'nang	0
北海阳光医药有限公司	bei'hai'yang'guang'yi'yao'you'xian'gong'si	0
北京北大维信生物科技有限公司	bei'jing'bei'da'wei'xin'sheng'wu'ke'ji'you'xian'gong'si	0
北京勃然制药有限公司	bei'jing'bo'ran'zhi'yao'you'xian'gong'si	0
北京长城制药厂	bei'jing'chang'cheng'zhi'yao'chang	0
北京东升制药有限公司	bei'jing'dong'sheng'zhi'yao'you'xian'gong'si	0
北京方生益达科技发展有限公司	bei'jing'fang'sheng'yi'da'ke'ji'fa'zhan'you'xian'gong'si	0
北京冠城药业有限公司	bei'jing'guan'cheng'yao'ye'you'xian'gong'si	0
北京韩美药品有限公司	bei'jing'han'mei'yao'pin'you'xian'gong'si	0
北京厚美德生物科技有限公司	bei'jing'hou'mei'de'sheng'wu'ke'ji'you'xian'gong'si	0
北京华素制药股份有限公司	bei'jing'hua'su'zhi'yao'gu'fen'you'xian'gong'si	0
北京金塞药业有限责任公司	bei'jing'jin'sai'yao'ye'you'xian'ze'ren'gong'si	0
北京京丰制药有限公司	bei'jing'jing'feng'zhi'yao'you'xian'gong'si	0
北京九龙制药有限公司	bei'jing'jiu'long'zhi'yao'you'xian'gong'si	0
北京凯因科技股份有限公司	bei'jing'kai'yin'ke'ji'gu'fen'you'xian'gong'si	0
北京康达五洲医疗器械中心	bei'jing'kang'da'wu'zhou'yi'liao'qi'xie'zhong'xin	0
北京科力康成医药有限公司	bei'jing'ke'li'kang'cheng'yi'yao'you'xian'gong'si	0
北京梅兰竹菊生物科技有限公司	bei'jing'mei'lan'zhu'ju'sheng'wu'ke'ji'you'xian'gong'si	0
北京诺华制药有限公司	bei'jing'nuo'hua'zhi'yao'you'xian'gong'si	0
北京赛而生物科技有限公司	bei'jing'sai'er'sheng'wu'ke'ji'you'xian'gong'si	0
北京赛升药业股份有限公司	bei'jing'sai'sheng'yao'ye'gu'fen'you'xian'gong'si	0
北京圣永制药有限公司	bei'jing'sheng'yong'zhi'yao'you'xian'gong'si	0
北京市燕京药业有限公司	bei'jing'shi'yan'jing'yao'ye'you'xian'gong'si	0
北京曙光药业有限责任公司	bei'jing'shu'guang'yao'ye'you'xian'ze'ren'gong'si	0
北京四环制药有限公司	bei'jing'si'huan'zhi'yao'you'xian'gong'si	0
北京斯利安药业有限公司	bei'jing'si'li'an'yao'ye'you'xian'gong'si	0
北京同仁堂制药有限公司	bei'jing'tong'ren'tang'zhi'yao'you'xian'gong'si	0
北京益民药业有限公司	bei'jing'yi'min'yao'ye'you'xian'gong'si	0
北京永正制药有限责任公司	bei'jing'yong'zheng'zhi'yao'you'xian'ze'ren'gong'si	0
北京中新制药厂	bei'jing'zhong'xin'zhi'yao'chang	0
北京紫竹药业有限公司	bei'jing'zi'zhu'yao'ye'you'xian'gong'si	0
苯苯海明片	ben'ben'hai'ming'pian	0
苯海拉明片	ben'hai'la'ming'pian	0
苯磺酸氨氯地平片	ben'huang'suan'an'lv'di'ping'pian	0
苯磺酸氨氯地平片步长	ben'huang'suan'an'lv'di'ping'pian'bu'chang	0
苯磺酸左旋氨氯地平片	ben'huang'suan'zuo'xuan'an'lv'di'ping'pian	0
本溪仙草堂药业有限公司	ben'xi'xian'cao'tang'yao'ye'you'xian'gong'si	0
吡拉西坦氯化钠注射液	bi'la'xi'tan'lv'hua'na'zhu'she'ye	0
吡拉西坦片	bi'la'xi'tan'pian	0
吡罗昔康片	bi'luo'xi'kang'pian	0
铋镁豆蔻片	bi'mei'dou'kou'pian	0
吡诺克辛钠滴眼液	bi'nuo'ke'xin'na'di'yan'ye	0
吡哌酸片	bi'pai'suan'pian	0
吡嗪酰胺片	bi'qin'xian'an'pian	0
碧生源减肥茶	bi'sheng'yuan'jian'fei'cha	0
鼻舒适片	bi'shu'shi'pian	0
鼻炎康片	bi'yan'kang'pian	0
避孕套铁汉草莓图	bi'yun'tao'tie'han'cao'mei'tu	0
苄达赖氨酸滴眼液	bian'da'lai'an'suan'di'yan'ye	0
别嘌醇片	bie'piao'chun'pian	0
丙谷胺片	bing'gu'an'pian	0
槟榔四消丸	bing'lang'si'xiao'wan	0
丙酸交沙霉素颗粒	bing'suan'jiao'sha'mei'su'ke'li	0
丙酸氯倍他索乳膏	bing'suan'lv'bei'ta'suo'ru'gao	0
博福益普生天津制药有限公司	bo'fu'yi'pu'sheng'tian'jin'zhi'yao'you'xian'gong'si	0
薄荷除臭鞋垫	bo'he'chu'chou'xie'dian	0
博凯泡泡牌葡萄糖酸锌泡腾片	bo'kai'pao'pao'pai'pu'tao'tang'suan'xin'pao'teng'pian	0
博凯泡泡牌葡萄糖酸亚铁泡腾片	bo'kai'pao'pao'pai'pu'tao'tang'suan'ya'tie'pao'teng'pian	0
玻璃火罐	bo'li'huo'guan	0
玻璃酒缸	bo'li'jiu'gang	0
拨云退翳丸	bo'yun'tui'yi'wan	0
补金片	bu'jin'pian	0
布洛芬缓释胶囊	bu'luo'fen'huan'shi'jiao'nang	0
布洛芬颗粒	bu'luo'fen'ke'li	0
布洛芬片	bu'luo'fen'pian	0
补脑安神片	bu'nao'an'shen'pian	0
补肾安神口服液	bu'shen'an'shen'kou'fu'ye	0
补肾强身片	bu'shen'qiang'shen'pian	0
补肾丸	bu'shen'wan	0
补肾益肠丸	bu'shen'yi'chang'wan	0
补肾益脑胶囊	bu'shen'yi'nao'jiao'nang	0
补血乳酸亚铁口服液	bu'xue'ru'suan'ya'tie'kou'fu'ye	0
补中益气丸	bu'zhong'yi'qi'wan	0
彩色普通带点口罩卡伊秀	cai'se'pu'tong'dai'dian'kou'zhao'ka'yi'xiu	0
蚕蛾公补片	can'e'gong'bu'pian	0
参莲利带洗液	can'lian'li'dai'xi'ye	0
参梅养胃颗粒	can'mei'yang'wei'ke'li	0
参芍胶囊	can'shao'jiao'nang	0
参松养心胶囊	can'song'yang'xin'jiao'nang	0
参苏感冒片	can'su'gan'mao'pian	0
参天制药中国有限公司	can'tian'zhi'yao'zhong'guo'you'xian'gong'si	0
参芎葡萄糖注射液	can'xiong'pu'tao'tang'zhu'she'ye	0
沧州得能制药有限公司	cang'zhou'dei'neng'zhi'yao'you'xian'gong'si	0
草本防脱控油洗发露	cao'ben'fang'tuo'kong'you'xi'fa'lu	0
草珊瑚薄荷含片	cao'shan'hu'bo'he'han'pian	0
测利得血糖仪	ce'li'de'xue'tang'yi	0
茶碱缓释片	cha'jian'huan'shi'pian	0
茶碱愈创甘油醚软胶囊	cha'jian'yu'chuang'gan'you'mi'ruan'jiao'nang	0
柴胡舒肝丸	chai'hu'shu'gan'wan	0
柴黄颗粒	chai'huang'ke'li	0
长白山古岳	chang'bai'shan'gu'yue	0
长长春大政药业有限公司	chang'chang'chun'da'zheng'yao'ye'you'xian'gong'si	0
长春	chang'chun	0
长春白求恩医疗器械有限公司	chang'chun'bai'qiu'en'yi'liao'qi'xie'you'xian'gong'si	0
长春北华药业有限公司	chang'chun'bei'hua'yao'ye'you'xian'gong'si	0
长春长红制药有限公司	chang'chun'chang'hong'zhi'yao'you'xian'gong'si	0
长春长虹制药有限公司	chang'chun'chang'hong'zhi'yao'you'xian'gong'si	0
长春海外制药集团有限公司	chang'chun'hai'wai'zhi'yao'ji'tuan'you'xian'gong'si	0
长春经开药业有限公司	chang'chun'jing'kai'yao'ye'you'xian'gong'si	0
长春精优药业股份有限公司	chang'chun'jing'you'yao'ye'gu'fen'you'xian'gong'si	0
长春普华制药股份有限公司	chang'chun'pu'hua'zhi'yao'gu'fen'you'xian'gong'si	0
长春人民药业集团有限公司	chang'chun'ren'min'yao'ye'ji'tuan'you'xian'gong'si	0
长春万德制药有限公司	chang'chun'wan'de'zhi'yao'you'xian'gong'si	0
长春西汀片	chang'chun'xi'ting'pian	0
长春新安药业有限公司	chang'chun'xin'an'yao'ye'you'xian'gong'si	0
长春新宇制药有限公司	chang'chun'xin'yu'zhi'yao'you'xian'gong'si	0
长春氧利康制氧气有限公司	chang'chun'yang'li'kang'zhi'yang'qi'you'xian'gong'si	0
长春银诺克药业有限公司	chang'chun'yin'nuo'ke'yao'ye'you'xian'gong'si	0
长春英平药业有限公司	chang'chun'ying'ping'yao'ye'you'xian'gong'si	0
长春远大国奥制药有限公司	chang'chun'yuan'da'guo'ao'zhi'yao'you'xian'gong'si	0
肠康片	chang'kang'pian	0
肠炎宁片	chang'yan'ning'pian	0
常州千红生化制药股份有限公司	chang'zhou'qian'hong'sheng'hua'zhi'yao'gu'fen'you'xian'gong'si	0
超声波多功能数码电子治疗仪	chao'sheng'bo'duo'gong'neng'shu'ma'dian'zi'zhi'liao'yi	0
超值血糖试片	chao'zhi'xue'tang'shi'pian	0
沉香化气片	chen'xiang'hua'qi'pian	0
陈香露白露片	chen'xiang'lu'bai'lu'pian	0
晨欣药业股份有限公司	chen'xin'yao'ye'gu'fen'you'xian'gong'si	0
辰欣药业股份有限公司	chen'xin'yao'ye'gu'fen'you'xian'gong'si	0
承德颈复康药业集团有限公司	cheng'de'jing'fu'kang'yao'ye'ji'tuan'you'xian'gong'si	0
承德市御金丹药业有限公司	cheng'de'shi'yu'jin'dan'yao'ye'you'xian'gong'si	0
承德燕峰药业有限公司	cheng'de'yan'feng'yao'ye'you'xian'gong'si	0
成都百裕科技制药有限公司	cheng'du'bai'yu'ke'ji'zhi'yao'you'xian'gong'si	0
成都倍特药业有限公司	cheng'du'bei'te'yao'ye'you'xian'gong'si	0
成都地奥制药集团有限公司	cheng'du'di'ao'zhi'yao'ji'tuan'you'xian'gong'si	0
成都迪康制药有限公司	cheng'du'di'kang'zhi'yao'you'xian'gong'si	0
成都东洋百信制药有限公司	cheng'du'dong'yang'bai'xin'zhi'yao'you'xian'gong'si	0
成都锦华药业有限责任公司	cheng'du'jin'hua'yao'ye'you'xian'ze'ren'gong'si	0
成都康弘制药有限公司	cheng'du'kang'hong'zhi'yao'you'xian'gong'si	0
成都乐本力源食品有限公司	cheng'du'le'ben'li'yuan'shi'pin'you'xian'gong'si	0
成长快乐复合维生素软片	cheng'zhang'kuai'le'fu'he'wei'sheng'su'ruan'pian	0
赤峰蒙欣药业有限公司	chi'feng'meng'xin'yao'ye'you'xian'gong'si	0
赤峰天奇在药业有限公司	chi'feng'tian'qi'zai'yao'ye'you'xian'gong'si	0
赤峰维康生化制药有限公司	chi'feng'wei'kang'sheng'hua'zhi'yao'you'xian'gong'si	0
重庆多普泰制药有限公司	chong'qing'duo'pu'tai'zhi'yao'you'xian'gong'si	0
重庆佳辰生物工程有限公司	chong'qing'jia'chen'sheng'wu'gong'cheng'you'xian'gong'si	0
重庆科瑞海南制药有限责任公司	chong'qing'ke'rui'hai'nan'zhi'yao'you'xian'ze'ren'gong'si	0
重庆科瑞制药集团有限公司	chong'qing'ke'rui'zhi'yao'ji'tuan'you'xian'gong'si	0
重庆市医济堂生物制品有限公司	chong'qing'shi'yi'ji'tang'sheng'wu'zhi'pin'you'xian'gong'si	0
重庆药友制药有限责任公司	chong'qing'yao'you'zhi'yao'you'xian'ze'ren'gong'si	0
重庆制药九厂	chong'qing'zhi'yao'jiu'chang	0
重组人粒细胞刺激因子注射液	chong'zu'ren'li'xi'bao'ci'ji'yin'zi'zhu'she'ye	0
除湿白带丸	chu'shi'bai'dai'wan	0
除纹抗皱霜	chu'wen'kang'zhou'shuang	0
除脂生发片	chu'zhi'sheng'fa'pian	0
川贝枇杷糖浆	chuan'bei'pi'pa'tang'jiang	0
穿龙骨刺片	chuan'long'gu'ci'pian	0
川奇消食片	chuan'qi'xiao'shi'pian	0
喘舒片	chuan'shu'pian	0
穿王消炎胶囊	chuan'wang'xiao'yan'jiao'nang	0
穿心连片	chuan'xin'lian'pian	0
川芎茶调颗粒	chuan'xiong'cha'tiao'ke'li	0
床式医用气垫	chuang'shi'yi'yong'qi'dian	0
唇齿清胃丸	chun'chi'qing'wei'wan	0
刺五加颗粒	ci'wu'jia'ke'li	0
刺五加脑灵胶囊	ci'wu'jia'nao'ling'jiao'nang	0
刺五加脑灵液	ci'wu'jia'nao'ling'ye	0
刺五加片	ci'wu'jia'pian	0
刺五加注射液	ci'wu'jia'zhu'she'ye	0
醋酸地塞米松片	cu'suan'di'sai'mi'song'pian	0
醋酸地塞米松粘贴剂	cu'suan'di'sai'mi'song'zhan'tie'ji	0
醋酸氟轻松冰片乳膏	cu'suan'fu'qing'song'bing'pian'ru'gao	0
醋酸甲羟孕酮片	cu'suan'jia'qiang'yun'tong'pian	0
醋酸泼尼松龙注射液	cu'suan'po'ni'song'long'zhu'she'ye	0
醋酸泼尼松片	cu'suan'po'ni'song'pian	0
醋酸曲安奈德尿素乳膏	cu'suan'qu'an'nai'de'niao'su'ru'gao	0
醋酸曲安奈德尿素软膏	cu'suan'qu'an'nai'de'niao'su'ruan'gao	0
醋酸曲安奈德注射液	cu'suan'qu'an'nai'de'zhu'she'ye	0
粗止血带	cu'zhi'xue'dai	0
大败毒胶囊	da'bai'du'jiao'nang	0
大川芎片	da'chuan'xiong'pian	0
大黄蛰虫丸	da'huang'zhe'chong'wan	0
大活络丸	da'huo'luo'wan	0
达克宁	da'ke'ning	0
大理药业股份有限公司	da'li'yao'ye'gu'fen'you'xian'gong'si	0
大连富生制药	da'lian'fu'sheng'zhi'yao	0
大连辉仁制药有限公司	da'lian'hui'ren'zhi'yao'you'xian'gong'si	0
大连桑拓生物新技术有限公司	da'lian'sang'tuo'sheng'wu'xin'ji'shu'you'xian'gong'si	0
大连市水产药业有限公司	da'lian'shi'shui'chan'yao'ye'you'xian'gong'si	0
大连水产药业有限公司	da'lian'shui'chan'yao'ye'you'xian'gong'si	0
大连雄伟保健品有限公司	da'lian'xiong'wei'bao'jian'pin'you'xian'gong'si	0
大镊子	da'nie'zi	0
大七厘胶囊	da'qi'li'jiao'nang	0
大山楂丸	da'shan'zha'wan	0
大同长兴制药有限责任公司	da'tong'chang'xing'zhi'yao'you'xian'ze'ren'gong'si	0
大同市卫华药业有限公司	da'tong'shi'wei'hua'yao'ye'you'xian'gong'si	0
大同市云冈制药有限公司	da'tong'shi'yun'gang'zhi'yao'you'xian'gong'si	0
蛋白粉颗粒葡萄味	dan'bai'fen'ke'li'pu'tao'wei	0
丹东医创药业有限责任公司	dan'dong'yi'chuang'yao'ye'you'xian'ze'ren'gong'si	0
丹佛胃尔康颗粒	dan'fo'wei'er'kang'ke'li	0
胆康片	dan'kang'pian	0
丹参川芎嗪注射液	dan'shen'chuan'xiong'qin'zhu'she'ye	0
丹参滴注液	dan'shen'di'zhu'ye	0
丹参舒心胶囊	dan'shen'shu'xin'jiao'nang	0
胆石利通片	dan'shi'li'tong'pian	0
胆舒软胶囊	dan'shu'ruan'jiao'nang	0
胆维丁乳	dan'wei'ding'ru	0
单硝酸异山梨酯缓释片	dan'xiao'suan'yi'shan'li'zhi'huan'shi'pian	0
单硝酸异山梨酯氯化钠注射液	dan'xiao'suan'yi'shan'li'zhi'lv'hua'na'zhu'she'ye	0
单硝酸异山梨酯片	dan'xiao'suan'yi'shan'li'zhi'pian	0
丹栀逍遥丸	dan'zhi'xiao'yao'wan	0
德国威玛舒培博士制药厂	de'guo'wei'ma'shu'pei'bo'shi'zhi'yao'chang	0
德州鑫瑞达消毒制品有限公司	de'zhou'xin'rui'da'xiao'du'zhi'pin'you'xian'gong'si	0
德州益家康消毒制品有限公司	de'zhou'yi'jia'kang'xiao'du'zhi'pin'you'xian'gong'si	0
灯盏花素片	deng'zhan'hua'su'pian	0
地奥心血康	di'ao'xin'xue'kang	0
地巴唑片	di'ba'zuo'pian	0
地高辛片	di'gao'xin'pian	0
地塞米松磷钠注射液	di'sai'mi'song'lin'na'zhu'she'ye	0
地塞米松磷酸钠滴眼液	di'sai'mi'song'lin'suan'na'di'yan'ye	0
地塞米松磷酸钠注射液	di'sai'mi'song'lin'suan'na'zhu'she'ye	0
迪沙药业集团有限公司	di'sha'yao'ye'ji'tuan'you'xian'gong'si	0
滴通鼻炎水喷雾剂	di'tong'bi'yan'shui'pen'wu'ji	0
滴眼用利福平	di'yan'yong'li'fu'ping	0
地衣牙孢杆菌活菌胶囊	di'yi'ya'bao'gan'jun'huo'jun'jiao'nang	0
地榆槐角丸	di'yu'huai'jiao'wan	0
碘酊	dian'ding	0
碘伏消毒液	dian'fu'xiao'du'ye	0
滇虹药业集团股份有限公司	dian'hong'yao'ye'ji'tuan'gu'fen'you'xian'gong'si	0
颠茄磺苄啶片	dian'qie'huang'bian'ding'pian	0
颠茄磺苄啶片大	dian'qie'huang'bian'ding'pian'da	0
颠茄片	dian'qie'pian	0
点舌丹	dian'she'dan	0
滇西白药	dian'xi'bai'yao	0
电子血压计上臂式	dian'zi'xue'ya'ji'shang'bi'shi	0
电子血压计腕式	dian'zi'xue'ya'ji'wan'shi	0
跌打红药片	die'da'hong'yao'pian	0
跌打活血散	die'da'huo'xue'san	0
跌打丸	die'da'wan	0
丁桂儿脐贴	ding'gui'er'qi'tie	0
丁硼乳膏	ding'peng'ru'gao	0
丁细牙痛胶囊	ding'xi'ya'tong'jiao'nang	0
冻疮暖肤膏	dong'chuang'nuan'fu'gao	0
东方钙中老年型	dong'fang'gai'zhong'lao'nian'xing	0
东方红彤	dong'fang'hong'tong	0
冬凌草糖浆	dong'ling'cao'tang'jiang	0
东洋蒲乳胶锦州有限公司	dong'yang'pu'ru'jiao'jin'zhou'you'xian'gong'si	0
独活寄生丸	du'huo'ji'sheng'wan	0
杜记独角膏	du'ji'du'jiao'gao	0
独一味软胶囊	du'yi'wei'ruan'jiao'nang	0
杜仲补腰合剂	du'zhong'bu'yao'he'ji	0
对乙酰氨基酚咀嚼片	dui'yi'xian'an'ji'fen'ju'jue'pian	0
对乙酰氨基酚颗粒	dui'yi'xian'an'ji'fen'ke'li	0
对乙酰氨基酚片	dui'yi'xian'an'ji'fen'pian	0
对已酰氨基酚栓	dui'yi'xian'an'ji'fen'shuan	0
多多药业有限公司	duo'duo'yao'ye'you'xian'gong'si	0
朵儿减肥胶囊	duo'er'jian'fei'jiao'nang	0
多乐士避孕套	duo'le'shi'bi'yun'tao	0
多酶片	duo'mei'pian	0
多潘立酮口腔崩解片	duo'pan'li'tong'kou'qiang'beng'jie'pian	0
多潘立酮片	duo'pan'li'tong'pian	0
多索茶碱片	duo'suo'cha'jian'pian	0
多索茶碱葡萄糖注射液	duo'suo'cha'jian'pu'tao'tang'zhu'she'ye	0
多维元素片	duo'wei'yuan'su'pian	0
多维元素片儿童	duo'wei'yuan'su'pian'er'tong	0
多种维生素矿物质泡腾片	duo'zhong'wei'sheng'su'kuang'wu'zhi'pao'teng'pian	0
厄贝沙坦片	e'bei'sha'tan'pian	0
阿胶含片	e'jiao'han'pian	0
恩威制药	en'wei'zhi'yao	0
二丁颗粒	er'ding'ke'li	0
二甲双胍格列本脲片	er'jia'shuang'gua'ge'lie'ben'niao'pian	0
耳聋丸	er'long'wan	0
耳聋左慈丸	er'long'zuo'ci'wan	0
二十六味通经散	er'shi'liu'wei'tong'jing'san	0
二十味沉香丸	er'shi'wei'chen'xiang'wan	0
二十五味肺病丸	er'shi'wu'wei'fei'bing'wan	0
二十五味鬼臼丸	er'shi'wu'wei'gui'jiu'wan	0
二十五味珊瑚丸	er'shi'wu'wei'shan'hu'wan	0
二维葡磷钙咀嚼片	er'wei'pu'lin'gai'ju'jue'pian	0
法莫替丁片	fa'mo'ti'ding'pian	0
返魂草颗粒	fan'hun'cao'ke'li	0
凡士林霜	fan'shi'lin'shuang	0
泛昔洛韦胶囊	fan'xi'luo'wei'jiao'nang	0
防风通圣丸	fang'feng'tong'sheng'wan	0
防芷鼻炎片	fang'zhi'bi'yan'pian	0
非咯地平缓释片	fei'ge'di'ping'huan'shi'pian	0
肺结核丸	fei'jie'he'wan	0
肺力咳合剂	fei'li'ke'he'ji	0
菲林刺绣口罩	fei'lin'ci'xiu'kou'zhao	0
非那雄胺片	fei'na'xiong'an'pian	0
肺宁颗粒	fei'ning'ke'li	0
肺宁片	fei'ning'pian	0
芬布芬片	fen'bu'fen'pian	0
酚咖片	fen'ka'pian	0
酚酞片	fen'tai'pian	0
风寒咳嗽颗粒	feng'han'ke'sou'ke'li	0
风寒双离拐片	feng'han'shuang'li'guai'pian	0
蜂胶软胶囊维尔健	feng'jiao'ruan'jiao'nang'wei'er'jian	0
枫蓼肠胃康片	feng'liao'chang'wei'kang'pian	0
风热感冒颗粒	feng're'gan'mao'ke'li	0
风湿安泰片	feng'shi'an'tai'pian	0
风湿关节炎贴	feng'shi'guan'jie'yan'tie	0
风湿痛贴	feng'shi'tong'tie	0
风油精	feng'you'jing	0
佛山德众药业有限公司	fo'shan'de'zhong'yao'ye'you'xian'gong'si	0
妇宝颗粒	fu'bao'ke'li	0
肤大夫软膏	fu'dai'fu'ruan'gao	0
富恩堂螺旋藻片	fu'en'tang'luo'xuan'zao'pian	0
富恩堂亚麻荞麦复合软胶囊	fu'en'tang'ya'ma'qiao'mai'fu'he'ruan'jiao'nang	0
复方氨酚苯海拉明片	fu'fang'an'fen'ben'hai'la'ming'pian	0
复方氨酚烷胺胶囊	fu'fang'an'fen'wan'an'jiao'nang	0
复方氨酚烷胺片	fu'fang'an'fen'wan'an'pian	0
复方氨林巴比妥注射液	fu'fang'an'lin'ba'bi'tuo'zhu'she'ye	0
复方百部止咳颗粒	fu'fang'bai'bu'zhi'ke'ke'li	0
复方百部止咳糖浆	fu'fang'bai'bu'zhi'ke'tang'jiang	0
复方保泰松鸡血藤片	fu'fang'bao'tai'song'ji'xue'teng'pian	0
复方苯巴比妥溴化钠片	fu'fang'ben'ba'bi'tuo'xiu'hua'na'pian	0
复方丙谷胺西咪替丁片	fu'fang'bing'gu'an'xi'mi'ti'ding'pian	0
复方草珊瑚含片	fu'fang'cao'shan'hu'han'pian	0
复方沉香胃片	fu'fang'chen'xiang'wei'pian	0
复方陈香胃片	fu'fang'chen'xiang'wei'pian	0
复方川贝精片	fu'fang'chuan'bei'jing'pian	0
复方穿心莲片	fu'fang'chuan'xin'lian'pian	0
复方醋酸地塞米松乳膏	fu'fang'cu'suan'di'sai'mi'song'ru'gao	0
复方蛋氨酸胆碱片	fu'fang'dan'an'suan'dan'jian'pian	0
复方丹参滴丸	fu'fang'dan'shen'di'wan	0
复方丹参片	fu'fang'dan'shen'pian	0
复方丹参丸	fu'fang'dan'shen'wan	0
复方胆通胶囊	fu'fang'dan'tong'jiao'nang	0
复方胆通片	fu'fang'dan'tong'pian	0
复方地芬诺酯片	fu'fang'di'fen'nuo'zhi'pian	0
复方杜仲胶囊	fu'fang'du'zhong'jiao'nang	0
复方莪术油栓	fu'fang'e'zhu'you'shuan	0
复方甘草口服溶液	fu'fang'gan'cao'kou'fu'rong'ye	0
复方甘草片	fu'fang'gan'cao'pian	0
复方甘草酸苷胶囊	fu'fang'gan'cao'suan'gan'jiao'nang	0
复方甘草酸苷注射液	fu'fang'gan'cao'suan'gan'zhu'she'ye	0
复方甘草浙贝氯化铵片	fu'fang'gan'cao'zhe'bei'lv'hua'an'pian	0
复方蛤青片	fu'fang'ge'qing'pian	0
复方骨肽注射液	fu'fang'gu'tai'zhu'she'ye	0
复方瓜子金颗粒	fu'fang'gua'zi'jin'ke'li	0
复方磺胺甲噁唑片	fu'fang'huang'an'jia'e'zuo'pian	0
复方磺胺脒片	fu'fang'huang'an'mi'pian	0
复方黄连素片	fu'fang'huang'lian'su'pian	0
复方桔梗止咳片	fu'fang'jie'geng'zhi'ke'pian	0
复方金银花颗粒	fu'fang'jin'yin'hua'ke'li	0
复方雷夫奴尔	fu'fang'lei'fu'nu'er	0
复方雷尼替丁胶囊	fu'fang'lei'ni'ti'ding'jiao'nang	0
复方利血平氨苯碟啶片	fu'fang'li'xue'ping'an'ben'die'ding'pian	0
复方利血平片	fu'fang'li'xue'ping'pian	0
复方硫黄乳膏	fu'fang'liu'huang'ru'gao	0
复方龙胆碳酸氢钠片	fu'fang'long'dan'tan'suan'qing'na'pian	0
复方芦荟胶囊	fu'fang'lu'hui'jiao'nang	0
复方芦荟片	fu'fang'lu'hui'pian	0
复方罗布麻片	fu'fang'luo'bu'ma'pian	0
复方铝酸铋片	fu'fang'lv'suan'bi'pian	0
复方氯已定地塞米松膜	fu'fang'lv'yi'ding'di'sai'mi'song'mo	0
复方脑蛋白水解物片	fu'fang'nao'dan'bai'shui'jie'wu'pian	0
复方牛黄消炎胶囊	fu'fang'niu'huang'xiao'yan'jiao'nang	0
复方气管炎片	fu'fang'qi'guan'yan'pian	0
复方青黛丸	fu'fang'qing'dai'wan	0
复方氢氧化铝片	fu'fang'qing'yang'hua'lv'pian	0
复方三嗪芦丁片	fu'fang'san'qin'lu'ding'pian	0
复方石韦胶囊	fu'fang'shi'wei'jiao'nang	0
复方石韦咀嚼片	fu'fang'shi'wei'ju'jue'pian	0
复方酮康唑发用洗剂	fu'fang'tong'kang'zuo'fa'yong'xi'ji	0
复方酮康唑软膏	fu'fang'tong'kang'zuo'ruan'gao	0
复方仙鹤草肠炎片	fu'fang'xian'he'cao'chang'yan'pian	0
复方杏香兔耳风胶囊	fu'fang'xing'xiang'tu'er'feng'jiao'nang	0
复方熊胆滴眼液	fu'fang'xiong'dan'di'yan'ye	0
复方岩白菜素片	fu'fang'yan'bai'cai'su'pian	0
复方羊角颗粒	fu'fang'yang'jiao'ke'li	0
复方羊角片	fu'fang'yang'jiao'pian	0
复方胰酶散	fu'fang'yi'mei'san	0
复方乙酰水杨酸片	fu'fang'yi'xian'shui'yang'suan'pian	0
复方左炔诺孕酮片	fu'fang'zuo'que'nuo'yun'tong'pian	0
附桂骨痛胶囊	fu'gui'gu'tong'jiao'nang	0
复合维生素眼部精华	fu'he'wei'sheng'su'yan'bu'jing'hua	0
复合维他命紧肤水	fu'he'wei'ta'ming'jin'fu'shui	0
福建省泉州罗裳山制药厂	fu'jian'sheng'quan'zhou'luo'shang'shan'zhi'yao'chang	0
福建太平洋制药有限公司	fu'jian'tai'ping'yang'zhi'yao'you'xian'gong'si	0
妇康片	fu'kang'pian	0
氟康唑胶囊	fu'kang'zuo'jiao'nang	0
氟康唑氯化钠注射液	fu'kang'zuo'lv'hua'na'zhu'she'ye	0
氟康唑片	fu'kang'zuo'pian	0
腹可安片	fu'ke'an'pian	0
妇科千金片	fu'ke'qian'jin'pian	0
妇科调经颗粒	fu'ke'tiao'jing'ke'li	0
妇科调经片	fu'ke'tiao'jing'pian	0
妇科止血灵片	fu'ke'zhi'xue'ling'pian	0
妇乐颗粒	fu'le'ke'li	0
茯苓蒲公英祛味洗液	fu'ling'pu'gong'ying'qu'wei'xi'ye	0
复明片	fu'ming'pian	0
呋喃妥因肠溶片	fu'nan'tuo'yin'chang'rong'pian	0
呋喃唑酮片	fu'nan'zuo'tong'pian	0
妇平胶囊	fu'ping'jiao'nang	0
辅仁药业集团有限公司	fu'ren'yao'ye'ji'tuan'you'xian'gong'si	0
呋塞米片	fu'sai'mi'pian	0
呋塞米注射液	fu'sai'mi'zhu'she'ye	0
弗泰吏腹泻贴	fu'tai'li'fu'xie'tie	0
弗泰吏退热贴	fu'tai'li'tui're'tie	0
弗泰吏早孕检测笔	fu'tai'li'zao'yun'jian'ce'bi	0
阜新蒙药有限公司	fu'xin'meng'yao'you'xian'gong'si	0
妇炎洁	fu'yan'jie	0
妇炎净胶囊	fu'yan'jing'jiao'nang	0
妇炎净片	fu'yan'jing'pian	0
妇炎康复片	fu'yan'kang'fu'pian	0
妇炎康片	fu'yan'kang'pian	0
妇炎灵泡腾片	fu'yan'ling'pao'teng'pian	0
妇月康胶囊	fu'yue'kang'jiao'nang	0
福州辰星药业有限公司	fu'zhou'chen'xing'yao'ye'you'xian'gong'si	0
肤专家金三角喷剂	fu'zhuan'jia'jin'san'jiao'pen'ji	0
肤专家金三角软膏	fu'zhuan'jia'jin'san'jiao'ruan'gao	0
肤专家喷剂	fu'zhuan'jia'pen'ji	0
肤专家湿痒王	fu'zhuan'jia'shi'yang'wang	0
肤专家痛立消	fu'zhuan'jia'tong'li'xiao	0
肤专家癣王	fu'zhuan'jia'xuan'wang	0
附子理中丸	fu'zi'li'zhong'wan	0
噶日迪五味丸	ga'ri'di'wu'wei'wan	0
钙加锌口服液	gai'jia'xin'kou'fu'ye	0
钙软胶囊维尔健	gai'ruan'jiao'nang'wei'er'jian	0
盖胃平片	gai'wei'ping'pian	0
甘氨酸碳酸钙胶囊	gan'an'suan'tan'suan'gai'jiao'nang	0
甘草良咽糖	gan'cao'liang'yan'tang	0
甘草片	gan'cao'pian	0
甘草酸二注射液	gan'cao'suan'er'zhu'she'ye	0
肝复康丸	gan'fu'kang'wan	0
干酵母片	gan'jiao'mu'pian	0
橄榄深层清洁精油皂	gan'lan'shen'ceng'qing'jie'jing'you'zao	0
甘露醇注射液	gan'lu'chun'zhu'she'ye	0
甘露六烟酯片	gan'lu'liu'yan'zhi'pian	0
感冒灵颗粒	gan'mao'ling'ke'li	0
感冒清胶囊	gan'mao'qing'jiao'nang	0
感冒清颗粒	gan'mao'qing'ke'li	0
感冒清热颗粒	gan'mao'qing're'ke'li	0
感冒软胶囊	gan'mao'ruan'jiao'nang	0
感冒退烧片	gan'mao'tui'shao'pian	0
感冒止咳颗粒	gan'mao'zhi'ke'ke'li	0
甘舒霖笔	gan'shu'lin'bi	0
肝爽颗粒	gan'shuang'ke'li	0
甘肃成纪药业有限公司	gan'su'cheng'ji'yao'ye'you'xian'gong'si	0
甘肃佛仁制药科技有限公司	gan'su'fo'ren'zhi'yao'ke'ji'you'xian'gong'si	0
甘肃河西制药有限责任公司	gan'su'he'xi'zhi'yao'you'xian'ze'ren'gong'si	0
甘肃泰康	gan'su'tai'kang	0
甘肃天森药业有限公司	gan'su'tian'sen'yao'ye'you'xian'gong'si	0
甘肃新兰药药业有限公司	gan'su'xin'lan'yao'yao'ye'you'xian'gong'si	0
甘肃中天金丹药业有限公司	gan'su'zhong'tian'jin'dan'yao'ye'you'xian'gong'si	0
甘肃众友药业有限公司	gan'su'zhong'you'yao'ye'you'xian'gong'si	0
肝泰舒胶囊	gan'tai'shu'jiao'nang	0
感愈胶囊	gan'yu'jiao'nang	0
肛康穆库利片	gang'kang'mu'ku'li'pian	0
肛舒宁	gang'shu'ning	0
肛泰贴	gang'tai'tie	0
高锰酸钾	gao'meng'suan'jia	0
葛根素氯化钠注射液	ge'gen'su'lv'hua'na'zhu'she'ye	0
葛洪脚气水	ge'hong'jiao'qi'shui	0
蛤蚧定喘丸	ge'jie'ding'chuan'wan	0
格列本脲片	ge'lie'ben'niao'pian	0
格列吡嗪片	ge'lie'bi'qin'pian	0
格列美脲片	ge'lie'mei'niao'pian	0
格列奇特片	ge'lie'qi'te'pian	0
根痛平胶囊	gen'tong'ping'jiao'nang	0
更年安片	geng'nian'an'pian	0
更年灵胶囊	geng'nian'ling'jiao'nang	0
共轭亚油酸绿茶	gong'e'ya'you'suan'lv'cha	0
宫瘤消胶囊	gong'liu'xiao'jiao'nang	0
汞溴红溶液	gong'xiu'hong'rong'ye	0
宫血宁胶囊	gong'xue'ning'jiao'nang	0
宫炎康妇用洗液	gong'yan'kang'fu'yong'xi'ye	0
宫炎康胶囊	gong'yan'kang'jiao'nang	0
宫炎平分散片	gong'yan'ping'fen'san'pian	0
宫炎平胶囊	gong'yan'ping'jiao'nang	0
枸芪五味子胶囊维尔健	gou'qi'wu'wei'zi'jiao'nang'wei'er'jian	0
固本咳喘胶囊	gu'ben'ke'chuan'jiao'nang	0
固本延龄丸	gu'ben'yan'ling'wan	0
固肠胶囊	gu'chang'jiao'nang	0
固肠止泻丸	gu'chang'zhi'xie'wan	0
骨刺平片	gu'ci'ping'pian	0
骨刺消痛胶囊	gu'ci'xiao'tong'jiao'nang	0
骨刺消痛液	gu'ci'xiao'tong'ye	0
骨肽注射液	gu'tai'zhu'she'ye	0
谷维素片	gu'wei'su'pian	0
骨友灵擦剂	gu'you'ling'ca'ji	0
骨折挫伤胶囊	gu'zhe'cuo'shang'jiao'nang	0
骨质增生贴	gu'zhi'zeng'sheng'tie	0
关节止痛膏	guan'jie'zhi'tong'gao	0
冠脉宁片	guan'mai'ning'pian	0
冠心宁注射液	guan'xin'ning'zhu'she'ye	0
冠心七味片	guan'xin'qi'wei'pian	0
冠心生脉丸	guan'xin'sheng'mai'wan	0
冠心舒通胶囊	guan'xin'shu'tong'jiao'nang	0
冠心苏合丸	guan'xin'su'he'wan	0
冠心泰丸	guan'xin'tai'wan	0
广东百科制药有限公司	guang'dong'bai'ke'zhi'yao'you'xian'gong'si	0
广东邦民制药厂有限公司	guang'dong'bang'min'zhi'yao'chang'you'xian'gong'si	0
广东诚美经济发展有限公司	guang'dong'cheng'mei'jing'ji'fa'zhan'you'xian'gong'si	0
广东和平药业有限公司	guang'dong'he'ping'yao'ye'you'xian'gong'si	0
广东恒健制药有限公司	guang'dong'heng'jian'zhi'yao'you'xian'gong'si	0
广东宏盈科技有限公司	guang'dong'hong'ying'ke'ji'you'xian'gong'si	0
广东华润顺峰药业有限公司	guang'dong'hua'run'shun'feng'yao'ye'you'xian'gong'si	0
广东嘉应制药股份有限公司	guang'dong'jia'ying'zhi'yao'gu'fen'you'xian'gong'si	0
广东九连山药业有限公司	guang'dong'jiu'lian'shan'yao'ye'you'xian'gong'si	0
广东罗浮山国药股份有限公司	guang'dong'luo'fu'shan'guo'yao'gu'fen'you'xian'gong'si	0
广东美好制药有限公司	guang'dong'mei'hao'zhi'yao'you'xian'gong'si	0
广东南国药业有限公司	guang'dong'nan'guo'yao'ye'you'xian'gong'si	0
广东人人康药业有限公司	guang'dong'ren'ren'kang'yao'ye'you'xian'gong'si	0
广东省惠州市中药厂有限公司	guang'dong'sheng'hui'zhou'shi'zhong'yao'chang'you'xian'gong'si	0
广东太安堂药业股份有限公司	guang'dong'tai'an'tang'yao'ye'gu'fen'you'xian'gong'si	0
广东先强药业股份有限公司	guang'dong'xian'qiang'yao'ye'gu'fen'you'xian'gong'si	0
广东仙乐制药有限公司	guang'dong'xian'yue'zhi'yao'you'xian'gong'si	0
广东新峰药业股份有限公司	guang'dong'xin'feng'yao'ye'gu'fen'you'xian'gong'si	0
广东新功药业有限公司	guang'dong'xin'gong'yao'ye'you'xian'gong'si	0
广东星昊药业有限公司	guang'dong'xing'hao'yao'ye'you'xian'gong'si	0
广东亿超生物科技有限公司	guang'dong'yi'chao'sheng'wu'ke'ji'you'xian'gong'si	0
广东一禾药业有限公	guang'dong'yi'he'yao'ye'you'xian'gong	0
广东逸舒制药有限公司	guang'dong'yi'shu'zhi'yao'you'xian'gong'si	0
广西博科药业有限公司	guang'xi'bo'ke'yao'ye'you'xian'gong'si	0
广西禅房药业有限公司	guang'xi'chan'fang'yao'ye'you'xian'gong'si	0
广西禅方药业有限公司	guang'xi'chan'fang'yao'ye'you'xian'gong'si	0
广西纯正堂制药厂	guang'xi'chun'zheng'tang'zhi'yao'chang	0
广西大力神制药股份有限公司	guang'xi'da'li'shen'zhi'yao'gu'fen'you'xian'gong'si	0
广西河丰药业有限公司	guang'xi'he'feng'yao'ye'you'xian'gong'si	0
广西禾力药业有限公司	guang'xi'he'li'yao'ye'you'xian'gong'si	0
广西恒拓集团仁盛制药有限公司	guang'xi'heng'tuo'ji'tuan'ren'sheng'zhi'yao'you'xian'gong'si	0
广西金海堂药业有限责任公司	guang'xi'jin'hai'tang'yao'ye'you'xian'ze'ren'gong'si	0
广西金诺制药有限公司	guang'xi'jin'nuo'zhi'yao'you'xian'gong'si	0
广西金嗓子有限责任公司	guang'xi'jin'sang'zi'you'xian'ze'ren'gong'si	0
广西金页制药有限公司	guang'xi'jin'ye'zhi'yao'you'xian'gong'si	0
广西灵峰药业有限公司	guang'xi'ling'feng'yao'ye'you'xian'gong'si	0
广西柳州药业有限公司	guang'xi'liu'zhou'yao'ye'you'xian'gong'si	0
广西圣民制药有限公司	guang'xi'sheng'min'zhi'yao'you'xian'gong'si	0
广西圣特药业有限公司	guang'xi'sheng'te'yao'ye'you'xian'gong'si	0
广西世彪制药有限公司	guang'xi'shi'biao'zhi'yao'you'xian'gong'si	0
广西双蚁药业有限公司	guang'xi'shuang'yi'yao'ye'you'xian'gong'si	0
广西梧洲制药股份有限公司	guang'xi'wu'zhou'zhi'yao'gu'fen'you'xian'gong'si	0
广西梧州制药集团股份有限公司	guang'xi'wu'zhou'zhi'yao'ji'tuan'gu'fen'you'xian'gong'si	0
广西亿康药业股份有限公司	guang'xi'yi'kang'yao'ye'gu'fen'you'xian'gong'si	0
广西玉兰制药有限公司	guang'xi'yu'lan'zhi'yao'you'xian'gong'si	0
广西玉林制药集团有限责任公司	guang'xi'yu'lin'zhi'yao'ji'tuan'you'xian'ze'ren'gong'si	0
广州白云山制药总厂	guang'zhou'bai'yun'shan'zhi'yao'zong'chang	0
广州白云中一药业有限公司	guang'zhou'bai'yun'zhong'yi'yao'ye'you'xian'gong'si	0
广州大明联合橡胶制品有限公司	guang'zhou'da'ming'lian'he'xiang'jiao'zhi'pin'you'xian'gong'si	0
广州方凡生物科技有限公司	guang'zhou'fang'fan'sheng'wu'ke'ji'you'xian'gong'si	0
广州惠氏生物科技有限公司	guang'zhou'hui'shi'sheng'wu'ke'ji'you'xian'gong'si	0
广州金瀚泉生物科技有限公司	guang'zhou'jin'han'quan'sheng'wu'ke'ji'you'xian'gong'si	0
广州金益德医药科技有限公司	guang'zhou'jin'yi'de'yi'yao'ke'ji'you'xian'gong'si	0
广州康和药业有限公司	guang'zhou'kang'he'yao'ye'you'xian'gong'si	0
广州来泰制药有限公司	guang'zhou'lai'tai'zhi'yao'you'xian'gong'si	0
广州紐崔健医药科技有限公司	guang'zhou'niu'cui'jian'yi'yao'ke'ji'you'xian'gong'si	0
广州诺金制药有限公司	guang'zhou'nuo'jin'zhi'yao'you'xian'gong'si	0
广州市利恩生物科技有限公司	guang'zhou'shi'li'en'sheng'wu'ke'ji'you'xian'gong'si	0
广州市美笛尔生物科技有限公司	guang'zhou'shi'mei'di'er'sheng'wu'ke'ji'you'xian'gong'si	0
广州市沃美日化用品有限公司	guang'zhou'shi'wo'mei'ri'hua'yong'pin'you'xian'gong'si	0
广州市纤雅化妆品有限公司	guang'zhou'shi'xian'ya'hua'zhuang'pin'you'xian'gong'si	0
广州太安堂药业股份有限公司	guang'zhou'tai'an'tang'yao'ye'gu'fen'you'xian'gong'si	0
广州同济生物科技有限公司	guang'zhou'tong'ji'sheng'wu'ke'ji'you'xian'gong'si	0
广州维力医疗器械股份有限公司	guang'zhou'wei'li'yi'liao'qi'xie'gu'fen'you'xian'gong'si	0
广州懿森康生物科技有限公司	guang'zhou'yi'sen'kang'sheng'wu'ke'ji'you'xian'gong'si	0
桂附地黄丸	gui'fu'di'huang'wan	0
龟甲养阴片	gui'jia'yang'yin'pian	0
桂林南药股份有限公司	gui'lin'nan'yao'gu'fen'you'xian'gong'si	0
桂林三金药业股份有限公司	gui'lin'san'jin'yao'ye'gu'fen'you'xian'gong'si	0
桂林西瓜霜	gui'lin'xi'gua'shuang	0
桂灵片	gui'ling'pian	0
归龙筋骨宁片	gui'long'jin'gu'ning'pian	0
桂龙金骨宁片	gui'long'jin'gu'ning'pian	0
桂龙药业安徽有限公司	gui'long'yao'ye'an'hui'you'xian'gong'si	0
桂芝茯苓胶囊	gui'zhi'fu'ling'jiao'nang	0
桂芝茯苓丸	gui'zhi'fu'ling'wan	0
贵州安泰药业有限公司	gui'zhou'an'tai'yao'ye'you'xian'gong'si	0
贵州百灵企业集团制药有限公司	gui'zhou'bai'ling'qi'ye'ji'tuan'zhi'yao'you'xian'gong'si	0
贵州拜特制药有限公司	gui'zhou'bai'te'zhi'yao'you'xian'gong'si	0
贵州浩诚药业有限公司	gui'zhou'hao'cheng'yao'ye'you'xian'gong'si	0
贵州家诚药业有限责任公司	gui'zhou'jia'cheng'yao'ye'you'xian'ze'ren'gong'si	0
贵州健兴药业有限责任公司	gui'zhou'jian'xing'yao'ye'you'xian'ze'ren'gong'si	0
贵州景峰注射剂有限公司	gui'zhou'jing'feng'zhu'she'ji'you'xian'gong'si	0
贵州神奇药业有限公司	gui'zhou'shen'qi'yao'ye'you'xian'gong'si	0
贵州顺健制药有限公司	gui'zhou'shun'jian'zhi'yao'you'xian'gong'si	0
贵州天地药业有限责任公司	gui'zhou'tian'di'yao'ye'you'xian'ze'ren'gong'si	0
贵州同济堂制药有限公司	gui'zhou'tong'ji'tang'zhi'yao'you'xian'gong'si	0
贵州威门药业有限公司	gui'zhou'wei'men'yao'ye'you'xian'gong'si	0
贵州益佰制药有限公司	gui'zhou'yi'bai'zhi'yao'you'xian'gong'si	0
国哥	guo'ge	0
过氧化氢	guo'yang'hua'qing	0
国药集团工业有限公司	guo'yao'ji'tuan'gong'ye'you'xian'gong'si	0
国药集团国瑞药业有限公司	guo'yao'ji'tuan'guo'rui'yao'ye'you'xian'gong'si	0
国药集团容生制药有限公司	guo'yao'ji'tuan'rong'sheng'zhi'yao'you'xian'gong'si	0
国药集团三益药业芜湖有限公司	guo'yao'ji'tuan'san'yi'yao'ye'wu'hu'you'xian'gong'si	0
哈尔滨大洋制药股份有限公司	ha'er'bin'da'yang'zhi'yao'gu'fen'you'xian'gong'si	0
哈尔滨儿童制药厂有限公司	ha'er'bin'er'tong'zhi'yao'chang'you'xian'gong'si	0
哈尔滨华雨集团有限公司	ha'er'bin'hua'yu'ji'tuan'you'xian'gong'si	0
哈尔滨菌克消毒用品厂	ha'er'bin'jun'ke'xiao'du'yong'pin'chang	0
哈尔滨凯程制药有限公司	ha'er'bin'kai'cheng'zhi'yao'you'xian'gong'si	0
哈尔滨康友药业有限公司	ha'er'bin'kang'you'yao'ye'you'xian'gong'si	0
哈尔滨仁黄药业有限公司	ha'er'bin'ren'huang'yao'ye'you'xian'gong'si	0
哈尔滨三乐生物工程有限公司	ha'er'bin'san'le'sheng'wu'gong'cheng'you'xian'gong'si	0
哈尔滨三联药业	ha'er'bin'san'lian'yao'ye	0
哈尔滨三木制药厂	ha'er'bin'san'mu'zhi'yao'chang	0
哈尔滨圣泰生物制药有限公司	ha'er'bin'sheng'tai'sheng'wu'zhi'yao'you'xian'gong'si	0
哈尔滨市天使卫生材料厂	ha'er'bin'shi'tian'shi'wei'sheng'cai'liao'chang	0
哈尔滨泰华药业股份有限公司	ha'er'bin'tai'hua'yao'ye'gu'fen'you'xian'gong'si	0
哈尔滨同一堂药业有限公司	ha'er'bin'tong'yi'tang'yao'ye'you'xian'gong'si	0
哈尔滨一洲药业有限公司	ha'er'bin'yi'zhou'yao'ye'you'xian'gong'si	0
哈尔滨中药六厂有限公司	ha'er'bin'zhong'yao'liu'chang'you'xian'gong'si	0
哈西奈德溶液	ha'xi'nai'de'rong'ye	0
哈药集团三精明水药业有限公司	ha'yao'ji'tuan'san'jing'ming'shui'yao'ye'you'xian'gong'si	0
哈药集团三精千鹤制药有限公司	ha'yao'ji'tuan'san'jing'qian'he'zhi'yao'you'xian'gong'si	0
哈药集团三精制药股份有限公司	ha'yao'ji'tuan'san'jing'zhi'yao'gu'fen'you'xian'gong'si	0
哈药集团三精制药四厂有限公司	ha'yao'ji'tuan'san'jing'zhi'yao'si'chang'you'xian'gong'si	0
哈药集团世一堂制药厂	ha'yao'ji'tuan'shi'yi'tang'zhi'yao'chang	0
哈药集团制药六厂	ha'yao'ji'tuan'zhi'yao'liu'chang	0
哈药集团制药总厂	ha'yao'ji'tuan'zhi'yao'zong'chang	0
哈药集团中药二厂	ha'yao'ji'tuan'zhong'yao'er'chang	0
哈药牌钙铁锌口服液	ha'yao'pai'gai'tie'xin'kou'fu'ye	0
海狗人参丸	hai'gou'ren'shen'wan	0
海口奇力制药股份有限公司	hai'kou'qi'li'zhi'yao'gu'fen'you'xian'gong'si	0
海口市制药厂有限公司	hai'kou'shi'zhi'yao'chang'you'xian'gong'si	0
海南碧凯药业有限公司	hai'nan'bi'kai'yao'ye'you'xian'gong'si	0
海南海力制药有限公司	hai'nan'hai'li'zhi'yao'you'xian'gong'si	0
海南海灵化学制药有限公司	hai'nan'hai'ling'hua'xue'zhi'yao'you'xian'gong'si	0
海南全星制药有限公司	hai'nan'quan'xing'zhi'yao'you'xian'gong'si	0
海南省金岛制药厂	hai'nan'sheng'jin'dao'zhi'yao'chang	0
海南通用康力制药有限公司	hai'nan'tong'yong'kang'li'zhi'yao'you'xian'gong'si	0
海南通用同盟药业有限公司	hai'nan'tong'yong'tong'meng'yao'ye'you'xian'gong'si	0
海南万州绿色制药有限公司	hai'nan'wan'zhou'lv'se'zhi'yao'you'xian'gong'si	0
海南新世通药业有限公司	hai'nan'xin'shi'tong'yao'ye'you'xian'gong'si	0
海南养生堂药业有限公司	hai'nan'yang'sheng'tang'yao'ye'you'xian'gong'si	0
还少丹	hai'shao'dan	0
海王金樽片	hai'wang'jin'zun'pian	0
邯郸滏荣制药有限公司	han'dan'fu'rong'zhi'yao'you'xian'gong'si	0
邯郸市柏林药业有限公司	han'dan'shi'bo'lin'yao'ye'you'xian'gong'si	0
邯郸市冀南制药有限公司	han'dan'shi'ji'nan'zhi'yao'you'xian'gong'si	0
含糖稳心颗粒	han'tang'wen'xin'ke'li	0
汉桃叶片	han'tao'ye'pian	0
汉通药业	han'tong'yao'ye	0
杭州弗泰吏	hang'zhou'fu'tai'li	0
杭州国光药业有限公司	hang'zhou'guo'guang'yao'ye'you'xian'gong'si	0
杭州惠致源科技有限公司	hang'zhou'hui'zhi'yuan'ke'ji'you'xian'gong'si	0
好贝贝小儿益生菌冲剂	hao'bei'bei'xiao'er'yi'sheng'jun'chong'ji	0
好医生高钙片	hao'yi'sheng'gao'gai'pian	0
和爱佳儿	he'ai'jia'er	0
河北安国药业集团有限公司	he'bei'an'guo'yao'ye'ji'tuan'you'xian'gong'si	0
河北百善药业有限公司	he'bei'bai'shan'yao'ye'you'xian'gong'si	0
河北长天药业有限公司	he'bei'chang'tian'yao'ye'you'xian'gong'si	0
河北国金药业有限责任公司	he'bei'guo'jin'yao'ye'you'xian'ze'ren'gong'si	0
河北衡水世康医疗用品出厂	he'bei'heng'shui'shi'kang'yi'liao'yong'pin'chu'chang	0
河北金牛制药有限公司	he'bei'jin'niu'zhi'yao'you'xian'gong'si	0
河北巨龙药业有限责任公司	he'bei'ju'long'yao'ye'you'xian'ze'ren'gong'si	0
河北康济药械有限公司出品	he'bei'kang'ji'yao'xie'you'xian'gong'si'chu'pin	0
河北康泰药业有限公司	he'bei'kang'tai'yao'ye'you'xian'gong'si	0
河北瑞森药业有限公司	he'bei'rui'sen'yao'ye'you'xian'gong'si	0
河北天成药业股份有限公司	he'bei'tian'cheng'yao'ye'gu'fen'you'xian'gong'si	0
河北同乐乳胶制品有限公司	he'bei'tong'le'ru'jiao'zhi'pin'you'xian'gong'si	0
河北万邦复临药业有限公司	he'bei'wan'bang'fu'lin'yao'ye'you'xian'gong'si	0
河北万岁药业有限公司	he'bei'wan'sui'yao'ye'you'xian'gong'si	0
河北亿能普药业有限公司	he'bei'yi'neng'pu'yao'ye'you'xian'gong'si	0
河北永丰药业有限公司	he'bei'yong'feng'yao'ye'you'xian'gong'si	0
合肥华润神鹿药业有限公司	he'fei'hua'run'shen'lu'yao'ye'you'xian'gong'si	0
何荷胶囊	he'he'jiao'nang	0
荷兰欧加农公司	he'lan'ou'jia'nong'gong'si	0
河南鼎昌药业有限公司	he'nan'ding'chang'yao'ye'you'xian'gong'si	0
河南辅仁堂制药有限公司	he'nan'fu'ren'tang'zhi'yao'you'xian'gong'si	0
河南怀庆药业有限责任公司	he'nan'huai'qing'yao'ye'you'xian'ze'ren'gong'si	0
河南金泰医疗器械有限公司	he'nan'jin'tai'yi'liao'qi'xie'you'xian'gong'si	0
河南九势制药股份有限公司	he'nan'jiu'shi'zhi'yao'gu'fen'you'xian'gong'si	0
河南科伦药业有限公司	he'nan'ke'lun'yao'ye'you'xian'gong'si	0
河南羚锐制药股份有限公司	he'nan'ling'rui'zhi'yao'gu'fen'you'xian'gong'si	0
河南明康制药有限公司	he'nan'ming'kang'zhi'yao'you'xian'gong'si	0
河南普瑞制药有限公司	he'nan'pu'rui'zhi'yao'you'xian'gong'si	0
河南润弘制药股份有限公司	he'nan'run'hong'zhi'yao'gu'fen'you'xian'gong'si	0
河南省白泉制药有限公司	he'nan'sheng'bai'quan'zhi'yao'you'xian'gong'si	0
河南省百泉制药有限公司	he'nan'sheng'bai'quan'zhi'yao'you'xian'gong'si	0
河南圣光集团三思药业有限公司	he'nan'sheng'guang'ji'tuan'san'si'yao'ye'you'xian'gong'si	0
河南省康华怀庆药业有限公司	he'nan'sheng'kang'hua'huai'qing'yao'ye'you'xian'gong'si	0
河南省宛西制药股份有限公司	he'nan'sheng'wan'xi'zhi'yao'gu'fen'you'xian'gong'si	0
河南天地药业股份有限公司	he'nan'tian'di'yao'ye'gu'fen'you'xian'gong'si	0
河南天方华中药业有限公司	he'nan'tian'fang'hua'zhong'yao'ye'you'xian'gong'si	0
河南天方药业股份有限公司	he'nan'tian'fang'yao'ye'gu'fen'you'xian'gong'si	0
河南同源制药有限公司	he'nan'tong'yuan'zhi'yao'you'xian'gong'si	0
河南禹州市药王制药有限公司	he'nan'yu'zhou'shi'yao'wang'zhi'yao'you'xian'gong'si	0
和血明目片	he'xue'ming'mu'pian	0
菏泽三木卫生材料有限公司出品	he'ze'san'mu'wei'sheng'cai'liao'you'xian'gong'si'chu'pin	0
黑龙江百泰药业有限公司	hei'long'jiang'bai'tai'yao'ye'you'xian'gong'si	0
黑龙江恒鼎升药业有限公司	hei'long'jiang'heng'ding'sheng'yao'ye'you'xian'gong'si	0
黑龙江科伦制药有限公司	hei'long'jiang'ke'lun'zhi'yao'you'xian'gong'si	0
黑龙江葵花药业股份有限公司	hei'long'jiang'kui'hua'yao'ye'gu'fen'you'xian'gong'si	0
黑龙江龙桂制药有限公司	hei'long'jiang'long'gui'zhi'yao'you'xian'gong'si	0
黑龙江全鸡药业有限公司	hei'long'jiang'quan'ji'yao'ye'you'xian'gong'si	0
黑龙江仁合堂药业有限责任公司	hei'long'jiang'ren'he'tang'yao'ye'you'xian'ze'ren'gong'si	0
黑龙江省格润药业有限责任公司	hei'long'jiang'sheng'ge'run'yao'ye'you'xian'ze'ren'gong'si	0
黑龙江省济仁药业有限公司	hei'long'jiang'sheng'ji'ren'yao'ye'you'xian'gong'si	0
黑龙江省中医研究院制药	hei'long'jiang'sheng'zhong'yi'yan'jiu'yuan'zhi'yao	0
黑龙江天宏药业股份有限公司	hei'long'jiang'tian'hong'yao'ye'gu'fen'you'xian'gong'si	0
黑龙江天翼药业有限公司	hei'long'jiang'tian'yi'yao'ye'you'xian'gong'si	0
黑龙江铁力	hei'long'jiang'tie'li	0
黑龙江珍宝岛药业股份有限公司	hei'long'jiang'zhen'bao'dao'yao'ye'gu'fen'you'xian'gong'si	0
黑龙江中桂制药有限公司	hei'long'jiang'zhong'gui'zhi'yao'you'xian'gong'si	0
衡水康王医疗器械厂	heng'shui'kang'wang'yi'liao'qi'xie'chang	0
红草止鼾胶囊	hong'cao'zhi'han'jiao'nang	0
红核妇洁洗液	hong'he'fu'jie'xi'ye	0
红花注射液	hong'hua'zhu'she'ye	0
鸿基银盾	hong'ji'yin'dun	0
红金消结片	hong'jin'xiao'jie'pian	0
红霉素肠溶片	hong'mei'su'chang'rong'pian	0
红霉素软膏	hong'mei'su'ruan'gao	0
红霉素眼膏	hong'mei'su'yan'gao	0
红药片	hong'yao'pian	0
红药贴膏	hong'yao'tie'gao	0
喉疾灵片	hou'ji'ling'pian	0
喉痛灵片	hou'tong'ling'pian	0
猴头健胃灵胶囊	hou'tou'jian'wei'ling'jiao'nang	0
猴头菌片	hou'tou'jun'pian	0
湖北安联药业有限公司	hu'bei'an'lian'yao'ye'you'xian'gong'si	0
湖北东信药业有限公司	hu'bei'dong'xin'yao'ye'you'xian'gong'si	0
湖北福广制药有限公司	hu'bei'fu'guang'zhi'yao'you'xian'gong'si	0
湖北福人金身药业有限公司	hu'bei'fu'ren'jin'shen'yao'ye'you'xian'gong'si	0
湖北广仁药业有限公司	hu'bei'guang'ren'yao'ye'you'xian'gong'si	0
湖北荷普药业股份有限公司	hu'bei'he'pu'yao'ye'gu'fen'you'xian'gong'si	0
湖北宏远药业有限公司	hu'bei'hong'yuan'yao'ye'you'xian'gong'si	0
湖北济安堂药业有限公司	hu'bei'ji'an'tang'yao'ye'you'xian'gong'si	0
湖北康源药业有限公司	hu'bei'kang'yuan'yao'ye'you'xian'gong'si	0
湖北科益药业股份有限公司	hu'bei'ke'yi'yao'ye'gu'fen'you'xian'gong'si	0
湖北美宝药业有限公司	hu'bei'mei'bao'yao'ye'you'xian'gong'si	0
湖北南洋药业有限公司	hu'bei'nan'yang'yao'ye'you'xian'gong'si	0
湖北潜江制药股份有限公司	hu'bei'qian'jiang'zhi'yao'gu'fen'you'xian'gong'si	0
湖北人福成田药业有限公司	hu'bei'ren'fu'cheng'tian'yao'ye'you'xian'gong'si	0
湖北仁悦药业有限公司	hu'bei'ren'yue'yao'ye'you'xian'gong'si	0
湖北瑞华制药有限责任公司	hu'bei'rui'hua'zhi'yao'you'xian'ze'ren'gong'si	0
湖北省益康制药厂	hu'bei'sheng'yi'kang'zhi'yao'chang	0
湖北天龙制药有限公司	hu'bei'tian'long'zhi'yao'you'xian'gong'si	0
湖北威士生物药业有限公司	hu'bei'wei'shi'sheng'wu'yao'ye'you'xian'gong'si	0
湖北武当金鼎制药有限公司	hu'bei'wu'dang'jin'ding'zhi'yao'you'xian'gong'si	0
湖北襄阳隆中药业集团有限公司	hu'bei'xiang'yang'long'zhong'yao'ye'ji'tuan'you'xian'gong'si	0
湖北远大天天明制药有限公司	hu'bei'yuan'da'tian'tian'ming'zhi'yao'you'xian'gong'si	0
湖北中佳药业有限公司	hu'bei'zhong'jia'yao'ye'you'xian'gong'si	0
护肝片	hu'gan'pian	0
葫芦岛国帝药业有限责任公司	hu'lu'dao'guo'di'yao'ye'you'xian'ze'ren'gong'si	0
呼伦贝尔松鹿制药有限公司	hu'lun'bei'er'song'lu'zhi'yao'you'xian'gong'si	0
虎梅含片	hu'mei'han'pian	0
湖南方盛制药股份有限公司	hu'nan'fang'sheng'zhi'yao'gu'fen'you'xian'gong'si	0
湖南汉森制药股份有限公司	hu'nan'han'sen'zhi'yao'gu'fen'you'xian'gong'si	0
湖南恒生制药股份有限公司	hu'nan'heng'sheng'zhi'yao'gu'fen'you'xian'gong'si	0
湖南科伦制药有限公司	hu'nan'ke'lun'zhi'yao'you'xian'gong'si	0
湖南明瑞制药有限公司	hu'nan'ming'rui'zhi'yao'you'xian'gong'si	0
湖南千金湘江药业股份有限公司	hu'nan'qian'jin'xiang'jiang'yao'ye'gu'fen'you'xian'gong'si	0
湖南五洲通药业有限责任公司	hu'nan'wu'zhou'tong'yao'ye'you'xian'ze'ren'gong'si	0
湖南湘泉药业股份有限公司	hu'nan'xiang'quan'yao'ye'gu'fen'you'xian'gong'si	0
湖南新汇制药有限公司	hu'nan'xin'hui'zhi'yao'you'xian'gong'si	0
琥珀安神丸	hu'po'an'shen'wan	0
琥珀抱龙丸	hu'po'bao'long'wan	0
琥珀酸美托洛尔缓释片	hu'po'suan'mei'tuo'luo'er'huan'shi'pian	0
琥乙红霉素颗粒	hu'yi'hong'mei'su'ke'li	0
琥乙红霉素片	hu'yi'hong'mei'su'pian	0
化毒丸	hua'du'wan	0
花红片	hua'hong'pian	0
滑膜炎颗粒	hua'mo'yan'ke'li	0
滑膜炎片	hua'mo'yan'pian	0
滑膜炎贴	hua'mo'yan'tie	0
华润三九医药股份有限公司	hua'run'san'jiu'yi'yao'gu'fen'you'xian'gong'si	0
华润双鹤药业股份有限公司	hua'run'shuang'he'yao'ye'gu'fen'you'xian'gong'si	0
化痰平喘片	hua'tan'ping'chuan'pian	0
化痰消咳片	hua'tan'xiao'ke'pian	0
华佗再造丸	hua'tuo'zai'zao'wan	0
华阳恩施药业有限公司	hua'yang'en'shi'yao'ye'you'xian'gong'si	0
华中药业股份有限公司	hua'zhong'yao'ye'gu'fen'you'xian'gong'si	0
槐角丸	huai'jiao'wan	0
淮南佳盟药业有限公司	huai'nan'jia'meng'yao'ye'you'xian'gong'si	0
黄豆苷元片	huang'dou'gan'yuan'pian	0
黄葵胶囊	huang'kui'jiao'nang	0
黄连上清片	huang'lian'shang'qing'pian	0
黄连上清丸	huang'lian'shang'qing'wan	0
黄连羊肝丸	huang'lian'yang'gan'wan	0
黄龙止咳颗粒	huang'long'zhi'ke'ke'li	0
黄芪红景大铬酵母	huang'qi'hong'jing'da'ge'jiao'mu	0
黄芪精	huang'qi'jing	0
黄芪注射液	huang'qi'zhu'she'ye	0
黄山市天目药业有限公司	huang'shan'shi'tian'mu'yao'ye'you'xian'gong'si	0
黄石三九药业有限公司	huang'shi'san'jiu'yao'ye'you'xian'gong'si	0
黄氏响声丸	huang'shi'xiang'sheng'wan	0
黄藤素片	huang'teng'su'pian	0
黄体酮注射液	huang'ti'tong'zhu'she'ye	0
回春花牌减肥茶	hui'chun'hua'pai'jian'fei'cha	0
灰黄霉素片	hui'huang'mei'su'pian	0
辉瑞制药有限公司	hui'rui'zhi'yao'you'xian'gong'si	0
茴三硫片	hui'san'liu'pian	0
惠氏制药有限公司	hui'shi'zhi'yao'you'xian'gong'si	0
回音必集团安徽制药有限公司	hui'yin'bi'ji'tuan'an'hui'zhi'yao'you'xian'gong'si	0
混合重组人胰岛素注射液	hun'he'chong'zu'ren'yi'dao'su'zhu'she'ye	0
活络消痛片	huo'luo'xiao'tong'pian	0
藿香清胃片	huo'xiang'qing'wei'pian	0
藿香祛暑软胶囊	huo'xiang'qu'shu'ruan'jiao'nang	0
藿香正气片	huo'xiang'zheng'qi'pian	0
藿香正气软胶囊	huo'xiang'zheng'qi'ruan'jiao'nang	0
藿香正气水	huo'xiang'zheng'qi'shui	0
活血通脉片	huo'xue'tong'mai'pian	0
活血应痛丸	huo'xue'ying'tong'wan	0
肌氨肽苷注射液	ji'an'tai'gan'zhu'she'ye	0
肌苷片	ji'gan'pian	0
肌苷注射液	ji'gan'zhu'she'ye	0
鸡骨草胶囊	ji'gu'cao'jiao'nang	0
吉林敖东洮南药业股份有限公司	ji'lin'ao'dong'tao'nan'yao'ye'gu'fen'you'xian'gong'si	0
吉林敖东延边药业股份有限公司	ji'lin'ao'dong'yan'bian'yao'ye'gu'fen'you'xian'gong'si	0
吉林百琦药业有限公司	ji'lin'bai'qi'yao'ye'you'xian'gong'si	0
吉林白山正茂药业股份有限公司	ji'lin'bai'shan'zheng'mao'yao'ye'gu'fen'you'xian'gong'si	0
吉林草还丹药业有限公司	ji'lin'cao'huan'dan'yao'ye'you'xian'gong'si	0
吉林国药制药有限责任公司	ji'lin'guo'yao'zhi'yao'you'xian'ze'ren'gong'si	0
吉林华康药业股份有限公司	ji'lin'hua'kang'yao'ye'gu'fen'you'xian'gong'si	0
吉林黄栀花药业有限公司	ji'lin'huang'zhi'hua'yao'ye'you'xian'gong'si	0
吉林康乃尔药业有限公司	ji'lin'kang'nai'er'yao'ye'you'xian'gong'si	0
吉林龙泰制药股份有限公司	ji'lin'long'tai'zhi'yao'gu'fen'you'xian'gong'si	0
吉林隆泰制药集团有限责任公司	ji'lin'long'tai'zhi'yao'ji'tuan'you'xian'ze'ren'gong'si	0
吉林龙鑫药业有限公司	ji'lin'long'xin'yao'ye'you'xian'gong'si	0
吉林省百年六福堂药业有限公司	ji'lin'sheng'bai'nian'liu'fu'tang'yao'ye'you'xian'gong'si	0
吉林省白山市浑江区板石街号	ji'lin'sheng'bai'shan'shi'hun'jiang'qu'ban'shi'jie'hao	0
吉林省博维药业有限公司	ji'lin'sheng'bo'wei'yao'ye'you'xian'gong'si	0
吉林省长源药业有限公司	ji'lin'sheng'chang'yuan'yao'ye'you'xian'gong'si	0
吉林省长中制药有限公司	ji'lin'sheng'chang'zhong'zhi'yao'you'xian'gong'si	0
吉林省大峻药业股份有限公司	ji'lin'sheng'da'jun'yao'ye'gu'fen'you'xian'gong'si	0
吉林省东丰药业股份有限公司	ji'lin'sheng'dong'feng'yao'ye'gu'fen'you'xian'gong'si	0
吉林省东颐生物科技有限公司	ji'lin'sheng'dong'yi'sheng'wu'ke'ji'you'xian'gong'si	0
吉林省都邦药业股份有限公司	ji'lin'sheng'du'bang'yao'ye'gu'fen'you'xian'gong'si	0
吉林省抚松制药股份有限公司	ji'lin'sheng'fu'song'zhi'yao'gu'fen'you'xian'gong'si	0
吉林省国文药业有限公司	ji'lin'sheng'guo'wen'yao'ye'you'xian'gong'si	0
吉林省红石药业有限公司	ji'lin'sheng'hong'shi'yao'ye'you'xian'gong'si	0
吉林省宏威生物科技有限公司	ji'lin'sheng'hong'wei'sheng'wu'ke'ji'you'xian'gong'si	0
吉林省华港制药有限公司	ji'lin'sheng'hua'gang'zhi'yao'you'xian'gong'si	0
吉林省华侨药业有限公司	ji'lin'sheng'hua'qiao'yao'ye'you'xian'gong'si	0
吉林省华威药业有限公司	ji'lin'sheng'hua'wei'yao'ye'you'xian'gong'si	0
吉林省九阳药业有限公司	ji'lin'sheng'jiu'yang'yao'ye'you'xian'gong'si	0
吉林省俊宏药业有限公司	ji'lin'sheng'jun'hong'yao'ye'you'xian'gong'si	0
吉林省康福药业有限公司	ji'lin'sheng'kang'fu'yao'ye'you'xian'gong'si	0
吉林省利华制药有限公司	ji'lin'sheng'li'hua'zhi'yao'you'xian'gong'si	0
吉林省力胜制药有限公司	ji'lin'sheng'li'sheng'zhi'yao'you'xian'gong'si	0
吉林省七星山药业有限公司	ji'lin'sheng'qi'xing'shan'yao'ye'you'xian'gong'si	0
吉林省天光药业有限公司	ji'lin'sheng'tian'guang'yao'ye'you'xian'gong'si	0
吉林省吴太感康药业有限公司	ji'lin'sheng'wu'tai'gan'kang'yao'ye'you'xian'gong'si	0
吉林省鑫辉药业有限公司	ji'lin'sheng'xin'hui'yao'ye'you'xian'gong'si	0
吉林省银河制药有限公司	ji'lin'sheng'yin'he'zhi'yao'you'xian'gong'si	0
吉林省正辉煌药业有限公司	ji'lin'sheng'zheng'hui'huang'yao'ye'you'xian'gong'si	0
吉林省中鼎药业有限公司	ji'lin'sheng'zhong'ding'yao'ye'you'xian'gong'si	0
吉林省中研药业有限公司	ji'lin'sheng'zhong'yan'yao'ye'you'xian'gong'si	0
吉林市鹿王制药股份有限公司	ji'lin'shi'lu'wang'zhi'yao'gu'fen'you'xian'gong'si	0
吉林市天池	ji'lin'shi'tian'chi	0
吉林特研药业有限公司	ji'lin'te'yan'yao'ye'you'xian'gong'si	0
吉林天药本草制药有限公司	ji'lin'tian'yao'ben'cao'zhi'yao'you'xian'gong'si	0
吉林万通药业有限公司	ji'lin'wan'tong'yao'ye'you'xian'gong'si	0
吉林显锋科技制药有限公司	ji'lin'xian'feng'ke'ji'zhi'yao'you'xian'gong'si	0
吉林修正修元生物科技有限公司	ji'lin'xiu'zheng'xiu'yuan'sheng'wu'ke'ji'you'xian'gong'si	0
吉林亚泰明星制药有限公司	ji'lin'ya'tai'ming'xing'zhi'yao'you'xian'gong'si	0
吉林延边朝药药业有限公司	ji'lin'yan'bian'chao'yao'yao'ye'you'xian'gong'si	0
吉林益民堂制药有限公司	ji'lin'yi'min'tang'zhi'yao'you'xian'gong'si	0
吉林银诺克药业有限公司	ji'lin'yin'nuo'ke'yao'ye'you'xian'gong'si	0
吉林永利药业股份有限公司	ji'lin'yong'li'yao'ye'gu'fen'you'xian'gong'si	0
吉林玉仁制药股份有限公司	ji'lin'yu'ren'zhi'yao'gu'fen'you'xian'gong'si	0
吉林真元制药有限公司	ji'lin'zhen'yuan'zhi'yao'you'xian'gong'si	0
吉林制药股份有限公司	ji'lin'zhi'yao'gu'fen'you'xian'gong'si	0
吉林紫鑫药业股份有限公司	ji'lin'zi'xin'yao'ye'gu'fen'you'xian'gong'si	0
济南利民制药有限责任公司	ji'nan'li'min'zhi'yao'you'xian'ze'ren'gong'si	0
集尿杯	ji'niao'bei	0
济生肾气丸	ji'sheng'shen'qi'wan	0
吉他霉素片	ji'ta'mei'su'pian	0
急支颗粒	ji'zhi'ke'li	0
甲钴胺片	jia'gu'an'pian	0
甲磺酸酚妥拉明片	jia'huang'suan'fen'tuo'la'ming'pian	0
甲磺酸帕珠沙星氯化钠注射液	jia'huang'suan'pa'zhu'sha'xing'lv'hua'na'zhu'she'ye	0
甲巯咪唑片	jia'qiu'mi'zuo'pian	0
佳蓉丸	jia'rong'wan	0
加替沙星氯化钠注射液	jia'ti'sha'xing'lv'hua'na'zhu'she'ye	0
加味藿香正气丸	jia'wei'huo'xiang'zheng'qi'wan	0
加味消遥丸	jia'wei'xiao'yao'wan	0
加味逍遥丸	jia'wei'xiao'yao'wan	0
甲硝唑芬布芬胶囊	jia'xiao'zuo'fen'bu'fen'jiao'nang	0
甲硝唑口颊片	jia'xiao'zuo'kou'jia'pian	0
甲硝唑氯化钠注射液	jia'xiao'zuo'lv'hua'na'zhu'she'ye	0
甲硝唑片	jia'xiao'zuo'pian	0
甲硝唑阴道泡腾片	jia'xiao'zuo'yin'dao'pao'teng'pian	0
甲氧氯普氨片	jia'yang'lv'pu'an'pian	0
甲氧氯普胺片	jia'yang'lv'pu'an'pian	0
甲状腺片	jia'zhuang'xian'pian	0
健儿清解液	jian'er'qing'jie'ye	0
健儿消食口服液	jian'er'xiao'shi'kou'fu'ye	0
减肥胶囊	jian'fei'jiao'nang	0
健民咽喉片	jian'min'yan'hou'pian	0
健脑胶囊	jian'nao'jiao'nang	0
健生堂肠清茶	jian'sheng'tang'chang'qing'cha	0
健胃消食片	jian'wei'xiao'shi'pian	0
健胃消炎颗粒	jian'wei'xiao'yan'ke'li	0
健胃止痛片	jian'wei'zhi'tong'pian	0
肩周炎贴	jian'zhou'yan'tie	0
降酶灵胶囊	jiang'mei'ling'jiao'nang	0
江苏晨牌药业集团股份有限公司	jiang'su'chen'pai'yao'ye'ji'tuan'gu'fen'you'xian'gong'si	0
江苏方强制药厂有限责任公司	jiang'su'fang'qiang'zhi'yao'chang'you'xian'ze'ren'gong'si	0
江苏豪森药业股份有限公司	jiang'su'hao'sen'yao'ye'gu'fen'you'xian'gong'si	0
江苏康缘药业股份有限公司	jiang'su'kang'yuan'yao'ye'gu'fen'you'xian'gong'si	0
江苏克胜药业有限公司	jiang'su'ke'sheng'yao'ye'you'xian'gong'si	0
江苏联环药业股份有限公司	jiang'su'lian'huan'yao'ye'gu'fen'you'xian'gong'si	0
江苏涟水制药有限公司	jiang'su'lian'shui'zhi'yao'you'xian'gong'si	0
江苏平光制药有限责任公司	jiang'su'ping'guang'zhi'yao'you'xian'ze'ren'gong'si	0
江苏七零七天然制药有限公司	jiang'su'qi'ling'qi'tian'ran'zhi'yao'you'xian'gong'si	0
江苏神龙药业有限公司	jiang'su'shen'long'yao'ye'you'xian'gong'si	0
江苏省华星医疗器械有限公司	jiang'su'sheng'hua'xing'yi'liao'qi'xie'you'xian'gong'si	0
江苏苏南药业实业有限公司	jiang'su'su'nan'yao'ye'shi'ye'you'xian'gong'si	0
江苏苏中药业集团股份有限公司	jiang'su'su'zhong'yao'ye'ji'tuan'gu'fen'you'xian'gong'si	0
江苏祥瑞药业有限公司	jiang'su'xiang'rui'yao'ye'you'xian'gong'si	0
江苏新海康制药有限公司	jiang'su'xin'hai'kang'zhi'yao'you'xian'gong'si	0
江苏亚邦爱普森药业有限公司	jiang'su'ya'bang'ai'pu'sen'yao'ye'you'xian'gong'si	0
江苏颐海药业有限责任公司	jiang'su'yi'hai'yao'ye'you'xian'ze'ren'gong'si	0
江苏云阳集团药业有限公司	jiang'su'yun'yang'ji'tuan'yao'ye'you'xian'gong'si	0
江苏中兴药业有限公司	jiang'su'zhong'xing'yao'ye'you'xian'gong'si	0
降糖宁胶囊	jiang'tang'ning'jiao'nang	0
江西昂泰制药有限公司	jiang'xi'ang'tai'zhi'yao'you'xian'gong'si	0
江西草珊瑚药业有限公司	jiang'xi'cao'shan'hu'yao'ye'you'xian'gong'si	0
江西诚志永丰药业有限责任公司	jiang'xi'cheng'zhi'yong'feng'yao'ye'you'xian'ze'ren'gong'si	0
江西大自然制药有限公司	jiang'xi'da'zi'ran'zhi'yao'you'xian'gong'si	0
江西德成制药有限公司	jiang'xi'de'cheng'zhi'yao'you'xian'gong'si	0
江西盖天灵药业有限公司	jiang'xi'gai'tian'ling'yao'ye'you'xian'gong'si	0
江西广信药业有限公司	jiang'xi'guang'xin'yao'ye'you'xian'gong'si	0
江西汇仁药业有限公司	jiang'xi'hui'ren'yao'ye'you'xian'gong'si	0
江西京通美联药业有限公司	jiang'xi'jing'tong'mei'lian'yao'ye'you'xian'gong'si	0
江西九华药业有限公司	jiang'xi'jiu'hua'yao'ye'you'xian'gong'si	0
江西聚仁药业有限公司	jiang'xi'ju'ren'yao'ye'you'xian'gong'si	0
江西桔王药业有限公司	jiang'xi'ju'wang'yao'ye'you'xian'gong'si	0
江西康宝医药生物科技有限公司	jiang'xi'kang'bao'yi'yao'sheng'wu'ke'ji'you'xian'gong'si	0
江西康美医药保健品有限公司	jiang'xi'kang'mei'yi'yao'bao'jian'pin'you'xian'gong'si	0
江西康约生物科技有限公司	jiang'xi'kang'yue'sheng'wu'ke'ji'you'xian'gong'si	0
江西科伦药业有限公司	jiang'xi'ke'lun'yao'ye'you'xian'gong'si	0
江西科伦医疗器械有限公司	jiang'xi'ke'lun'yi'liao'qi'xie'you'xian'gong'si	0
江西乐满堂保健有限公司	jiang'xi'le'man'tang'bao'jian'you'xian'gong'si	0
江西民济药业有限公司	jiang'xi'min'ji'yao'ye'you'xian'gong'si	0
江西南昌桑海制药厂	jiang'xi'nan'chang'sang'hai'zhi'yao'chang	0
江西盛翔制药有限公司	jiang'xi'sheng'xiang'zhi'yao'you'xian'gong'si	0
江西天施康中药股份有限公司	jiang'xi'tian'shi'kang'zhong'yao'gu'fen'you'xian'gong'si	0
江西铜鼓仁和制药有限公司	jiang'xi'tong'gu'ren'he'zhi'yao'you'xian'gong'si	0
江西汪氏药业有限公司	jiang'xi'wang'shi'yao'ye'you'xian'gong'si	0
江西心诚药业有限公司	jiang'xi'xin'cheng'yao'ye'you'xian'gong'si	0
江西杏林白马药业有限公司	jiang'xi'xing'lin'bai'ma'yao'ye'you'xian'gong'si	0
江西益佰年药业股份有限公司	jiang'xi'yi'bai'nian'yao'ye'gu'fen'you'xian'gong'si	0
江西一品堂生物科技有限公司	jiang'xi'yi'pin'tang'sheng'wu'ke'ji'you'xian'gong'si	0
江西银涛药业有限公司	jiang'xi'yin'tao'yao'ye'you'xian'gong'si	0
江西禹欣药业有限公司	jiang'xi'yu'xin'yao'ye'you'xian'gong'si	0
江西樟树市庆人保健品有限公司	jiang'xi'zhang'shu'shi'qing'ren'bao'jian'pin'you'xian'gong'si	0
江西珍视明药业有限公司	jiang'xi'zhen'shi'ming'yao'ye'you'xian'gong'si	0
江西制药有限责任公司	jiang'xi'zhi'yao'you'xian'ze'ren'gong'si	0
江西众心堂制药有限公司	jiang'xi'zhong'xin'tang'zhi'yao'you'xian'gong'si	0
降脂灵片	jiang'zhi'ling'pian	0
降脂宁颗粒	jiang'zhi'ning'ke'li	0
降脂宁片	jiang'zhi'ning'pian	0
降脂排毒胶囊	jiang'zhi'pai'du'jiao'nang	0
降脂通便胶囊	jiang'zhi'tong'bian'jiao'nang	0
江中药业股份有限公司	jiang'zhong'yao'ye'gu'fen'you'xian'gong'si	0
绞股蓝总甙片	jiao'gu'lan'zong'dai'pian	0
脚气克星	jiao'qi'ke'xing	0
交沙霉素片	jiao'sha'mei'su'pian	0
胶体果胶铋胶囊	jiao'ti'guo'jiao'bi'jiao'nang	0
胶原蛋白软胶囊	jiao'yuan'dan'bai'ruan'jiao'nang	0
胶原蛋白原液面膜	jiao'yuan'dan'bai'yuan'ye'mian'mo	0
洁尔阴草本抑菌洗液	jie'er'yin'cao'ben'yi'jun'xi'ye	0
洁尔阴洗液	jie'er'yin'xi'ye	0
桔梗冬花片	jie'geng'dong'hua'pian	0
接骨丸	jie'gu'wan	0
接骨续筋片	jie'gu'xu'jin'pian	0
解心痛胶囊	jie'xin'tong'jiao'nang	0
解郁安神颗粒	jie'yu'an'shen'ke'li	0
金奥力牌羊胎软胶囊	jin'ao'li'pai'yang'tai'ruan'jiao'nang	0
金贝痰咳清颗粒	jin'bei'tan'ke'qing'ke'li	0
金胆片	jin'dan'pian	0
金感胶囊	jin'gan'jiao'nang	0
金刚藤软胶囊	jin'gang'teng'ruan'jiao'nang	0
筋骨活络王	jin'gu'huo'luo'wang	0
金鸡胶囊	jin'ji'jiao'nang	0
金匮肾气丸	jin'kui'shen'qi'wan	0
金荞麦片	jin'qiao'mai'pian	0
金嗓子喉片	jin'sang'zi'hou'pian	0
金水宝胶囊	jin'shui'bao'jiao'nang	0
金银花含片	jin'yin'hua'han'pian	0
金银花颗粒	jin'yin'hua'ke'li	0
锦州本天药业有限公司	jin'zhou'ben'tian'yao'ye'you'xian'gong'si	0
锦州汉宝药业有限公司	jin'zhou'han'bao'yao'ye'you'xian'gong'si	0
颈部牵引固定器	jing'bu'qian'yin'gu'ding'qi	0
京都念慈菴蜜炼川贝枇杷膏	jing'du'nian'ci'an'mi'lian'chuan'bei'pi'pa'gao	0
颈复康颗粒	jing'fu'kang'ke'li	0
荆肤止痒颗粒	jing'fu'zhi'yang'ke'li	0
精华制药集团股份有限公司	jing'hua'zhi'yao'ji'tuan'gu'fen'you'xian'gong'si	0
颈康胶囊	jing'kang'jiao'nang	0
精品肤专家软膏	jing'pin'fu'zhuan'jia'ruan'gao	0
颈痛灵药酒	jing'tong'ling'yao'jiu	0
京万红软膏	jing'wan'hong'ruan'gao	0
京万红痔疮膏	jing'wan'hong'zhi'chuang'gao	0
颈腰按摩师	jing'yao'an'mo'shi	0
颈腰康胶囊	jing'yao'kang'jiao'nang	0
颈腰康贴	jing'yao'kang'tie	0
精制狗皮膏	jing'zhi'gou'pi'gao	0
精致银翘解毒片	jing'zhi'yin'qiao'jie'du'pian	0
景忠山国药唐山有限公司	jing'zhong'shan'guo'yao'tang'shan'you'xian'gong'si	0
荆州市津奉药业发展有限公司	jing'zhou'shi'jin'feng'yao'ye'fa'zhan'you'xian'gong'si	0
颈椎病贴	jing'zhui'bing'tie	0
九哥姜葛压片糖果	jiu'ge'jiang'ge'ya'pian'tang'guo	0
九合维生素丸	jiu'he'wei'sheng'su'wan	0
酒精	jiu'jing	0
久强脑立清	jiu'qiang'nao'li'qing	0
酒石酸罗格列酮胶囊	jiu'shi'suan'luo'ge'lie'tong'jiao'nang	0
酒石酸美托洛尔片	jiu'shi'suan'mei'tuo'luo'er'pian	0
九味獐牙菜丸	jiu'wei'zhang'ya'cai'wan	0
九芝堂股份有限公司	jiu'zhi'tang'gu'fen'you'xian'gong'si	0
橘红颗粒	ju'hong'ke'li	0
桔红丸	ju'hong'wan	0
橘红丸	ju'hong'wan	0
聚协昌北京药业有限公司	ju'xie'chang'bei'jing'yao'ye'you'xian'gong'si	0
枸橼酸铋钾颗粒	ju'yuan'suan'bi'jia'ke'li	0
枸橼酸铋钾片	ju'yuan'suan'bi'jia'pian	0
枸橼酸钾颗粒	ju'yuan'suan'jia'ke'li	0
枸橼酸喷托维林片	ju'yuan'suan'pen'tuo'wei'lin'pian	0
桔远止咳片	ju'yuan'zhi'ke'pian	0
龟裂护肤膏	jun'lie'hu'fu'gao	0
卡马西平片	ka'ma'xi'ping'pian	0
卡托普利片	ka'tuo'pu'li'pian	0
开封制药集团有限公司	kai'feng'zhi'yao'ji'tuan'you'xian'gong'si	0
开塞露	kai'sai'lu	0
开胸顺气丸	kai'xiong'shun'qi'wan	0
开胸消食片	kai'xiong'xiao'shi'pian	0
开郁舒肝丸	kai'yu'shu'gan'wan	0
坎地沙坦酯片	kan'di'sha'tan'zhi'pian	0
抗病毒口服液	kang'bing'du'kou'fu'ye	0
康富丽牌大豆卵磷脂软胶囊	kang'fu'li'pai'da'dou'luan'lin'zhi'ruan'jiao'nang	0
康富丽牌鱼油软胶囊	kang'fu'li'pai'yu'you'ruan'jiao'nang	0
康妇消炎栓	kang'fu'xiao'yan'shuan	0
康复新液	kang'fu'xin'ye	0
康妇炎胶囊	kang'fu'yan'jiao'nang	0
抗感解毒口服液	kang'gan'jie'du'kou'fu'ye	0
抗宫炎片	kang'gong'yan'pian	0
抗骨增生片	kang'gu'zeng'sheng'pian	0
抗骨增生丸古岳	kang'gu'zeng'sheng'wan'gu'yue	0
康普药业股份有限公司	kang'pu'yao'ye'gu'fen'you'xian'gong'si	0
康润合正骨贴	kang'run'he'zheng'gu'tie	0
糠甾醇片	kang'zai'chun'pian	0
康祝拔罐器	kang'zhu'ba'guan'qi	0
康祝慈足浴盆	kang'zhu'ci'zu'yu'pen	0
克拉霉素胶囊	ke'la'mei'su'jiao'nang	0
克拉霉素片	ke'la'mei'su'pian	0
克痢痧胶囊	ke'li'sha'jiao'nang	0
克林霉素磷酸酯注射液	ke'lin'mei'su'lin'suan'zhi'zhu'she'ye	0
咳露口服液	ke'lu'kou'fu'ye	0
克霉唑乳膏	ke'mei'zuo'ru'gao	0
克霉唑栓	ke'mei'zuo'shuan	0
咳特灵胶囊	ke'te'ling'jiao'nang	0
口服葡萄糖	kou'fu'pu'tao'tang	0
口腔溃疡散	kou'qiang'kui'yang'san	0
口腔炎喷雾剂	kou'qiang'yan'pen'wu'ji	0
口炎胶囊	kou'yan'jiao'nang	0
苦胆草片	ku'dan'cao'pian	0
苦碟子注射液	ku'die'zi'zhu'she'ye	0
苦瓜籽粉	ku'gua'zi'fen	0
苦参片	ku'shen'pian	0
快胃舒肝丸	kuai'wei'shu'gan'wan	0
葵花药业集团重庆有限公司	kui'hua'yao'ye'ji'tuan'chong'qing'you'xian'gong'si	0
坤宝丸	kun'bao'wan	0
昆明全新生物制药有限公司	kun'ming'quan'xin'sheng'wu'zhi'yao'you'xian'gong'si	0
昆明生达制药有限公司	kun'ming'sheng'da'zhi'yao'you'xian'gong'si	0
昆明振华制药厂有限公司	kun'ming'zhen'hua'zhi'yao'chang'you'xian'gong'si	0
昆明制药集团股份有限公司	kun'ming'zhi'yao'ji'tuan'gu'fen'you'xian'gong'si	0
昆明中药厂有限公司	kun'ming'zhong'yao'chang'you'xian'gong'si	0
辣椒风湿膏	la'jiao'feng'shi'gao	0
拉西地平片	la'xi'di'ping'pian	0
来苏儿消毒液	lai'su'er'xiao'du'ye	0
蓝佳堂生物医药福建有限公司	lan'jia'tang'sheng'wu'yi'yao'fu'jian'you'xian'gong'si	0
兰索拉唑肠溶片	lan'suo'la'zuo'chang'rong'pian	0
兰索拉唑片	lan'suo'la'zuo'pian	0
阑尾消炎片	lan'wei'xiao'yan'pian	0
兰溪市拜迪尔医药用品有限公司	lan'xi'shi'bai'di'er'yi'yao'yong'pin'you'xian'gong'si	0
兰州和胜堂制药有限公司	lan'zhou'he'sheng'tang'zhi'yao'you'xian'gong'si	0
狼毒喷丫净	lang'du'pen'ya'jing	0
浪爽洁阴卫生湿巾	lang'shuang'jie'yin'wei'sheng'shi'jin	0
了哥王片	le'ge'wang'pian	0
乐力复合氨基酸螯合胶囊	le'li'fu'he'an'ji'suan'ao'he'jiao'nang	0
雷贝拉唑肠溶胶囊	lei'bei'la'zuo'chang'rong'jiao'nang	0
雷贝拉唑钠肠溶片	lei'bei'la'zuo'na'chang'rong'pian	0
雷允上药业有限公司	lei'yun'shang'yao'ye'you'xian'gong'si	0
利巴韦林颗粒	li'ba'wei'lin'ke'li	0
利巴韦林口服溶液	li'ba'wei'lin'kou'fu'rong'ye	0
利巴韦林喷雾剂	li'ba'wei'lin'pen'wu'ji	0
利巴韦林注射液	li'ba'wei'lin'zhu'she'ye	0
利鼻片	li'bi'pian	0
利胆排石片	li'dan'pai'shi'pian	0
利肺片	li'fei'pian	0
利福平胶囊	li'fu'ping'jiao'nang	0
利膈丸	li'ge'wan	0
力克	li'ke	0
理气舒心片	li'qi'shu'xin'pian	0
利心丸	li'xin'wan	0
利咽灵片	li'yan'ling'pian	0
丽珠集团丽珠制药厂	li'zhu'ji'tuan'li'zhu'zhi'yao'chang	0
连花清瘟胶囊	lian'hua'qing'wen'jiao'nang	0
联磺甲氧卞啶片	lian'huang'jia'yang'bian'ding'pian	0
联磺甲氧苄啶片	lian'huang'jia'yang'bian'ding'pian	0
连蒲双清片	lian'pu'shuang'qing'pian	0
连翘败毒片	lian'qiao'bai'du'pian	0
莲芝消炎片	lian'zhi'xiao'yan'pian	0
辽宁海神联盛制药有限公司	liao'ning'hai'shen'lian'sheng'zhi'yao'you'xian'gong'si	0
辽宁华润本溪三药有限公司	liao'ning'hua'run'ben'xi'san'yao'you'xian'gong'si	0
辽宁华源天利药业有限公司	liao'ning'hua'yuan'tian'li'yao'ye'you'xian'gong'si	0
辽宁可济药业有限公司	liao'ning'ke'ji'yao'ye'you'xian'gong'si	0
辽宁力克制药有限公司	liao'ning'li'ke'zhi'yao'you'xian'gong'si	0
辽宁绿丹药业有限公司	liao'ning'lv'dan'yao'ye'you'xian'gong'si	0
辽宁民康制药有限公司	liao'ning'min'kang'zhi'yao'you'xian'gong'si	0
辽宁沈阳市铁西区	liao'ning'shen'yang'shi'tie'xi'qu	0
辽宁生物科技开发有限公司	liao'ning'sheng'wu'ke'ji'kai'fa'you'xian'gong'si	0
辽宁仙草堂药业股份有限公司	liao'ning'xian'cao'tang'yao'ye'gu'fen'you'xian'gong'si	0
辽源市百康药业有限责任公司	liao'yuan'shi'bai'kang'yao'ye'you'xian'ze'ren'gong'si	0
辽源誉隆亚东药业有限责任公司	liao'yuan'yu'long'ya'dong'yao'ye'you'xian'ze'ren'gong'si	0
林旦乳膏	lin'dan'ru'gao	0
临汾宝珠制药有限公司	lin'fen'bao'zhu'zhi'yao'you'xian'gong'si	0
林可霉素利多卡因凝胶	lin'ke'mei'su'li'duo'ka'yin'ning'jiao	0
磷霉素该片	lin'mei'su'gai'pian	0
磷酸苯丙哌林片咳快好	lin'suan'ben'bing'pai'lin'pian'ke'kuai'hao	0
磷酸川芎嗪氯化钠注射液	lin'suan'chuan'xiong'qin'lv'hua'na'zhu'she'ye	0
磷酸川芎嗪片	lin'suan'chuan'xiong'qin'pian	0
磷酸哌嗪宝塔糖	lin'suan'pai'qin'bao'ta'tang	0
林州市亚神制药有限公司	lin'zhou'shi'ya'shen'zhi'yao'you'xian'gong'si	0
凌海市爽尔佳卫生用品有限公司	ling'hai'shi'shuang'er'jia'wei'sheng'yong'pin'you'xian'gong'si	0
羚羊感冒片	ling'yang'gan'mao'pian	0
羚羊角口服液	ling'yang'jiao'kou'fu'ye	0
羚羊清肺丸	ling'yang'qing'fei'wan	0
流感丸	liu'gan'wan	0
六和维生素丸	liu'he'wei'sheng'su'wan	0
六灵丸	liu'ling'wan	0
六神丸	liu'shen'wan	0
硫酸阿米卡星注射液	liu'suan'a'mi'ka'xing'zhu'she'ye	0
硫酸阿托品注射液	liu'suan'a'tuo'pin'zhu'she'ye	0
硫酸镁注射液	liu'suan'mei'zhu'she'ye	0
硫酸庆大霉素缓释片	liu'suan'qing'da'mei'su'huan'shi'pian	0
硫酸庆大霉素颗粒	liu'suan'qing'da'mei'su'ke'li	0
硫酸庆大霉素碳酸铋胶囊	liu'suan'qing'da'mei'su'tan'suan'bi'jiao'nang	0
硫酸庆大霉素注射液	liu'suan'qing'da'mei'su'zhu'she'ye	0
硫酸氢氯吡格雷片	liu'suan'qing'lv'bi'ge'lei'pian	0
硫酸沙丁胺醇气雾剂	liu'suan'sha'ding'an'chun'qi'wu'ji	0
硫酸特布他林片	liu'suan'te'bu'ta'lin'pian	0
硫糖铝咀嚼片	liu'tang'lv'ju'jue'pian	0
六味安消胶囊	liu'wei'an'xiao'jiao'nang	0
六味地黄滴丸	liu'wei'di'huang'di'wan	0
六味地黄胶囊	liu'wei'di'huang'jiao'nang	0
六味地黄丸	liu'wei'di'huang'wan	0
六味地黄丸浓缩丸	liu'wei'di'huang'wan'nong'suo'wan	0
六味能消丸	liu'wei'neng'xiao'wan	0
六味壮骨颗粒	liu'wei'zhuang'gu'ke'li	0
癃必舒片	long'bi'shu'pian	0
龙胆碳酸氢钠片	long'dan'tan'suan'qing'na'pian	0
龙胆泻肝片	long'dan'xie'gan'pian	0
龙胆泻肝丸	long'dan'xie'gan'wan	0
龙口市双鹰医疗器械有限公司	long'kou'shi'shuang'ying'yi'liao'qi'xie'you'xian'gong'si	0
龙牡壮骨颗粒	long'mu'zhuang'gu'ke'li	0
龙生蛭胶囊	long'sheng'zhi'jiao'nang	0
龙泽熊胆胶囊	long'ze'xiong'dan'jiao'nang	0
六安华源制药有限公司	lu'an'hua'yuan'zhi'yao'you'xian'gong'si	0
芦丁片	lu'ding'pian	0
六合定中丸	lu'he'ding'zhong'wan	0
芦荟杀菌洁阴卫生巾	lu'hui'sha'jun'jie'yin'wei'sheng'jin	0
鲁南贝特制药有限公司	lu'nan'bei'te'zhi'yao'you'xian'gong'si	0
鹿胎膏	lu'tai'gao	0
鹿胎颗粒	lu'tai'ke'li	0
罗汉果含片	luo'han'guo'han'pian	0
漯河市方汇药业有限公司	luo'he'shi'fang'hui'yao'ye'you'xian'gong'si	0
罗红霉素分散片	luo'hong'mei'su'fen'san'pian	0
罗红霉素公散片	luo'hong'mei'su'gong'san'pian	0
罗红霉素缓释胶囊	luo'hong'mei'su'huan'shi'jiao'nang	0
罗红霉素胶囊	luo'hong'mei'su'jiao'nang	0
罗红霉素颗粒	luo'hong'mei'su'ke'li	0
罗红霉素片	luo'hong'mei'su'pian	0
螺内酯片	luo'nei'zhi'pian	0
洛索洛芬钠	luo'suo'luo'fen'na	0
洛索洛芬钠片	luo'suo'luo'fen'na'pian	0
洛阳君山制药有限公司	luo'yang'jun'shan'zhi'yao'you'xian'gong'si	0
洛阳康华生物制品有限公司	luo'yang'kang'hua'sheng'wu'zhi'pin'you'xian'gong'si	0
洛阳宁竹药业有限公司	luo'yang'ning'zhu'yao'ye'you'xian'gong'si	0
洛阳市沐春药业有限公司	luo'yang'shi'mu'chun'yao'ye'you'xian'gong'si	0
洛阳天生药业有限公司	luo'yang'tian'sheng'yao'ye'you'xian'gong'si	0
洛阳维尔健生物工程有限公司	luo'yang'wei'er'jian'sheng'wu'gong'cheng'you'xian'gong'si	0
氯化钾片	lv'hua'jia'pian	0
氯化钾注射液	lv'hua'jia'zhu'she'ye	0
氯化钠钙注射液	lv'hua'na'gai'zhu'she'ye	0
氯化钠注射液	lv'hua'na'zhu'she'ye	0
驴胶补血颗粒	lv'jiao'bu'xue'ke'li	0
氯雷他定胶囊	lv'lei'ta'ding'jiao'nang	0
氯雷他定片	lv'lei'ta'ding'pian	0
氯霉素滴眼液	lv'mei'su'di'yan'ye	0
氯霉素片	lv'mei'su'pian	0
绿森林牌芦荟软胶囊	lv'sen'lin'pai'lu'hui'ruan'jiao'nang	0
铝碳酸镁咀嚼片	lv'tan'suan'mei'ju'jue'pian	0
氯唑沙宗片	lv'zuo'sha'zong'pian	0
玛卡益康咀嚼片	ma'ka'yi'kang'ju'jue'pian	0
马来酸氯苯那敏片	ma'lai'suan'lv'ben'na'min'pian	0
马来酸噻吗洛尔滴眼液	ma'lai'suan'sai'ma'luo'er'di'yan'ye	0
马来酸依那普利片	ma'lai'suan'yi'na'pu'li'pian	0
麻仁软胶囊	ma'ren'ruan'jiao'nang	0
麻仁润肠丸	ma'ren'run'chang'wan	0
麻仁丸	ma'ren'wan	0
麻仁滋脾丸	ma'ren'zi'pi'wan	0
马应龙麝香痔疮膏	ma'ying'long'she'xiang'zhi'chuang'gao	0
马应龙药业集团股份有限公司	ma'ying'long'yao'ye'ji'tuan'gu'fen'you'xian'gong'si	0
麦迪霉素片	mai'di'mei'su'pian	0
麦味地黄丸	mai'wei'di'huang'wan	0
脉血康胶囊	mai'xue'kang'jiao'nang	0
芒果止咳片	mang'guo'zhi'ke'pian	0
毛冬青片	mao'dong'qing'pian	0
玫瑰美白祛黄精油皂	mei'gui'mei'bai'qu'huang'jing'you'zao	0
美国安市制药有限公司	mei'guo'an'shi'zhi'yao'you'xian'gong'si	0
美洛昔康片	mei'luo'xi'kang'pian	0
美索巴莫胶囊	mei'suo'ba'mo'jiao'nang	0
蒙脱石散	meng'tuo'shi'san	0
米格来宁	mi'ge'lai'ning	0
米格来宁片	mi'ge'lai'ning'pian	0
秘诀清凉散	mi'jue'qing'liang'san	0
免疫球蛋白粉	mian'yi'qiu'dan'bai'fen	0
免疫球蛋白抗体抗菌液	mian'yi'qiu'dan'bai'kang'ti'kang'jun'ye	0
苗族坐骨神经贴	miao'zu'zuo'gu'shen'jing'tie	0
灭菌注射用水	mie'jun'zhu'she'yong'shui	0
敏力消	min'li'xiao	0
民生药业集团有限公司	min'sheng'yao'ye'ji'tuan'you'xian'gong'si	0
明目地黄丸	ming'mu'di'huang'wan	0
明目蒺藜丸	ming'mu'ji'li'wan	0
明目上清片	ming'mu'shang'qing'pian	0
莫匹罗星软膏	mo'pi'luo'xing'ruan'gao	0
牡丹江友搏制药股份有限公司	mu'dan'jiang'you'bo'zhi'yao'gu'fen'you'xian'gong'si	0
木瓜丸	mu'gua'wan	0
牡蛎杞草压片果糖	mu'li'qi'cao'ya'pian'guo'tang	0
牡蛎碳酸钙颗粒	mu'li'tan'suan'gai'ke'li	0
木香顺气丸	mu'xiang'shun'qi'wan	0
那如三味丸	na'ru'san'wei'wan	0
萘敏维滴眼液粉润洁	nai'min'wei'di'yan'ye'fen'run'jie	0
萘哌地尔片	nai'pai'di'er'pian	0
萘普生胶囊	nai'pu'sheng'jiao'nang	0
男宝胶囊	nan'bao'jiao'nang	0
南昌川奇保健品有限公司	nan'chang'chuan'qi'bao'jian'pin'you'xian'gong'si	0
南昌弘益药业有限公司	nan'chang'hong'yi'yao'ye'you'xian'gong'si	0
南昌华益医疗器械有限公司	nan'chang'hua'yi'yi'liao'qi'xie'you'xian'gong'si	0
南昌市兴兴医疗器械有限公司	nan'chang'shi'xing'xing'yi'liao'qi'xie'you'xian'gong'si	0
南昌市意尔康医疗器械有限公司	nan'chang'shi'yi'er'kang'yi'liao'qi'xie'you'xian'gong'si	0
南昌卫材医疗器械有限公司	nan'chang'wei'cai'yi'liao'qi'xie'you'xian'gong'si	0
南京白敬宇制药有限公司	nan'jing'bai'jing'yu'zhi'yao'you'xian'gong'si	0
南京海辰药业有限公司	nan'jing'hai'chen'yao'ye'you'xian'gong'si	0
南京海鲸药业有限公司	nan'jing'hai'jing'yao'ye'you'xian'gong'si	0
南京新百药业有限公司	nan'jing'xin'bai'yao'ye'you'xian'gong'si	0
男士控油抑螨洁面乳	nan'shi'kong'you'yi'man'jie'mian'ru	0
南通市伊士生物技术有限公司	nan'tong'shi'yi'shi'sheng'wu'ji'shu'you'xian'gong'si	0
南阳利欣制药	nan'yang'li'xin'zhi'yao	0
南阳市澳福来药业有限责任公司	nan'yang'shi'ao'fu'lai'yao'ye'you'xian'ze'ren'gong'si	0
南阳市新生制药有限公司	nan'yang'shi'xin'sheng'zhi'yao'you'xian'gong'si	0
南岳生物制药有限公司	nan'yue'sheng'wu'zhi'yao'you'xian'gong'si	0
脑络通胶囊	nao'luo'tong'jiao'nang	0
脑心舒口服液	nao'xin'shu'kou'fu'ye	0
脑心通胶囊	nao'xin'tong'jiao'nang	0
脑血栓片	nao'xue'shuan'pian	0
内蒙古白医制药股份有限公司	nei'meng'gu'bai'yi'zhi'yao'gu'fen'you'xian'gong'si	0
内蒙古诚梓药业有限公司	nei'meng'gu'cheng'zi'yao'ye'you'xian'gong'si	0
内蒙古京新药业有限公司	nei'meng'gu'jing'xin'yao'ye'you'xian'gong'si	0
内蒙古科尔沁药业有限公司	nei'meng'gu'ke'er'qin'yao'ye'you'xian'gong'si	0
内蒙古蒙药股份有限公司	nei'meng'gu'meng'yao'gu'fen'you'xian'gong'si	0
内蒙古双奇药业股份有限公司	nei'meng'gu'shuang'qi'yao'ye'gu'fen'you'xian'gong'si	0
内蒙古天奇中蒙药股份有限公司	nei'meng'gu'tian'qi'zhong'meng'yao'gu'fen'you'xian'gong'si	0
内蒙古通辽制药股份有限公司	nei'meng'gu'tong'liao'zhi'yao'gu'fen'you'xian'gong'si	0
尼美舒利分散片	ni'mei'shu'li'fen'san'pian	0
尼美舒利颗粒	ni'mei'shu'li'ke'li	0
尼莫地平缓释片	ni'mo'di'ping'huan'shi'pian	0
尼莫地平片	ni'mo'di'ping'pian	0
尼群地平片	ni'qun'di'ping'pian	0
宁波市天衡制药有限公司	ning'bo'shi'tian'heng'zhi'yao'you'xian'gong'si	0
宁神补心片	ning'shen'bu'xin'pian	0
宁神灵颗粒	ning'shen'ling'ke'li	0
宁夏康亚药业有限公司	ning'xia'kang'ya'yao'ye'you'xian'gong'si	0
宁心宝胶囊	ning'xin'bao'jiao'nang	0
牛黄降压丸	niu'huang'jiang'ya'wan	0
牛黄解毒片	niu'huang'jie'du'pian	0
牛黄解毒丸	niu'huang'jie'du'wan	0
牛黄净脑片	niu'huang'jing'nao'pian	0
牛黄清肺散	niu'huang'qing'fei'san	0
牛黄清胃丸	niu'huang'qing'wei'wan	0
牛黄上清片	niu'huang'shang'qing'pian	0
牛黄上清丸	niu'huang'shang'qing'wan	0
牛磺酸滴眼液	niu'huang'suan'di'yan'ye	0
牛黄消炎片	niu'huang'xiao'yan'pian	0
纽徕佛牌蛋白质粉	niu'lai'fo'pai'dan'bai'zhi'fen	0
纽徕佛牌钙铁锌软胶囊	niu'lai'fo'pai'gai'tie'xin'ruan'jiao'nang	0
纽徕佛牌卵磷脂软胶囊	niu'lai'fo'pai'luan'lin'zhi'ruan'jiao'nang	0
纽徕佛牌鱼油软胶囊	niu'lai'fo'pai'yu'you'ruan'jiao'nang	0
纽徕佛牌鱼油软胶囊特惠装	niu'lai'fo'pai'yu'you'ruan'jiao'nang'te'hui'zhuang	0
暖宫贴	nuan'gong'tie	0
暖胃舒乐片	nuan'wei'shu'le'pian	0
诺氟沙星胶囊	nuo'fu'sha'xing'jiao'nang	0
诺氟沙星片	nuo'fu'sha'xing'pian	0
诺氟沙星葡萄糖注射液	nuo'fu'sha'xing'pu'tao'tang'zhu'she'ye	0
诺和笔	nuo'he'bi	0
诺和诺德中国制药有限公司	nuo'he'nuo'de'zhong'guo'zhi'yao'you'xian'gong'si	0
诺和针	nuo'he'zhen	0
女宝胶囊	nv'bao'jiao'nang	0
女贞玉竹胶囊	nv'zhen'yu'zhu'jiao'nang	0
欧莱雅国际集团香港有限公司	ou'lai'ya'guo'ji'ji'tuan'xiang'gang'you'xian'gong'si	0
排毒养颜片	pai'du'yang'yan'pian	0
排卵试笔	pai'luan'shi'bi	0
排卵试纸	pai'luan'shi'zhi	0
排石颗粒	pai'shi'ke'li	0
泮托拉唑钠肠溶胶囊	pan'tuo'la'zuo'na'chang'rong'jiao'nang	0
泮托拉唑钠肠溶片	pan'tuo'la'zuo'na'chang'rong'pian	0
胖大海糖	pang'da'hai'tang	0
泡脚盐老姜王	pao'jiao'yan'lao'jiang'wang	0
泡脚盐鲜玫瑰	pao'jiao'yan'xian'mei'gui	0
泡脚盐熏衣草	pao'jiao'yan'xun'yi'cao	0
蓬莱诺康药业有限公司	peng'lai'nuo'kang'yao'ye'you'xian'gong'si	0
皮肤病血毒丸	pi'fu'bing'xue'du'wan	0
脾胃舒丸	pi'wei'shu'wan	0
偏瘫复原丸	pian'tan'fu'yuan'wan	0
蒲地蓝消炎片	pu'di'lan'xiao'yan'pian	0
普伐他汀钠胶囊	pu'fa'ta'ting'na'jiao'nang	0
蒲公英颗粒	pu'gong'ying'ke'li	0
普乐安胶囊	pu'le'an'jiao'nang	0
普乐安片	pu'le'an'pian	0
葡萄糖酸钙口服溶液	pu'tao'tang'suan'gai'kou'fu'rong'ye	0
葡萄糖酸钙碳酸钙泡腾片	pu'tao'tang'suan'gai'tan'suan'gai'pao'teng'pian	0
葡萄糖酸钙锌口服溶液	pu'tao'tang'suan'gai'xin'kou'fu'rong'ye	0
葡萄糖酸钙注射液	pu'tao'tang'suan'gai'zhu'she'ye	0
葡萄糖酸锌颗粒	pu'tao'tang'suan'xin'ke'li	0
葡萄糖酸锌口服溶液	pu'tao'tang'suan'xin'kou'fu'rong'ye	0
葡萄糖酸锌口服液	pu'tao'tang'suan'xin'kou'fu'ye	0
葡萄糖酸亚铁糖浆	pu'tao'tang'suan'ya'tie'tang'jiang	0
葡萄糖注射液	pu'tao'tang'zhu'she'ye	0
葡萄籽粉	pu'tao'zi'fen	0
绮峰制氧剂	qi'feng'zhi'yang'ji	0
气管炎丸	qi'guan'yan'wan	0
杞菊地黄丸	qi'ju'di'huang'wan	0
齐鲁制药有限公司	qi'lu'zhi'yao'you'xian'gong'si	0
启脾丸	qi'pi'wan	0
齐齐哈尔市万达卫生消毒剂厂	qi'qi'ha'er'shi'wan'da'wei'sheng'xiao'du'ji'chang	0
七叶洋地双苷滴眼液	qi'ye'yang'di'shuang'gan'di'yan'ye	0
七月花香椴树蜜	qi'yue'hua'xiang'duan'shu'mi	0
七月花香椴树原蜜	qi'yue'hua'xiang'duan'shu'yuan'mi	0
气滞胃痛颗粒	qi'zhi'wei'tong'ke'li	0
七制香附丸	qi'zhi'xiang'fu'wan	0
千柏鼻炎片	qian'bai'bi'yan'pian	0
千里光片	qian'li'guang'pian	0
前列安通胶囊	qian'lie'an'tong'jiao'nang	0
前列回春片	qian'lie'hui'chun'pian	0
前列金丹片	qian'lie'jin'dan'pian	0
前列癃闭通片	qian'lie'long'bi'tong'pian	0
前列舒乐胶囊	qian'lie'shu'le'jiao'nang	0
前列舒通胶囊	qian'lie'shu'tong'jiao'nang	0
羟苯磺酸钙胶囊	qiang'ben'huang'suan'gai'jiao'nang	0
强迪牌创口贴	qiang'di'pai'chuang'kou'tie	0
强迪牌高弹防水创可贴	qiang'di'pai'gao'tan'fang'shui'chuang'ke'tie	0
羟甲司坦片	qiang'jia'si'tan'pian	0
羟甲烟胺片	qiang'jia'yan'an'pian	0
强力脑清素片	qiang'li'nao'qing'su'pian	0
强力天麻杜仲丸	qiang'li'tian'ma'du'zhong'wan	0
敲敲乐颈肩背腰多功能按摩器	qiao'qiao'le'jing'jian'bei'yao'duo'gong'neng'an'mo'qi	0
芩暴红止咳胶囊	qin'bao'hong'zhi'ke'jiao'nang	0
芹菜籽粉	qin'cai'zi'fen	0
秦皇岛皇威制药有限公司	qin'huang'dao'huang'wei'zhi'yao'you'xian'gong'si	0
芩石利咽口服液	qin'shi'li'yan'kou'fu'ye	0
青岛国风药业股份有限公司	qing'dao'guo'feng'yao'ye'gu'fen'you'xian'gong'si	0
青岛海诺生物工程有限公司	qing'dao'hai'nuo'sheng'wu'gong'cheng'you'xian'gong'si	0
青岛黄海制药有限责任公司	qing'dao'huang'hai'zhi'yao'you'xian'ze'ren'gong'si	0
青岛科美生物工程有限公司	qing'dao'ke'mei'sheng'wu'gong'cheng'you'xian'gong'si	0
清肺化痰丸	qing'fei'hua'tan'wan	0
清肺抑火片	qing'fei'yi'huo'pian	0
青海晶珠藏药集团	qing'hai'jing'zhu'zang'yao'ji'tuan	0
青海制药厂有限公司	qing'hai'zhi'yao'chang'you'xian'gong'si	0
清喉利咽颗粒	qing'hou'li'yan'ke'li	0
清喉咽颗粒	qing'hou'yan'ke'li	0
清焕活眼霜	qing'huan'huo'yan'shuang	0
清火片	qing'huo'pian	0
清火栀麦片	qing'huo'zhi'mai'pian	0
清解片	qing'jie'pian	0
清金糖浆	qing'jin'tang'jiang	0
清开灵注射液	qing'kai'ling'zhu'she'ye	0
清凉油	qing'liang'you	0
情侣洁阴专家	qing'lv'jie'yin'zhuan'jia	0
氢氯噻嗪片	qing'lv'sai'qin'pian	0
氢氯塞嗪片	qing'lv'sai'qin'pian	0
清脑降压片	qing'nao'jiang'ya'pian	0
青鹏软膏	qing'peng'ruan'gao	0
清清乐	qing'qing'le	0
清热解毒胶囊	qing're'jie'du'jiao'nang	0
清热解毒口服液	qing're'jie'du'kou'fu'ye	0
清热散结片	qing're'san'jie'pian	0
清胃黄连丸	qing'wei'huang'lian'wan	0
氢溴酸右美沙芬颗粒	qing'xiu'suan'you'mei'sha'fen'ke'li	0
氢溴酸右美沙芬片	qing'xiu'suan'you'mei'sha'fen'pian	0
清眩降压片	qing'xuan'jiang'ya'pian	0
清眩片	qing'xuan'pian	0
清玄丸	qing'xuan'wan	0
清眩丸	qing'xuan'wan	0
清咽丸	qing'yan'wan	0
清胰利胆颗粒	qing'yi'li'dan'ke'li	0
清胰利胆丸	qing'yi'li'dan'wan	0
清音丸	qing'yin'wan	0
青州尧王制药有限公司	qing'zhou'yao'wang'zhi'yao'you'xian'gong'si	0
秋梨润肺膏	qiu'li'run'fei'gao	0
秋水仙碱片	qiu'shui'xian'jian'pian	0
曲安柰德氯霉素溶液	qu'an'nai'de'lv'mei'su'rong'ye	0
曲安奈德新霉素贴膏	qu'an'nai'de'xin'mei'su'tie'gao	0
曲安奈德益康唑乳膏	qu'an'nai'de'yi'kang'zuo'ru'gao	0
曲安奈德注射液	qu'an'nai'de'zhu'she'ye	0
祛斑亮白素	qu'ban'liang'bai'su	0
祛痘黄金凝胶	qu'dou'huang'jin'ning'jiao	0
去痘黄金凝胶套装	qu'dou'huang'jin'ning'jiao'tao'zhuang	0
祛痘洁面乳	qu'dou'jie'mian'ru	0
祛风止痛胶囊	qu'feng'zhi'tong'jiao'nang	0
祛黄褐斑胶囊	qu'huang'he'ban'jiao'nang	0
祛黄褐斑片	qu'huang'he'ban'pian	0
曲克芦丁片	qu'ke'lu'ding'pian	0
曲克芦丁注射液	qu'ke'lu'ding'zhu'she'ye	0
曲咪新乳膏	qu'mi'xin'ru'gao	0
曲匹布通片	qu'pi'bu'tong'pian	0
去痛片	qu'tong'pian	0
去氧孕烯炔雌醇片	qu'yang'yun'xi'que'ci'chun'pian	0
去乙酰毛花苷注射液	qu'yi'xian'mao'hua'gan'zhu'she'ye	0
全鹿丸	quan'lu'wan	0
热感抗冻霜	re'gan'kang'dong'shuang	0
壬苯醇醚栓	ren'ben'chun'mi'shuan	0
人工黄甲硝唑胶囊	ren'gong'huang'jia'xiao'zuo'jiao'nang	0
人工牛黄甲硝唑胶囊	ren'gong'niu'huang'jia'xiao'zuo'jiao'nang	0
人参归脾丸	ren'shen'gui'pi'wan	0
人参健脾丸	ren'shen'jian'pi'wan	0
人参养荣丸	ren'shen'yang'rong'wan	0
人参再造丸	ren'shen'zai'zao'wan	0
人体润滑剂	ren'ti'run'hua'ji	0
鞣酸蛋白酵母散	rou'suan'dan'bai'jiao'mu'san	0
乳核内消液	ru'he'nei'xiao'ye	0
乳块消片	ru'kuai'xiao'pian	0
乳酶生片	ru'mei'sheng'pian	0
乳宁片	ru'ning'pian	0
乳癖消片	ru'pi'xiao'pian	0
乳酸环丙沙星氯化钠注射液	ru'suan'huan'bing'sha'xing'lv'hua'na'zhu'she'ye	0
乳酸菌素颗粒	ru'suan'jun'su'ke'li	0
乳酸菌素片	ru'suan'jun'su'pian	0
乳酸亚铁口服液	ru'suan'ya'tie'kou'fu'ye	0
乳酸左氧氟沙星氯化钠注射液	ru'suan'zuo'yang'fu'sha'xing'lv'hua'na'zhu'she'ye	0
瑞格列奈片	rui'ge'lie'nai'pian	0
润唇膏	run'chun'gao	0
塞克硝唑胶囊	sai'ke'xiao'zuo'jiao'nang	0
塞雪风湿胶囊	sai'xue'feng'shi'jiao'nang	0
三合钙咀嚼片	san'he'gai'ju'jue'pian	0
三黄妇炎康洗液	san'huang'fu'yan'kang'xi'ye	0
三黄胶囊	san'huang'jiao'nang	0
三黄片	san'huang'pian	0
三金片	san'jin'pian	0
三九胃泰颗粒	san'jiu'wei'tai'ke'li	0
三磷酸腺苷二钠注射液	san'lin'suan'xian'gan'er'na'zhu'she'ye	0
三门峡广宇生物制药有限公司	san'men'xia'guang'yu'sheng'wu'zhi'yao'you'xian'gong'si	0
三门峡崋原制药有限公司	san'men'xia'hua'yuan'zhi'yao'you'xian'gong'si	0
三门峡赛诺维制药有限公司	san'men'xia'sai'nuo'wei'zhi'yao'you'xian'gong'si	0
三诺生物传感股份有限公司	san'nuo'sheng'wu'chuan'gan'gu'fen'you'xian'gong'si	0
三七伤药片	san'qi'shang'yao'pian	0
三肾丸	san'shen'wan	0
桑菊感冒片	sang'ju'gan'mao'pian	0
桑拓妮爽	sang'tuo'ni'shuang	0
扫日老劳肺止咳胶囊	sao'ri'lao'lao'fei'zhi'ke'jiao'nang	0
纱口罩	sha'kou'zhao	0
砂轮片	sha'lun'pian	0
山东百草药业有限公司	shan'dong'bai'cao'yao'ye'you'xian'gong'si	0
山东百维药业有限公司	shan'dong'bai'wei'yao'ye'you'xian'gong'si	0
山东博士伦福瑞达制药有限公司	shan'dong'bo'shi'lun'fu'rui'da'zhi'yao'you'xian'gong'si	0
山东步长制药股份有限公司	shan'dong'bu'chang'zhi'yao'gu'fen'you'xian'gong'si	0
山东大陆药业有限公司	shan'dong'da'lu'yao'ye'you'xian'gong'si	0
山东方健制药有限公司	shan'dong'fang'jian'zhi'yao'you'xian'gong'si	0
山东方明药业集团股份有限公司	shan'dong'fang'ming'yao'ye'ji'tuan'gu'fen'you'xian'gong'si	0
山东华鲁制药有限公司	shan'dong'hua'lu'zhi'yao'you'xian'gong'si	0
山东健民药业有限公司	shan'dong'jian'min'yao'ye'you'xian'gong'si	0
山东京卫制药有限公司	shan'dong'jing'wei'zhi'yao'you'xian'gong'si	0
山东良福制药有限公司	shan'dong'liang'fu'zhi'yao'you'xian'gong'si	0
山东鲁抗东岳制药有限公司	shan'dong'lu'kang'dong'yue'zhi'yao'you'xian'gong'si	0
山东鲁抗医药股份有限公司	shan'dong'lu'kang'yi'yao'gu'fen'you'xian'gong'si	0
山东鲁药制药有限公司	shan'dong'lu'yao'zhi'yao'you'xian'gong'si	0
山东罗欣药业股份有限公司	shan'dong'luo'xin'yao'ye'gu'fen'you'xian'gong'si	0
山东齐都药业有限公司	shan'dong'qi'dou'yao'ye'you'xian'gong'si	0
山东齐康药业有限公司	shan'dong'qi'kang'yao'ye'you'xian'gong'si	0
山东仁和堂药业有限公司	shan'dong'ren'he'tang'yao'ye'you'xian'gong'si	0
山东润华药业有限公司	shan'dong'run'hua'yao'ye'you'xian'gong'si	0
山东山大康诺制药有限公司	shan'dong'shan'da'kang'nuo'zhi'yao'you'xian'gong'si	0
山东圣海保健品有限公司	shan'dong'sheng'hai'bao'jian'pin'you'xian'gong'si	0
山东五吴制药有限公司	shan'dong'wu'wu'zhi'yao'you'xian'gong'si	0
山东仙河药业有限公司	shan'dong'xian'he'yao'ye'you'xian'gong'si	0
山东信谊制药有限公司	shan'dong'xin'yi'zhi'yao'you'xian'gong'si	0
山东益康药业有限公司	shan'dong'yi'kang'yao'ye'you'xian'gong'si	0
山东禹王药业	shan'dong'yu'wang'yao'ye	0
山蜂蜜	shan'feng'mi	0
珊瑚七十味丸	shan'hu'qi'shi'wei'wan	0
闪亮护眼贴	shan'liang'hu'yan'tie	0
山玫胶囊	shan'mei'jiao'nang	0
山葡健脾颗粒	shan'pu'jian'pi'ke'li	0
疝气治疗带	shan'qi'zhi'liao'dai	0
汕头市美宝制药有限公司	shan'tou'shi'mei'bao'zhi'yao'you'xian'gong'si	0
山西澳迩药业有限公司	shan'xi'ao'er'yao'ye'you'xian'gong'si	0
陕西百年健康药业有限公司	shan'xi'bai'nian'jian'kang'yao'ye'you'xian'gong'si	0
陕西步长制药有限公司	shan'xi'bu'chang'zhi'yao'you'xian'gong'si	0
陕西春晖药业有限公司	shan'xi'chun'hui'yao'ye'you'xian'gong'si	0
陕西方舟制药有限公司	shan'xi'fang'zhou'zhi'yao'you'xian'gong'si	0
山西国润制药有限公司	shan'xi'guo'run'zhi'yao'you'xian'gong'si	0
山西亨瑞达制药有限公司	shan'xi'heng'rui'da'zhi'yao'you'xian'gong'si	0
山西华康药业股份有限公司	shan'xi'hua'kang'yao'ye'gu'fen'you'xian'gong'si	0
山西皇城相符药业有限公司	shan'xi'huang'cheng'xiang'fu'yao'ye'you'xian'gong'si	0
山西佳能达化禹制药有限公司	shan'xi'jia'neng'da'hua'yu'zhi'yao'you'xian'gong'si	0
陕西君碧莎制药有限公司	shan'xi'jun'bi'sha'zhi'yao'you'xian'gong'si	0
陕西君寿堂制药有限公司	shan'xi'jun'shou'tang'zhi'yao'you'xian'gong'si	0
陕西康惠制药股份有限公司	shan'xi'kang'hui'zhi'yao'gu'fen'you'xian'gong'si	0
山西康立生药业有限公司	shan'xi'kang'li'sheng'yao'ye'you'xian'gong'si	0
山西利丰华瑞制药有限责任公司	shan'xi'li'feng'hua'rui'zhi'yao'you'xian'ze'ren'gong'si	0
陕西立众制药有限公司	shan'xi'li'zhong'zhi'yao'you'xian'gong'si	0
山西迈迪制药有限公司	shan'xi'mai'di'zhi'yao'you'xian'gong'si	0
陕西摩美得制药有限公司	shan'xi'mo'mei'de'zhi'yao'you'xian'gong'si	0
山西普德药业股份有限公司	shan'xi'pu'de'yao'ye'gu'fen'you'xian'gong'si	0
山西千汇药业有限公司	shan'xi'qian'hui'yao'ye'you'xian'gong'si	0
山西仟源制药股份有限公司	shan'xi'qian'yuan'zhi'yao'gu'fen'you'xian'gong'si	0
陕西仁康药业有限公司	shan'xi'ren'kang'yao'ye'you'xian'gong'si	0
山西省临汾健民药业有限公司	shan'xi'sheng'lin'fen'jian'min'yao'ye'you'xian'gong'si	0
陕西省咸阳市五五药业有限公司	shan'xi'sheng'xian'yang'shi'wu'wu'yao'ye'you'xian'gong'si	0
山西双人药业有限责任公司	shan'xi'shuang'ren'yao'ye'you'xian'ze'ren'gong'si	0
山西太原药业有限公司	shan'xi'tai'yuan'yao'ye'you'xian'gong'si	0
陕西天润药械有限公司	shan'xi'tian'run'yao'xie'you'xian'gong'si	0
山西天星制药有限公司	shan'xi'tian'xing'zhi'yao'you'xian'gong'si	0
山西同达药业有限公司	shan'xi'tong'da'yao'ye'you'xian'gong'si	0
山西享瑞达制药有限公司	shan'xi'xiang'rui'da'zhi'yao'you'xian'gong'si	0
山西鑫煜制药有限公司	shan'xi'xin'yu'zhi'yao'you'xian'gong'si	0
山西星火维敏制药有限公司	shan'xi'xing'huo'wei'min'zhi'yao'you'xian'gong'si	0
陕西颐生堂药业有限公司	shan'xi'yi'sheng'tang'yao'ye'you'xian'gong'si	0
山西远景康业制药有限公司	shan'xi'yuan'jing'kang'ye'zhi'yao'you'xian'gong'si	0
山西渊源药业有限公司	shan'xi'yuan'yuan'yao'ye'you'xian'gong'si	0
山西云鹏制药有限公司	shan'xi'yun'peng'zhi'yao'you'xian'gong'si	0
山西振东泰盛制药有限公司	shan'xi'zhen'dong'tai'sheng'zhi'yao'you'xian'gong'si	0
山西中宝曙光药业有限公司	shan'xi'zhong'bao'shu'guang'yao'ye'you'xian'gong'si	0
山羊奶孕婴专用皂	shan'yang'nai'yun'ying'zhuan'yong'zao	0
山药薏仁粉	shan'yao'yi'ren'fen	0
山楂丸	shan'zha'wan	0
山庄降脂片	shan'zhuang'jiang'zhi'pian	0
伤风停片	shang'feng'ting'pian	0
上海宝隆医疗用品有限公司	shang'hai'bao'long'yi'liao'yong'pin'you'xian'gong'si	0
上海北杰集团关东药业有限公司	shang'hai'bei'jie'ji'tuan'guan'dong'yao'ye'you'xian'gong'si	0
上海复旦复华药业有限公司	shang'hai'fu'dan'fu'hua'yao'ye'you'xian'gong'si	0
上海海迪化妆品有限公司	shang'hai'hai'di'hua'zhuang'pin'you'xian'gong'si	0
上海和黄药业	shang'hai'he'huang'yao'ye	0
上海华源安徽锦辉制药有限公司	shang'hai'hua'yuan'an'hui'jin'hui'zhi'yao'you'xian'gong'si	0
上海华源安徽仁济制药有限公司	shang'hai'hua'yuan'an'hui'ren'ji'zhi'yao'you'xian'gong'si	0
上海皇象铁力蓝天制药有限公司	shang'hai'huang'xiang'tie'li'lan'tian'zhi'yao'you'xian'gong'si	0
上海健陵贸易有限公司	shang'hai'jian'ling'mao'yi'you'xian'gong'si	0
上海金不换兰考制药有限公司	shang'hai'jin'bu'huan'lan'kao'zhi'yao'you'xian'gong'si	0
上海静安制药有限公司	shang'hai'jing'an'zhi'yao'you'xian'gong'si	0
上海凯宝药业股份有限公司	shang'hai'kai'bao'yao'ye'gu'fen'you'xian'gong'si	0
上海康达生物科技有限公司	shang'hai'kang'da'sheng'wu'ke'ji'you'xian'gong'si	0
上海美优制药有限公司	shang'hai'mei'you'zhi'yao'you'xian'gong'si	0
上海普康药业有限公司	shang'hai'pu'kang'yao'ye'you'xian'gong'si	0
上海清雷电子有限公司	shang'hai'qing'lei'dian'zi'you'xian'gong'si	0
上海群爱医疗科技有限公司	shang'hai'qun'ai'yi'liao'ke'ji'you'xian'gong'si	0
上海市大药业股份有限公司	shang'hai'shi'da'yao'ye'gu'fen'you'xian'gong'si	0
上海天赐福生物工程有限公司	shang'hai'tian'ci'fu'sheng'wu'gong'cheng'you'xian'gong'si	0
上海通用药业股份有限公司	shang'hai'tong'yong'yao'ye'gu'fen'you'xian'gong'si	0
上海现代哈森药业有限公司	shang'hai'xian'dai'ha'sen'yao'ye'you'xian'gong'si	0
上海现代制药股份有限公司	shang'hai'xian'dai'zhi'yao'gu'fen'you'xian'gong'si	0
上海仙灵葆雅制药有限公司	shang'hai'xian'ling'bao'ya'zhi'yao'you'xian'gong'si	0
上海新亚药业有限公司	shang'hai'xin'ya'yao'ye'you'xian'gong'si	0
上海信宜天平药业有限公司	shang'hai'xin'yi'tian'ping'yao'ye'you'xian'gong'si	0
上海信谊药厂有限公司	shang'hai'xin'yi'yao'chang'you'xian'gong'si	0
上海云峰药业有限公司	shang'hai'yun'feng'yao'ye'you'xian'gong'si	0
上海珍誉工贸有限公司	shang'hai'zhen'yu'gong'mao'you'xian'gong'si	0
伤科跌大片	shang'ke'die'da'pian	0
伤科跌打丸	shang'ke'die'da'wan	0
商丘市亮峰卫生用品有限公司	shang'qiu'shi'liang'feng'wei'sheng'yong'pin'you'xian'gong'si	0
伤湿止痛膏	shang'shi'zhi'tong'gao	0
伤痛宁膏	shang'tong'ning'gao	0
伤痛宁胶囊	shang'tong'ning'jiao'nang	0
少腹逐瘀丸	shao'fu'zhu'yu'wan	0
韶颜堂阿胶糕	shao'yan'tang'e'jiao'gao	0
蛇胆川贝液	she'dan'chuan'bei'ye	0
麝香保心丸	she'xiang'bao'xin'wan	0
麝香接骨胶囊	she'xiang'jie'gu'jiao'nang	0
麝香祛痛气雾剂	she'xiang'qu'tong'qi'wu'ji	0
麝香痔疮栓	she'xiang'zhi'chuang'shuan	0
麝香止痛贴复盛公	she'xiang'zhi'tong'tie'fu'sheng'gong	0
麝香壮骨膏	she'xiang'zhuang'gu'gao	0
肾宝合剂	shen'bao'he'ji	0
肾宝片	shen'bao'pian	0
深层补水霜	shen'ceng'bu'shui'shuang	0
肾复康胶囊	shen'fu'kang'jiao'nang	0
参苓白术散	shen'ling'bai'zhu'san	0
参麦注射液	shen'mai'zhu'she'ye	0
参芪健胃颗粒	shen'qi'jian'wei'ke'li	0
参芪五味子糖浆	shen'qi'wu'wei'zi'tang'jiang	0
参茸鞭丸	shen'rong'bian'wan	0
肾上腺色腙片	shen'shang'xian'se'zong'pian	0
肾石通颗粒	shen'shi'tong'ke'li	0
神威药业集团有限公司	shen'wei'yao'ye'ji'tuan'you'xian'gong'si	0
肾炎安胶囊	shen'yan'an'jiao'nang	0
肾炎片	shen'yan'pian	0
沈阳东陵药业股份有限公司	shen'yang'dong'ling'yao'ye'gu'fen'you'xian'gong'si	0
沈阳格林制药有限公司	shen'yang'ge'lin'zhi'yao'you'xian'gong'si	0
沈阳管城制药有限责任公司	shen'yang'guan'cheng'zhi'yao'you'xian'ze'ren'gong'si	0
沈阳红旗制药有限公司	shen'yang'hong'qi'zhi'yao'you'xian'gong'si	0
沈阳红药制药股份有限公司	shen'yang'hong'yao'zhi'yao'gu'fen'you'xian'gong'si	0
沈阳绿洲制药有限公司	shen'yang'lv'zhou'zhi'yao'you'xian'gong'si	0
沈阳双鼎制药有限公司	shen'yang'shuang'ding'zhi'yao'you'xian'gong'si	0
沈阳同联药业有限公司	shen'yang'tong'lian'yao'ye'you'xian'gong'si	0
沈阳维尔医疗器械有限公司	shen'yang'wei'er'yi'liao'qi'xie'you'xian'gong'si	0
沈阳一天生物制药有限公司	shen'yang'yi'tian'sheng'wu'zhi'yao'you'xian'gong'si	0
深圳市生命力科技发展有限公司	shen'zhen'shi'sheng'ming'li'ke'ji'fa'zhan'you'xian'gong'si	0
深圳市泰康制药有限公司	shen'zhen'shi'tai'kang'zhi'yao'you'xian'gong'si	0
深圳太太药业有限公司	shen'zhen'tai'tai'yao'ye'you'xian'gong'si	0
深圳信立泰药业股份有限公司	shen'zhen'xin'li'tai'yao'ye'gu'fen'you'xian'gong'si	0
深圳致君制药有限公司	shen'zhen'zhi'jun'zhi'yao'you'xian'gong'si	0
圣大唐山药业有限公司	sheng'da'tang'shan'yao'ye'you'xian'gong'si	0
生脉饮党参方	sheng'mai'yin'dang'shen'fang	0
生脉注射液	sheng'mai'zhu'she'ye	0
十八味诃子利尿丸	shi'ba'wei'he'zi'li'niao'wan	0
十八味诃子丸	shi'ba'wei'he'zi'wan	0
湿毒清胶囊	shi'du'qing'jiao'nang	0
湿毒清片	shi'du'qing'pian	0
石斛夜光丸	shi'hu'ye'guang'wan	0
施慧达药业集团吉林有限公司	shi'hui'da'yao'ye'ji'tuan'ji'lin'you'xian'gong'si	0
石家庄奥伟医药有限公司	shi'jia'zhuang'ao'wei'yi'yao'you'xian'gong'si	0
石家庄康贺威药业有限公司	shi'jia'zhuang'kang'he'wei'yao'ye'you'xian'gong'si	0
石家庄市华新药业有限责任公司	shi'jia'zhuang'shi'hua'xin'yao'ye'you'xian'ze'ren'gong'si	0
石家庄市协和药业有限公司	shi'jia'zhuang'shi'xie'he'yao'ye'you'xian'gong'si	0
石家庄四药有限公司	shi'jia'zhuang'si'yao'you'xian'gong'si	0
石家庄万和制药有限公司	shi'jia'zhuang'wan'he'zhi'yao'you'xian'gong'si	0
石家庄以岭药业股份有限公司	shi'jia'zhuang'yi'ling'yao'ye'gu'fen'you'xian'gong'si	0
石淋通片	shi'lin'tong'pian	0
石榴日轮丸	shi'liu'ri'lun'wan	0
食母生片	shi'mu'sheng'pian	0
十全大补膏	shi'quan'da'bu'gao	0
十全大补丸	shi'quan'da'bu'wan	0
湿润烧伤膏	shi'run'shao'shang'gao	0
时尚休闲防尘口罩	shi'shang'xiu'xian'fang'chen'kou'zhao	0
施圣多维氨基酸蛋白质粉	shi'sheng'duo'wei'an'ji'suan'dan'bai'zhi'fen	0
施圣牛初乳蛋白粉	shi'sheng'niu'chu'ru'dan'bai'fen	0
施圣全营养蛋白粉	shi'sheng'quan'ying'yang'dan'bai'fen	0
施圣无糖型蛋白粉	shi'sheng'wu'tang'xing'dan'bai'fen	0
施圣中老年蛋白质粉	shi'sheng'zhong'lao'nian'dan'bai'zhi'fen	0
十五位龙胆花	shi'wu'wei'long'dan'hua	0
十五味乳鹏丸	shi'wu'wei'ru'peng'wan	0
十香暖脐膏	shi'xiang'nuan'qi'gao	0
十香止痛丸	shi'xiang'zhi'tong'wan	0
石杏痰咳片	shi'xing'tan'ke'pian	0
石药集团欧意药业有限公司	shi'yao'ji'tuan'ou'yi'yao'ye'you'xian'gong'si	0
石药银湖制药有限公司	shi'yao'yin'hu'zhi'yao'you'xian'gong'si	0
手臂式电子血压计	shou'bi'shi'dian'zi'xue'ya'ji	0
首乌延寿片	shou'wu'yan'shou'pian	0
寿制药株式会社	shou'zhi'yao'zhu'shi'hui'she	0
疏风定痛丸	shu'feng'ding'tong'wan	0
舒肝和胃丸	shu'gan'he'wei'wan	0
舒肝健胃丸	shu'gan'jian'wei'wan	0
舒肝丸	shu'gan'wan	0
舒筋活血片	shu'jin'huo'xue'pian	0
舒筋丸	shu'jin'wan	0
舒秘胶囊	shu'mi'jiao'nang	0
舒心安神口服液	shu'xin'an'shen'kou'fu'ye	0
舒血宁注射液	shu'xue'ning'zhu'she'ye	0
疏血通注射液	shu'xue'tong'zhu'she'ye	0
输液器	shu'ye'qi	0
双黄连含片	shuang'huang'lian'han'pian	0
双黄连清湿洗液	shuang'huang'lian'qing'shi'xi'ye	0
双黄连注射液	shuang'huang'lian'zhu'she'ye	0
双料喉风散	shuang'liao'hou'feng'san	0
双苓止泻口服液	shuang'ling'zhi'xie'kou'fu'ye	0
双氯芬酸二乙胺乳胶剂	shuang'lv'fen'suan'er'yi'an'ru'jiao'ji	0
双氯芬酸钠肠溶片	shuang'lv'fen'suan'na'chang'rong'pian	0
双氯芬酸钠滴眼液	shuang'lv'fen'suan'na'di'yan'ye	0
双氯芬酸钠缓释胶囊	shuang'lv'fen'suan'na'huan'shi'jiao'nang	0
双氯芬酸钠缓释片	shuang'lv'fen'suan'na'huan'shi'pian	0
双歧杆菌乳杆菌三联活菌片	shuang'qi'gan'jun'ru'gan'jun'san'lian'huo'jun'pian	0
双唑泰栓	shuang'zuo'tai'shuan	0
双唑泰阴道软胶囊	shuang'zuo'tai'yin'dao'ruan'jiao'nang	0
水飞蓟宾胶囊	shui'fei'ji'bin'jiao'nang	0
睡好片	shui'hao'pian	0
水灵滋养霜	shui'ling'zi'yang'shuang	0
水嫩润唇膏	shui'nen'run'chun'gao	0
水杨酸苯酚贴膏	shui'yang'suan'ben'fen'tie'gao	0
硕尔拔罐器	shuo'er'ba'guan'qi	0
四川彩虹制药有限公司	si'chuan'cai'hong'zhi'yao'you'xian'gong'si	0
四川大千药业有限公司	si'chuan'da'qian'yao'ye'you'xian'gong'si	0
四川德元药业集团有限公司	si'chuan'de'yuan'yao'ye'ji'tuan'you'xian'gong'si	0
四川恩威制药有限公司	si'chuan'en'wei'zhi'yao'you'xian'gong'si	0
四川光大制药有限公司	si'chuan'guang'da'zhi'yao'you'xian'gong'si	0
四川国康药业有限公司	si'chuan'guo'kang'yao'ye'you'xian'gong'si	0
四川好医生攀西药业有限公司	si'chuan'hao'yi'sheng'pan'xi'yao'ye'you'xian'gong'si	0
四川好医生药业集团有限公司	si'chuan'hao'yi'sheng'yao'ye'ji'tuan'you'xian'gong'si	0
四川禾邦阳光制药股份有限公司	si'chuan'he'bang'yang'guang'zhi'yao'gu'fen'you'xian'gong'si	0
四川恒明科技开发有限公司	si'chuan'heng'ming'ke'ji'kai'fa'you'xian'gong'si	0
四川金药师制药有限公司	si'chuan'jin'yao'shi'zhi'yao'you'xian'gong'si	0
四川康定金珠制药有限公司	si'chuan'kang'ding'jin'zhu'zhi'yao'you'xian'gong'si	0
四川科伦药业股份有限公司	si'chuan'ke'lun'yao'ye'gu'fen'you'xian'gong'si	0
四川美大康药业股份有限公司	si'chuan'mei'da'kang'yao'ye'gu'fen'you'xian'gong'si	0
四川奇力制药有限公司	si'chuan'qi'li'zhi'yao'you'xian'gong'si	0
四川赛卓药业股份有限公司	si'chuan'sai'zhuo'yao'ye'gu'fen'you'xian'gong'si	0
四川省三星堆制药有限公司	si'chuan'sheng'san'xing'dui'zhi'yao'you'xian'gong'si	0
四川省尚善堂制药有限公司	si'chuan'sheng'shang'shan'tang'zhi'yao'you'xian'gong'si	0
四川省通园制药有限公司	si'chuan'sheng'tong'yuan'zhi'yao'you'xian'gong'si	0
四川省中药厂有限责任公司	si'chuan'sheng'zhong'yao'chang'you'xian'ze'ren'gong'si	0
四川维奥制药有限公司	si'chuan'wei'ao'zhi'yao'you'xian'gong'si	0
四川旭阳药业有限责任公司	si'chuan'xu'yang'yao'ye'you'xian'ze'ren'gong'si	0
四川珍珠药业有限公司	si'chuan'zhen'zhu'yao'ye'you'xian'gong'si	0
四川中方制药有限公司	si'chuan'zhong'fang'zhi'yao'you'xian'gong'si	0
斯达舒胶囊	si'da'shu'jiao'nang	0
四环素片	si'huan'su'pian	0
四季感冒片	si'ji'gan'mao'pian	0
四磨汤口服液	si'mo'tang'kou'fu'ye	0
司帕沙星片	si'pa'sha'xing'pian	0
四神丸	si'shen'wan	0
思维诺口服液	si'wei'nuo'kou'fu'ye	0
四维他胶囊	si'wei'ta'jiao'nang	0
四味珍层冰硼滴眼液	si'wei'zhen'ceng'bing'peng'di'yan'ye	0
四消丸	si'xiao'wan	0
松龄血脉康胶囊	song'ling'xue'mai'kang'jiao'nang	0
速效救心丸	su'xiao'jiu'xin'wan	0
苏州东瑞制药有限公司	su'zhou'dong'rui'zhi'yao'you'xian'gong'si	0
苏州太湖美药业有限公司	su'zhou'tai'hu'mei'yao'ye'you'xian'gong'si	0
羧甲司坦颗粒	suo'jia'si'tan'ke'li	0
锁阳补肾胶囊	suo'yang'bu'shen'jiao'nang	0
锁阳固精丸	suo'yang'gu'jing'wan	0
太极跌打损伤消痛贴	tai'ji'die'da'sun'shang'xiao'tong'tie	0
太极风湿关节消痛贴	tai'ji'feng'shi'guan'jie'xiao'tong'tie	0
太极骨质增生消痛贴	tai'ji'gu'zhi'zeng'sheng'xiao'tong'tie	0
太极集团桐君阁药厂有限公司	tai'ji'ji'tuan'tong'jun'ge'yao'chang'you'xian'gong'si	0
太极集团西南药业股份有限公司	tai'ji'ji'tuan'xi'nan'yao'ye'gu'fen'you'xian'gong'si	0
太极集团浙江东方制药有限公司	tai'ji'ji'tuan'zhe'jiang'dong'fang'zhi'yao'you'xian'gong'si	0
太极肩周炎消痛贴	tai'ji'jian'zhou'yan'xiao'tong'tie	0
太极颈椎消痛贴	tai'ji'jing'zhui'xiao'tong'tie	0
太极丸	tai'ji'wan	0
太极西南药业股份有限公司	tai'ji'xi'nan'yao'ye'gu'fen'you'xian'gong'si	0
太极腰椎间盘突出消痛贴	tai'ji'yao'zhui'jian'pan'tu'chu'xiao'tong'tie	0
台式血压计	tai'shi'xue'ya'ji	0
太阳石唐山药业有限公司	tai'yang'shi'tang'shan'yao'ye'you'xian'gong'si	0
台州南峰药业有限公司	tai'zhou'nan'feng'yao'ye'you'xian'gong'si	0
痰咳净片	tan'ke'jing'pian	0
痰热清注射液	tan're'qing'zhu'she'ye	0
碳酸氢钠片	tan'suan'qing'na'pian	0
碳酸氢钠注射液	tan'suan'qing'na'zhu'she'ye	0
糖果小迪成人口罩	tang'guo'xiao'di'cheng'ren'kou'zhao	0
唐山红星药业有限责任公司	tang'shan'hong'xing'yao'ye'you'xian'ze'ren'gong'si	0
唐山集川药业利康制药有限公司	tang'shan'ji'chuan'yao'ye'li'kang'zhi'yao'you'xian'gong'si	0
特定电磁波谱治疗仪神灯	te'ding'dian'ci'bo'pu'zhi'liao'yi'shen'deng	0
特非那定片	te'fei'na'ding'pian	0
藤黄健骨丸	teng'huang'jian'gu'wan	0
替米沙坦片	ti'mi'sha'tan'pian	0
体温计粗	ti'wen'ji'cu	0
体温计细	ti'wen'ji'xi	0
替硝唑氯化钠注射液	ti'xiao'zuo'lv'hua'na'zhu'she'ye	0
替硝唑片	ti'xiao'zuo'pian	0
天津达仁堂京万红药业有限公司	tian'jin'da'ren'tang'jing'wan'hong'yao'ye'you'xian'gong'si	0
天津和治药业	tian'jin'he'zhi'yao'ye	0
天津金虹胜利药业有限公司	tian'jin'jin'hong'sheng'li'yao'ye'you'xian'gong'si	0
天津金耀药业有限公司	tian'jin'jin'yao'yao'ye'you'xian'gong'si	0
天津力生制药股份有限公司	tian'jin'li'sheng'zhi'yao'gu'fen'you'xian'gong'si	0
天津隆顺榕发展制药有限公司	tian'jin'long'shun'rong'fa'zhan'zhi'yao'you'xian'gong'si	0
天津市康瑞药业有限公司	tian'jin'shi'kang'rui'yao'ye'you'xian'gong'si	0
天津市中央药业有限公司	tian'jin'shi'zhong'yang'yao'ye'you'xian'gong'si	0
天津太平洋制药有限公司	tian'jin'tai'ping'yang'zhi'yao'you'xian'gong'si	0
天津药业集团新郑股份有限公司	tian'jin'yao'ye'ji'tuan'xin'zheng'gu'fen'you'xian'gong'si	0
天麻胶囊	tian'ma'jiao'nang	0
天麻片	tian'ma'pian	0
天麻素片	tian'ma'su'pian	0
天麻素注射液	tian'ma'su'zhu'she'ye	0
天麻头风灵片	tian'ma'tou'feng'ling'pian	0
天麻丸	tian'ma'wan	0
田七痛经胶囊	tian'qi'tong'jing'jiao'nang	0
天士力制药集团股份有限公司	tian'shi'li'zhi'yao'ji'tuan'gu'fen'you'xian'gong'si	0
天王补心丸	tian'wang'bu'xin'wan	0
铁汉铁盒避孕套	tie'han'tie'he'bi'yun'tao	0
铁岭市杜记膏药厂	tie'ling'shi'du'ji'gao'yao'chang	0
听诊器	ting'zhen'qi	0
通便灵胶囊	tong'bian'ling'jiao'nang	0
通化爱心药业有限责任公司	tong'hua'ai'xin'yao'ye'you'xian'ze'ren'gong'si	0
通化百信药业有限公司	tong'hua'bai'xin'yao'ye'you'xian'gong'si	0
通化长城药业股份有限公司	tong'hua'chang'cheng'yao'ye'gu'fen'you'xian'gong'si	0
通化东宝药业股份有限公司	tong'hua'dong'bao'yao'ye'gu'fen'you'xian'gong'si	0
通化东圣药业股份有限公司	tong'hua'dong'sheng'yao'ye'gu'fen'you'xian'gong'si	0
通化鸿淘茂药业有限公司	tong'hua'hong'tao'mao'yao'ye'you'xian'gong'si	0
通化华夏药业有限责任公司	tong'hua'hua'xia'yao'ye'you'xian'ze'ren'gong'si	0
通化汇金堂药业股份有限公司	tong'hua'hui'jin'tang'yao'ye'gu'fen'you'xian'gong'si	0
通化金马药业集团股份有限公司	tong'hua'jin'ma'yao'ye'ji'tuan'gu'fen'you'xian'gong'si	0
通化久铭工业有限公司	tong'hua'jiu'ming'gong'ye'you'xian'gong'si	0
通化利民药业有限责任公司	tong'hua'li'min'yao'ye'you'xian'ze'ren'gong'si	0
通化茂祥制药有限公司	tong'hua'mao'xiang'zhi'yao'you'xian'gong'si	0
通化民泰药业股份有限公司	tong'hua'min'tai'yao'ye'gu'fen'you'xian'gong'si	0
通化仁民药业股份有限公司	tong'hua'ren'min'yao'ye'gu'fen'you'xian'gong'si	0
通化万通药业股份有限公司	tong'hua'wan'tong'yao'ye'gu'fen'you'xian'gong'si	0
通化颐生药业股份有限公司	tong'hua'yi'sheng'yao'ye'gu'fen'you'xian'gong'si	0
通化制药集团股份有限公司	tong'hua'zhi'yao'ji'tuan'gu'fen'you'xian'gong'si	0
痛经宝颗粒	tong'jing'bao'ke'li	0
痛经贴	tong'jing'tie	0
酮康他索乳膏	tong'kang'ta'suo'ru'gao	0
通络祛痛膏	tong'luo'qu'tong'gao	0
通脉降糖胶囊	tong'mai'jiang'tang'jiao'nang	0
通脉颗粒	tong'mai'ke'li	0
通脉口服液	tong'mai'kou'fu'ye	0
通气鼻贴	tong'qi'bi'tie	0
通窍鼻炎片	tong'qiao'bi'yan'pian	0
通窍耳聋丸	tong'qiao'er'long'wan	0
同仁牛黄清心丸	tong'ren'niu'huang'qing'xin'wan	0
同仁乌鸡白凤丸	tong'ren'wu'ji'bai'feng'wan	0
通乳颗粒	tong'ru'ke'li	0
通舒口爽胶囊	tong'shu'kou'shuang'jiao'nang	0
通心络胶囊	tong'xin'luo'jiao'nang	0
通宣理肺丸	tong'xuan'li'fei'wan	0
通药制药集团股份有限公司	tong'yao'zhi'yao'ji'tuan'gu'fen'you'xian'gong'si	0
头孢氨苄甲氧苄啶胶囊	tou'bao'an'bian'jia'yang'bian'ding'jiao'nang	0
头孢氨苄胶囊	tou'bao'an'bian'jiao'nang	0
头孢氨苄颗粒	tou'bao'an'bian'ke'li	0
头孢氨苄片	tou'bao'an'bian'pian	0
头孢呋辛酯胶囊	tou'bao'fu'xin'zhi'jiao'nang	0
头孢克洛胶囊	tou'bao'ke'luo'jiao'nang	0
头孢克洛咀嚼片	tou'bao'ke'luo'ju'jue'pian	0
头孢克洛颗粒	tou'bao'ke'luo'ke'li	0
头孢克肟分散片	tou'bao'ke'wo'fen'san'pian	0
头孢克肟颗粒	tou'bao'ke'wo'ke'li	0
头孢克肟片	tou'bao'ke'wo'pian	0
头孢拉定胶囊	tou'bao'la'ding'jiao'nang	0
头孢拉定颗粒	tou'bao'la'ding'ke'li	0
透气自粘无菌敷料贴	tou'qi'zi'zhan'wu'jun'fu'liao'tie	0
透气自粘无菌辅料贴	tou'qi'zi'zhan'wu'jun'fu'liao'tie	0
头痛宁胶囊	tou'tong'ning'jiao'nang	0
土霉素片	tu'mei'su'pian	0
褪黑素软胶囊维尔健	tui'hei'su'ruan'jiao'nang'wei'er'jian	0
妥布霉素地塞米松滴眼液	tuo'bu'mei'su'di'sai'mi'song'di'yan'ye	0
妥布霉素滴眼液	tuo'bu'mei'su'di'yan'ye	0
脱脂棉纱布	tuo'zhi'mian'sha'bu	0
外用溃疡散	wai'yong'kui'yang'san	0
万痛筋骨喷剂	wan'tong'jin'gu'pen'ji	0
万通筋骨片	wan'tong'jin'gu'pian	0
万通筋骨贴	wan'tong'jin'gu'tie	0
卫材中国药业有限公司制造	wei'cai'zhong'guo'yao'ye'you'xian'gong'si'zhi'zao	0
胃肠灵胶囊	wei'chang'ling'jiao'nang	0
胃蛋白酶片	wei'dan'bai'mei'pian	0
潍坊中狮药业有限公司	wei'fang'zhong'shi'yao'ye'you'xian'gong'si	0
威海百合生物技术有限公司	wei'hai'bai'he'sheng'wu'ji'shu'you'xian'gong'si	0
威海华威药业集团有限公司	wei'hai'hua'wei'yao'ye'ji'tuan'you'xian'gong'si	0
胃康灵胶囊	wei'kang'ling'jiao'nang	0
胃康灵颗粒	wei'kang'ling'ke'li	0
胃乐新颗粒	wei'le'xin'ke'li	0
威灵骨刺膏	wei'ling'gu'ci'gao	0
维酶素片	wei'mei'su'pian	0
胃舒宁颗粒	wei'shu'ning'ke'li	0
胃苏颗粒	wei'su'ke'li	0
维他命保湿补水护手霜	wei'ta'ming'bao'shi'bu'shui'hu'shou'shuang	0
维他命保湿补水乳液	wei'ta'ming'bao'shi'bu'shui'ru'ye	0
维他命补水精华乳	wei'ta'ming'bu'shui'jing'hua'ru	0
维他命儿童滋润霜	wei'ta'ming'er'tong'zi'run'shuang	0
维他命男宝宝保湿霜	wei'ta'ming'nan'bao'bao'bao'shi'shuang	0
维他命女宝宝润肤霜	wei'ta'ming'nv'bao'bao'run'fu'shuang	0
维他命日夜修护嫩手霜	wei'ta'ming'ri'ye'xiu'hu'nen'shou'shuang	0
胃泰胶囊	wei'tai'jiao'nang	0
胃痛丸	wei'tong'wan	0
威威强身胶囊	wei'wei'qiang'shen'jiao'nang	0
胃欣舒胶囊	wei'xin'shu'jiao'nang	0
胃炎康胶囊	wei'yan'kang'jiao'nang	0
胃炎宁颗粒	wei'yan'ning'ke'li	0
温胃舒颗粒	wen'wei'shu'ke'li	0
稳心颗粒无蔗糖	wen'xin'ke'li'wu'zhe'tang	0
五海瘿瘤丸	wu'hai'ying'liu'wan	0
武汉长联来福制药股份有限公司	wu'han'chang'lian'lai'fu'zhi'yao'gu'fen'you'xian'gong'si	0
武汉福星生物药业有限公司	wu'han'fu'xing'sheng'wu'yao'ye'you'xian'gong'si	0
武汉华龙生物制药有限公司	wu'han'hua'long'sheng'wu'zhi'yao'you'xian'gong'si	0
武汉健民集团随州药业有限公司	wu'han'jian'min'ji'tuan'sui'zhou'yao'ye'you'xian'gong'si	0
武汉金城美商贸有限公司	wu'han'jin'cheng'mei'shang'mao'you'xian'gong'si	0
武汉润禾生物医药有限公司	wu'han'run'he'sheng'wu'yi'yao'you'xian'gong'si	0
武汉太福制药有限公司	wu'han'tai'fu'zhi'yao'you'xian'gong'si	0
武汉中联集团四药药业有限公司	wu'han'zhong'lian'ji'tuan'si'yao'yao'ye'you'xian'gong'si	0
无痕清痘霜	wu'hen'qing'dou'shuang	0
乌鸡白凤丸	wu'ji'bai'feng'wan	0
无菌笔式注射针	wu'jun'bi'shi'zhu'she'zhen	0
乌军治胆片	wu'jun'zhi'dan'pian	0
乌兰浩特中蒙制药有限公司	wu'lan'hao'te'zhong'meng'zhi'yao'you'xian'gong'si	0
五灵止痛胶囊	wu'ling'zhi'tong'jiao'nang	0
乌洛托品溶液	wu'luo'tuo'pin'rong'ye	0
五味子颗粒	wu'wei'zi'ke'li	0
无锡济民可信山禾药业有限公司	wu'xi'ji'min'ke'xin'shan'he'yao'ye'you'xian'gong'si	0
无锡凯夫制药有限公司	wu'xi'kai'fu'zhi'yao'you'xian'gong'si	0
五子衍宗丸	wu'zi'yan'zong'wan	0
西安碑林药业股份有限公司	xi'an'bei'lin'yao'ye'gu'fen'you'xian'gong'si	0
西安必康制药集团有限公司	xi'an'bi'kang'zhi'yao'ji'tuan'you'xian'gong'si	0
西安大唐制药集团有限公司	xi'an'da'tang'zhi'yao'ji'tuan'you'xian'gong'si	0
西安德天药业股份有限公司	xi'an'de'tian'yao'ye'gu'fen'you'xian'gong'si	0
西安阿房宫药业有限公司	xi'an'e'pang'gong'yao'ye'you'xian'gong'si	0
西安风华药业有限公	xi'an'feng'hua'yao'ye'you'xian'gong	0
西安金通电子有限责任公司	xi'an'jin'tong'dian'zi'you'xian'ze'ren'gong'si	0
西安康拜耳制药有限公司	xi'an'kang'bai'er'zhi'yao'you'xian'gong'si	0
西安利君制药有限责任公司	xi'an'li'jun'zhi'yao'you'xian'ze'ren'gong'si	0
西安杨森制药有限公司	xi'an'yang'sen'zhi'yao'you'xian'gong'si	0
西安自力中药集团有限公司	xi'an'zi'li'zhong'yao'ji'tuan'you'xian'gong'si	0
西地碘含片	xi'di'dian'han'pian	0
西瓜爽含片	xi'gua'shuang'han'pian	0
西瓜霜润喉片	xi'gua'shuang'run'hou'pian	0
西黄丸	xi'huang'wan	0
西咪替丁片	xi'mi'ti'ding'pian	0
西咪替丁注射液	xi'mi'ti'ding'zhu'she'ye	0
西沙必利片	xi'sha'bi'li'pian	0
吸湿罐	xi'shi'guan	0
西施兰南阳药业有限公司	xi'shi'lan'nan'yang'yao'ye'you'xian'gong'si	0
西双版纳版纳药业有限责任公司	xi'shuang'ban'na'ban'na'yao'ye'you'xian'ze'ren'gong'si	0
细辛脑片	xi'xin'nao'pian	0
西藏昌都光宇利民制药有限公司	xi'zang'chang'du'guang'yu'li'min'zhi'yao'you'xian'gong'si	0
西藏金珠雅砻藏药有限责任公司	xi'zang'jin'zhu'ya'long'zang'yao'you'xian'ze'ren'gong'si	0
西藏神猴药业有限责任公司	xi'zang'shen'hou'yao'ye'you'xian'ze'ren'gong'si	0
西藏雄巴拉曲神水藏药厂	xi'zang'xiong'ba'la'qu'shen'shui'zang'yao'chang	0
细止血带	xi'zhi'xue'dai	0
夏枯草膏	xia'ku'cao'gao	0
夏枯草胶囊	xia'ku'cao'jiao'nang	0
夏枯草颗粒	xia'ku'cao'ke'li	0
仙灵骨葆胶囊	xian'ling'gu'bao'jiao'nang	0
仙人掌胃康胶囊	xian'ren'zhang'wei'kang'jiao'nang	0
鲜竹沥	xian'zhu'li	0
香丹注射液	xiang'dan'zhu'she'ye	0
香附丸	xiang'fu'wan	0
香港国际有限公司监制	xiang'gang'guo'ji'you'xian'gong'si'jian'zhi	0
香港好时尚国际控股有限公司	xiang'gang'hao'shi'shang'guo'ji'kong'gu'you'xian'gong'si	0
香港新界荃湾德士古道号	xiang'gang'xin'jie'quan'wan'de'shi'gu'dao'hao	0
橡胶手套	xiang'jiao'shou'tao	0
香菊胶囊	xiang'ju'jiao'nang	0
响亮胖大海菊花塘	xiang'liang'pang'da'hai'ju'hua'tang	0
香砂养胃丸	xiang'sha'yang'wei'wan	0
香幽幽香体露	xiang'you'you'xiang'ti'lu	0
硝苯地平缓释片	xiao'ben'di'ping'huan'shi'pian	0
硝苯地平控释片	xiao'ben'di'ping'kong'shi'pian	0
硝苯地平片	xiao'ben'di'ping'pian	0
小柴胡颗粒	xiao'chai'hu'ke'li	0
消毒液	xiao'du'ye	0
小儿氨酚黄那敏颗粒	xiao'er'an'fen'huang'na'min'ke'li	0
小儿氨酚黄那敏片	xiao'er'an'fen'huang'na'min'pian	0
小儿氨酚烷胺颗粒	xiao'er'an'fen'wan'an'ke'li	0
小儿宝泰康颗粒	xiao'er'bao'tai'kang'ke'li	0
小儿导赤片	xiao'er'dao'chi'pian	0
小儿肺热咳喘颗粒	xiao'er'fei're'ke'chuan'ke'li	0
小儿肺热咳喘口服液	xiao'er'fei're'ke'chuan'kou'fu'ye	0
小儿酚氨咖敏颗粒	xiao'er'fen'an'ka'min'ke'li	0
小儿复方鸡内金散	xiao'er'fu'fang'ji'nei'jin'san	0
小儿感冒颗粒	xiao'er'gan'mao'ke'li	0
小儿化痰止咳颗粒	xiao'er'hua'tan'zhi'ke'ke'li	0
小儿解表颗粒	xiao'er'jie'biao'ke'li	0
小儿金丹片	xiao'er'jin'dan'pian	0
小儿咳喘灵颗粒	xiao'er'ke'chuan'ling'ke'li	0
小儿麻甘颗粒	xiao'er'ma'gan'ke'li	0
小儿麦枣咀嚼片	xiao'er'mai'zao'ju'jue'pian	0
小儿暖脐膏	xiao'er'nuan'qi'gao	0
小儿脐风散	xiao'er'qi'feng'san	0
小儿七星茶颗粒	xiao'er'qi'xing'cha'ke'li	0
小儿奇应丸	xiao'er'qi'ying'wan	0
小儿清肺止咳片	xiao'er'qing'fei'zhi'ke'pian	0
小儿清热止咳口服液	xiao'er'qing're'zhi'ke'kou'fu'ye	0
小儿清咽颗粒	xiao'er'qing'yan'ke'li	0
小儿十维颗粒	xiao'er'shi'wei'ke'li	0
小儿维生素咀嚼片	xiao'er'wei'sheng'su'ju'jue'pian	0
小儿喜食糖浆	xiao'er'xi'shi'tang'jiang	0
小儿消咳片	xiao'er'xiao'ke'pian	0
小儿消食咀嚼片	xiao'er'xiao'shi'ju'jue'pian	0
小儿咽扁颗粒	xiao'er'yan'bian'ke'li	0
小活络片	xiao'huo'luo'pian	0
小活络丸	xiao'huo'luo'wan	0
消积化滞片	xiao'ji'hua'zhi'pian	0
小金丸	xiao'jin'wan	0
消咳喘片	xiao'ke'chuan'pian	0
消渴降糖胶囊	xiao'ke'jiang'tang'jiao'nang	0
消渴降糖片	xiao'ke'jiang'tang'pian	0
消渴灵片	xiao'ke'ling'pian	0
消渴丸	xiao'ke'wan	0
消糜栓	xiao'mi'shuan	0
消糜阴道泡腾片	xiao'mi'yin'dao'pao'teng'pian	0
小牛血去蛋白提取物注射液	xiao'niu'xue'qu'dan'bai'ti'qu'wu'zhu'she'ye	0
消乳散结胶囊	xiao'ru'san'jie'jiao'nang	0
消石利胆胶囊	xiao'shi'li'dan'jiao'nang	0
消栓通络片	xiao'shuan'tong'luo'pian	0
消栓再造丸	xiao'shuan'zai'zao'wan	0
硝酸甘油片	xiao'suan'gan'you'pian	0
硝酸咪康唑乳膏	xiao'suan'mi'kang'zuo'ru'gao	0
硝酸咪康唑栓	xiao'suan'mi'kang'zuo'shuan	0
硝酸益康唑喷雾剂	xiao'suan'yi'kang'zuo'pen'wu'ji	0
硝酸异山梨酯片	xiao'suan'yi'shan'li'zhi'pian	0
消旋山莨菪碱片	xiao'xuan'shan'lang'dang'jian'pian	0
消炎利胆片	xiao'yan'li'dan'pian	0
消炎灵胶囊	xiao'yan'ling'jiao'nang	0
消炎片	xiao'yan'pian	0
消炎止咳片	xiao'yan'zhi'ke'pian	0
消炎止痢灵片	xiao'yan'zhi'li'ling'pian	0
消炎止痛贴	xiao'yan'zhi'tong'tie	0
逍遥颗粒	xiao'yao'ke'li	0
逍遥丸	xiao'yao'wan	0
消瘀定痛膏	xiao'yu'ding'tong'gao	0
消肿止痛酊	xiao'zhong'zhi'tong'ding	0
血塞通分散片	xie'sai'tong'fen'san'pian	0
血塞通片	xie'sai'tong'pian	0
血塞通注射液	xie'sai'tong'zhu'she'ye	0
缬沙坦胶囊	xie'sha'tan'jiao'nang	0
心安胶囊	xin'an'jiao'nang	0
心宝丸	xin'bao'wan	0
心达康片	xin'da'kang'pian	0
辛伐他汀片	xin'fa'ta'ting'pian	0
辛芳鼻炎胶囊	xin'fang'bi'yan'jiao'nang	0
新复方大青叶片	xin'fu'fang'da'qing'ye'pian	0
新盖中盖高钙片	xin'gai'zhong'gai'gao'gai'pian	0
心脑康胶囊	xin'nao'kang'jiao'nang	0
心脑清软胶囊	xin'nao'qing'ruan'jiao'nang	0
心脑疏通胶囊	xin'nao'shu'tong'jiao'nang	0
心脑舒通胶囊	xin'nao'shu'tong'jiao'nang	0
心宁片	xin'ning'pian	0
辛芩颗粒	xin'qin'ke'li	0
心神宁片	xin'shen'ning'pian	0
新生化颗粒	xin'sheng'hua'ke'li	0
心舒宝胶囊	xin'shu'bao'jiao'nang	0
新乡东升制药有限公司	xin'xiang'dong'sheng'zhi'yao'you'xian'gong'si	0
新乡恒久远药业有限公司	xin'xiang'heng'jiu'yuan'yao'ye'you'xian'gong'si	0
新乡华清药业有限公司	xin'xiang'hua'qing'yao'ye'you'xian'gong'si	0
新乡金象科技有限公司	xin'xiang'jin'xiang'ke'ji'you'xian'gong'si	0
新乡市常乐制药有限公司	xin'xiang'shi'chang'le'zhi'yao'you'xian'gong'si	0
新乡市康元生物科技有限公司	xin'xiang'shi'kang'yuan'sheng'wu'ke'ji'you'xian'gong'si	0
新乡市琦宁药业有限公司	xin'xiang'shi'qi'ning'yao'ye'you'xian'gong'si	0
醒脑安神片	xing'nao'an'shen'pian	0
醒脑再造胶囊	xing'nao'zai'zao'jiao'nang	0
醒脑再造丸	xing'nao'zai'zao'wan	0
杏苏止咳颗粒	xing'su'zhi'ke'ke'li	0
醒醒脑静注射液	xing'xing'nao'jing'zhu'she'ye	0
熊胆痔疮膏	xiong'dan'zhi'chuang'gao	0
芎香通脉滴丸	xiong'xiang'tong'mai'di'wan	0
秀妹尔减肥泡腾片	xiu'mei'er'jian'fei'pao'teng'pian	0
修正牛初乳粉	xiu'zheng'niu'chu'ru'fen	0
修正药业集团股份有限公司	xiu'zheng'yao'ye'ji'tuan'gu'fen'you'xian'gong'si	0
修姿茶	xiu'zi'cha	0
虚汗停糖浆	xu'han'ting'tang'jiang	0
血府逐瘀丸	xue'fu'zhu'yu'wan	0
血红素铁胶囊维尔健	xue'hong'su'tie'jiao'nang'wei'er'jian	0
雪美口罩成人	xue'mei'kou'zhao'cheng'ren	0
血尿胶囊	xue'niao'jiao'nang	0
血栓通注射液	xue'shuan'tong'zhu'she'ye	0
血脂康胶囊	xue'zhi'kang'jiao'nang	0
荨麻疹丸	xun'ma'zhen'wan	0
亚宝药业集团股份有限公司	ya'bao'yao'ye'ji'tuan'gu'fen'you'xian'gong'si	0
牙克石市森健药业有限公司	ya'ke'shi'shi'sen'jian'yao'ye'you'xian'gong'si	0
压舌片	ya'she'pian	0
延安长泰药业有限责任公司	yan'an'chang'tai'yao'ye'you'xian'ze'ren'gong'si	0
延更丹	yan'geng'dan	0
炎见宁片	yan'jian'ning'pian	0
炎可宁片	yan'ke'ning'pian	0
炎立消胶囊	yan'li'xiao'jiao'nang	0
炎立消片	yan'li'xiao'pian	0
盐酸氨碘酮片	yan'suan'an'dian'tong'pian	0
盐酸氨基葡萄糖胶囊	yan'suan'an'ji'pu'tao'tang'jiao'nang	0
盐酸氨溴索分散片	yan'suan'an'xiu'suo'fen'san'pian	0
盐酸氨溴索颗粒	yan'suan'an'xiu'suo'ke'li	0
盐酸氨溴索口服溶液	yan'suan'an'xiu'suo'kou'fu'rong'ye	0
盐酸氨溴索口服液	yan'suan'an'xiu'suo'kou'fu'ye	0
盐酸氨溴索片	yan'suan'an'xiu'suo'pian	0
盐酸氨溴索葡萄糖注射液	yan'suan'an'xiu'suo'pu'tao'tang'zhu'she'ye	0
盐酸倍他司汀氯化钠注射液	yan'suan'bei'ta'si'ting'lv'hua'na'zhu'she'ye	0
盐酸倍他司汀片	yan'suan'bei'ta'si'ting'pian	0
盐酸地芬尼多片	yan'suan'di'fen'ni'duo'pian	0
盐酸多西环素片	yan'suan'duo'xi'huan'su'pian	0
盐酸二甲双胍肠溶胶囊	yan'suan'er'jia'shuang'gua'chang'rong'jiao'nang	0
盐酸二甲双胍缓释片	yan'suan'er'jia'shuang'gua'huan'shi'pian	0
盐酸二甲双胍片	yan'suan'er'jia'shuang'gua'pian	0
盐酸二氧丙嗪颗粒	yan'suan'er'yang'bing'qin'ke'li	0
盐酸酚苄明片	yan'suan'fen'bian'ming'pian	0
盐酸氟桂利嗪胶囊	yan'suan'fu'gui'li'qin'jiao'nang	0
盐酸环丙沙星滴眼液	yan'suan'huan'bing'sha'xing'di'yan'ye	0
盐酸环丙沙星片	yan'suan'huan'bing'sha'xing'pian	0
盐酸黄酮哌酯片	yan'suan'huang'tong'pai'zhi'pian	0
盐酸甲氧氯普胺注射液	yan'suan'jia'yang'lv'pu'an'zhu'she'ye	0
盐酸金刚烷胺片	yan'suan'jin'gang'wan'an'pian	0
盐酸金霉素眼膏	yan'suan'jin'mei'su'yan'gao	0
盐酸克林霉素胶囊	yan'suan'ke'lin'mei'su'jiao'nang	0
盐酸利多卡因注射液	yan'suan'li'duo'ka'yin'zhu'she'ye	0
盐酸林可霉素注射液	yan'suan'lin'ke'mei'su'zhu'she'ye	0
盐酸洛美沙星片	yan'suan'luo'mei'sha'xing'pian	0
盐酸洛美沙星眼液	yan'suan'luo'mei'sha'xing'yan'ye	0
盐酸氯哌丁片	yan'suan'lv'pai'ding'pian	0
盐酸吗啉胍片	yan'suan'ma'lin'gua'pian	0
盐酸美他环素片	yan'suan'mei'ta'huan'su'pian	0
盐酸美西律片	yan'suan'mei'xi'lv'pian	0
盐酸奈福泮片	yan'suan'nai'fu'pan'pian	0
盐酸奈福泮注射液	yan'suan'nai'fu'pan'zhu'she'ye	0
盐酸柰甲唑啉	yan'suan'nai'jia'zuo'lin	0
盐酸普罗帕酮片	yan'suan'pu'luo'pa'tong'pian	0
盐酸普萘洛尔片	yan'suan'pu'nai'luo'er'pian	0
盐酸赛庚啶片	yan'suan'sai'geng'ding'pian	0
盐酸肾上腺素注射液	yan'suan'shen'shang'xian'su'zhu'she'ye	0
盐酸特比萘芬喷雾剂	yan'suan'te'bi'nai'fen'pen'wu'ji	0
盐酸特拉唑嗪胶囊	yan'suan'te'la'zuo'qin'jiao'nang	0
盐酸维拉帕米片	yan'suan'wei'la'pa'mi'pian	0
盐酸西替利嗪片	yan'suan'xi'ti'li'qin'pian	0
盐酸小檗碱片	yan'suan'xiao'bo'jian'pian	0
盐酸消旋山莨菪碱注射液	yan'suan'xiao'xuan'shan'lang'dang'jian'zhu'she'ye	0
盐酸乙胺丁醇片	yan'suan'yi'an'ding'chun'pian	0
盐酸伊托必利片	yan'suan'yi'tuo'bi'li'pian	0
盐酸左氧氟沙星滴眼液	yan'suan'zuo'yang'fu'sha'xing'di'yan'ye	0
盐酸左氧氟沙星胶囊	yan'suan'zuo'yang'fu'sha'xing'jiao'nang	0
盐酸左氧氟沙星片	yan'suan'zuo'yang'fu'sha'xing'pian	0
烟台鲁银药业有限公司	yan'tai'lu'yin'yao'ye'you'xian'gong'si	0
烟台荣昌制药股份有限公司	yan'tai'rong'chang'zhi'yao'gu'fen'you'xian'gong'si	0
烟台只楚药业有限公司	yan'tai'zhi'chu'yao'ye'you'xian'gong'si	0
咽炎片	yan'yan'pian	0
阳春胶囊	yang'chun'jiao'nang	0
氧氟沙星滴耳液	yang'fu'sha'xing'di'er'ye	0
氧氟沙星滴眼液	yang'fu'sha'xing'di'yan'ye	0
杨凌东科麦迪森在药业有限公司	yang'ling'dong'ke'mai'di'sen'zai'yao'ye'you'xian'gong'si	0
养胃舒颗粒	yang'wei'shu'ke'li	0
养心安神片	yang'xin'an'shen'pian	0
养心氏片	yang'xin'shi'pian	0
养血安神片	yang'xue'an'shen'pian	0
养血清脑颗粒	yang'xue'qing'nao'ke'li	0
养血生发胶囊	yang'xue'sheng'fa'jiao'nang	0
养阴清肺丸	yang'yin'qing'fei'wan	0
养阴镇静片	yang'yin'zhen'jing'pian	0
扬州源康医疗器械有限公司	yang'zhou'yuan'kang'yi'liao'qi'xie'you'xian'gong'si	0
扬州制药有限公司	yang'zhou'zhi'yao'you'xian'gong'si	0
扬子江药业集团有限公司	yang'zi'jiang'yao'ye'ji'tuan'you'xian'gong'si	0
药都制药集团股份有限公司	yao'du'zhi'yao'ji'tuan'gu'fen'you'xian'gong'si	0
腰间盘突出贴	yao'jian'pan'tu'chu'tie	0
腰痛宁胶囊	yao'tong'ning'jiao'nang	0
腰痛片	yao'tong'pian	0
腰腿疼痛贴	yao'tui'teng'tong'tie	0
腰息痛胶囊	yao'xi'tong'jiao'nang	0
药用炭片	yao'yong'tan'pian	0
叶酸片	ye'suan'pian	0
异丙嗪胆汁片	yi'bing'qin'dan'zhi'pian	0
乙醇酒精	yi'chun'jiu'jing	0
乙醇消毒液	yi'chun'xiao'du'ye	0
伊春药业有限公司	yi'chun'yao'ye'you'xian'gong'si	0
一次性使用集尿袋	yi'ci'xing'shi'yong'ji'niao'dai	0
一次性使用口罩	yi'ci'xing'shi'yong'kou'zhao	0
一次性使用乳胶导尿管	yi'ci'xing'shi'yong'ru'jiao'dao'niao'guan	0
一次性使用无菌导尿管	yi'ci'xing'shi'yong'wu'jun'dao'niao'guan	0
一次性使用医用无菌橡胶手套	yi'ci'xing'shi'yong'yi'yong'wu'jun'xiang'jiao'shou'tao	0
依达拉奉注射液	yi'da'la'feng'zhu'she'ye	0
胰岛素注射器	yi'dao'su'zhu'she'qi	0
胰激肽原酶肠溶片	yi'ji'tai'yuan'mei'chang'rong'pian	0
一粒止痛丸	yi'li'zhi'tong'wan	0
益母草颗粒	yi'mu'cao'ke'li	0
益母丸	yi'mu'wan	0
益脑宁片	yi'nao'ning'pian	0
益气养血口服液	yi'qi'yang'xue'kou'fu'ye	0
一清颗粒	yi'qing'ke'li	0
一扫光软膏	yi'sao'guang'ruan'gao	0
益天乐牌钙镁片	yi'tian'le'pai'gai'mei'pian	0
依托红霉素颗粒	yi'tuo'hong'mei'su'ke'li	0
乙酰螺旋霉素片	yi'xian'luo'xuan'mei'su'pian	0
益心通脉颗粒	yi'xin'tong'mai'ke'li	0
抑眩宁胶囊	yi'xuan'ning'jiao'nang	0
异烟肼片	yi'yan'jing'pian	0
异烟肼注射液	yi'yan'jing'zhu'she'ye	0
医用胶带	yi'yong'jiao'dai	0
医用抗菌凝胶	yi'yong'kang'jun'ning'jiao	0
医用棉签	yi'yong'mian'qian	0
医用输液贴	yi'yong'shu'ye'tie	0
医用脱脂绷带	yi'yong'tuo'zhi'beng'dai	0
医用脱脂棉	yi'yong'tuo'zhi'mian	0
医用橡皮膏	yi'yong'xiang'pi'gao	0
医用消毒碘伏	yi'yong'xiao'du'dian'fu	0
医用消毒酒精	yi'yong'xiao'du'jiu'jing	0
一正痛消贴	yi'zheng'tong'xiao'tie	0
吲达帕胺片	yin'da'pa'an'pian	0
阴道冲洗器	yin'dao'chong'xi'qi	0
阴道扩张器	yin'dao'kuo'zhang'qi	0
吲哚美辛肠溶片	yin'duo'mei'xin'chang'rong'pian	0
银花感冒颗粒	yin'hua'gan'mao'ke'li	0
银黄颗粒	yin'huang'ke'li	0
银黄片	yin'huang'pian	0
蚓激酶肠溶胶囊	yin'ji'mei'chang'rong'jiao'nang	0
银翘解毒颗粒	yin'qiao'jie'du'ke'li	0
银翘解毒丸	yin'qiao'jie'du'wan	0
茵山莲颗粒无糖型	yin'shan'lian'ke'li'wu'tang'xing	0
银杏达莫注射液	yin'xing'da'mo'zhu'she'ye	0
银杏酮酯分散片	yin'xing'tong'zhi'fen'san'pian	0
银杏叶分散片	yin'xing'ye'fen'san'pian	0
银杏叶片	yin'xing'ye'pian	0
银杏叶提取物注射液	yin'xing'ye'ti'qu'wu'zhu'she'ye	0
婴儿健脾散	ying'er'jian'pi'san	0
婴儿喂药器	ying'er'wei'yao'qi	0
永康市康飞医疗器械有限公司	yong'kang'shi'kang'fei'yi'liao'qi'xie'you'xian'gong'si	0
右归丸	you'gui'wan	0
优氯净	you'lv'jing	0
优美特制药有限公司	you'mei'te'zhi'yao'you'xian'gong'si	0
右旋酮洛芬氨丁三醇片	you'xuan'tong'luo'fen'an'ding'san'chun'pian	0
愈风宁心片	yu'feng'ning'xin'pian	0
愈美分散片	yu'mei'fen'san'pian	0
愈伤灵胶囊	yu'shang'ling'jiao'nang	0
裕松源药业有限公司	yu'song'yuan'yao'ye'you'xian'gong'si	0
鱼腥草素钠片	yu'xing'cao'su'na'pian	0
玉叶清火片	yu'ye'qing'huo'pian	0
玉簪清咽十五味丸	yu'zan'qing'yan'shi'wu'wei'wan	0
远大医药中国有限公司	yuan'da'yi'yao'zhong'guo'you'xian'gong'si	0
元胡止痛片	yuan'hu'zhi'tong'pian	0
月见草油胶丸	yue'jian'cao'you'jiao'wan	0
越鞠保和丸	yue'ju'bao'he'wan	0
越橘叶黄素软胶囊	yue'ju'ye'huang'su'ruan'jiao'nang	0
悦康药业集团有限公司	yue'kang'yao'ye'ji'tuan'you'xian'gong'si	0
云南白药创可贴	yun'nan'bai'yao'chuang'ke'tie	0
云南白药酊	yun'nan'bai'yao'ding	0
云南白药粉	yun'nan'bai'yao'fen	0
云南白药膏	yun'nan'bai'yao'gao	0
云南白药集团股份有限公司	yun'nan'bai'yao'ji'tuan'gu'fen'you'xian'gong'si	0
云南白药集团丽江药业有限公司	yun'nan'bai'yao'ji'tuan'li'jiang'yao'ye'you'xian'gong'si	0
云南白药集团无锡药业有限公司	yun'nan'bai'yao'ji'tuan'wu'xi'yao'ye'you'xian'gong'si	0
云南白药胶囊	yun'nan'bai'yao'jiao'nang	0
云南白药气雾剂	yun'nan'bai'yao'qi'wu'ji	0
云南滇中药业有限公司	yun'nan'dian'zhong'yao'ye'you'xian'gong'si	0
云南个旧生物药业有限公司	yun'nan'ge'jiu'sheng'wu'yao'ye'you'xian'gong'si	0
云南金碧制药有限公司	yun'nan'jin'bi'zhi'yao'you'xian'gong'si	0
云南金柯制药有限公司	yun'nan'jin'ke'zhi'yao'you'xian'gong'si	0
云南龙海天然植物药业有限公司	yun'nan'long'hai'tian'ran'zhi'wu'yao'ye'you'xian'gong'si	0
云南明镜亨利制药有限公司	yun'nan'ming'jing'heng'li'zhi'yao'you'xian'gong'si	0
云南省曲靖药业有限公司	yun'nan'sheng'qu'jing'yao'ye'you'xian'gong'si	0
云南特安呐制药股份有限公司	yun'nan'te'an'na'zhi'yao'gu'fen'you'xian'gong'si	0
云南永安制药有限公司	yun'nan'yong'an'zhi'yao'you'xian'gong'si	0
云南永孜堂制药有限公司	yun'nan'yong'zi'tang'zhi'yao'you'xian'gong'si	0
云南植物药业有限公司	yun'nan'zhi'wu'yao'ye'you'xian'gong'si	0
枣仁安神颗粒	zao'ren'an'shen'ke'li	0
藻酸双酯钠片	zao'suan'shuang'zhi'na'pian	0
早早孕检测试纸	zao'zao'yun'jian'ce'shi'zhi	0
樟脑水合氯醛酊	zhang'nao'shui'he'lv'quan'ding	0
漳州无极药业有限公司	zhang'zhou'wu'ji'yao'ye'you'xian'gong'si	0
浙江奥瑞特制药有限公司	zhe'jiang'ao'rui'te'zhi'yao'you'xian'gong'si	0
浙江贝得药业有限公司	zhe'jiang'bei'de'yao'ye'you'xian'gong'si	0
浙江诚意药业有限公司	zhe'jiang'cheng'yi'yao'ye'you'xian'gong'si	0
浙江海正药业股份有限公司	zhe'jiang'hai'zheng'yao'ye'gu'fen'you'xian'gong'si	0
浙江康恩贝制药股份有限公司	zhe'jiang'kang'en'bei'zhi'yao'gu'fen'you'xian'gong'si	0
浙江普洛康裕制药有限公司	zhe'jiang'pu'luo'kang'yu'zhi'yao'you'xian'gong'si	0
浙江莎普爱思药业股份有限公司	zhe'jiang'sha'pu'ai'si'yao'ye'gu'fen'you'xian'gong'si	0
浙江泰利森药业有限公司	zhe'jiang'tai'li'sen'yao'ye'you'xian'gong'si	0
浙江万马药业有限公司	zhe'jiang'wan'ma'yao'ye'you'xian'gong'si	0
浙江仙琚制药股份有限公司	zhe'jiang'xian'ju'zhi'yao'gu'fen'you'xian'gong'si	0
浙江亚峰药厂有限公司	zhe'jiang'ya'feng'yao'chang'you'xian'gong'si	0
浙江亚太药业股份有限公司	zhe'jiang'ya'tai'yao'ye'gu'fen'you'xian'gong'si	0
浙江永宁药业股份有限公司	zhe'jiang'yong'ning'yao'ye'gu'fen'you'xian'gong'si	0
珍宝丸	zhen'bao'wan	0
珍菊降压片	zhen'ju'jiang'ya'pian	0
真空拔罐器	zhen'kong'ba'guan'qi	0
镇脑宁胶囊	zhen'nao'ning'jiao'nang	0
珍珠明目滴眼液	zhen'zhu'ming'mu'di'yan'ye	0
正大天晴药业集团股份有限公司	zheng'da'tian'qing'yao'ye'ji'tuan'gu'fen'you'xian'gong'si	0
正骨水	zheng'gu'shui	0
正红花油	zheng'hong'hua'you	0
正天丸	zheng'tian'wan	0
正胃片	zheng'wei'pian	0
郑州博凯医药保健品有限公司	zheng'zhou'bo'kai'yi'yao'bao'jian'pin'you'xian'gong'si	0
郑州瑞康制药有限公司	zheng'zhou'rui'kang'zhi'yao'you'xian'gong'si	0
郑州卓峰制药有限公司	zheng'zhou'zhuo'feng'zhi'yao'you'xian'gong'si	0
知柏地黄丸	zhi'bai'di'huang'wan	0
脂必妥片	zhi'bi'tuo'pian	0
痔疮栓	zhi'chuang'shuan	0
治带片	zhi'dai'pian	0
稚儿灵颗粒	zhi'er'ling'ke'li	0
脂肪乳注射液	zhi'fang'ru'zhu'she'ye	0
痔康乐膏	zhi'kang'le'gao	0
止咳宝片	zhi'ke'bao'pian	0
止咳枇杷颗粒	zhi'ke'pi'pa'ke'li	0
止痢宁片	zhi'li'ning'pian	0
制霉菌素片	zhi'mei'jun'su'pian	0
治偏痛胶囊	zhi'pian'tong'jiao'nang	0
止嗽立效胶囊	zhi'sou'li'xiao'jiao'nang	0
痔速宁片	zhi'su'ning'pian	0
止痛化症胶囊	zhi'tong'hua'zheng'jiao'nang	0
止泻保童颗粒	zhi'xie'bao'tong'ke'li	0
止血灵胶囊	zhi'xue'ling'jiao'nang	0
止血祛瘀明目片	zhi'xue'qu'yu'ming'mu'pian	0
栀子金花丸	zhi'zi'jin'hua'wan	0
重点消痘水	zhong'dian'xiao'dou'shui	0
中风回春胶囊	zhong'feng'hui'chun'jiao'nang	0
中华跌打丸	zhong'hua'die'da'wan	0
中美上海施贵宝在药业有限公司	zhong'mei'shang'hai'shi'gui'bao'zai'yao'ye'you'xian'gong'si	0
中美天津史克制药有限公司	zhong'mei'tian'jin'shi'ke'zhi'yao'you'xian'gong'si	0
中诺药业石家庄有限公司	zhong'nuo'yao'ye'shi'jia'zhuang'you'xian'gong'si	0
中山尼克美制药有限公司	zhong'shan'ni'ke'mei'zhi'yao'you'xian'gong'si	0
中山市恒生药业有限公司	zhong'shan'shi'heng'sheng'yao'ye'you'xian'gong'si	0
珠海博康药业有限公司	zhu'hai'bo'kang'yao'ye'you'xian'gong'si	0
朱砂安神丸	zhu'sha'an'shen'wan	0
注射器	zhu'she'qi	0
注射用阿莫西林钠舒巴坦钠	zhu'she'yong'a'mo'xi'lin'na'shu'ba'tan'na	0
注射用阿奇霉素	zhu'she'yong'a'qi'mei'su	0
注射用阿魏酸钠	zhu'she'yong'a'wei'suan'na	0
注射用阿昔洛韦	zhu'she'yong'a'xi'luo'wei	0
注射用氨曲南	zhu'she'yong'an'qu'nan	0
注射用奥美拉唑钠	zhu'she'yong'ao'mei'la'zuo'na	0
注射用奥扎格雷钠	zhu'she'yong'ao'zha'ge'lei'na	0
注射用长春西汀	zhu'she'yong'chang'chun'xi'ting	0
注射用单磷酸阿糖腺苷	zhu'she'yong'dan'lin'suan'a'tang'xian'gan	0
注射用丹参冻干	zhu'she'yong'dan'shen'dong'gan	0
注射用对氨基水杨酸钠	zhu'she'yong'dui'an'ji'shui'yang'suan'na	0
注射用还原型谷胱甘肽	zhu'she'yong'hai'yuan'xing'gu'guang'gan'tai	0
注射用红花黄色素	zhu'she'yong'hong'hua'huang'se'su	0
注射用甲磺酸培氟沙星	zhu'she'yong'jia'huang'suan'pei'fu'sha'xing	0
注射用甲磺酸左氧氟沙星	zhu'she'yong'jia'huang'suan'zuo'yang'fu'sha'xing	0
注射用酒石酸吉他霉素钠	zhu'she'yong'jiu'shi'suan'ji'ta'mei'su'na	0
注射用克林霉素磷酸钠	zhu'she'yong'ke'lin'mei'su'lin'suan'na	0
注射用克林霉素磷酸酯	zhu'she'yong'ke'lin'mei'su'lin'suan'zhi	0
注射用赖氨匹林	zhu'she'yong'lai'an'pi'lin	0
注射用利福霉素钠	zhu'she'yong'li'fu'mei'su'na	0
注射用链霉素	zhu'she'yong'lian'mei'su	0
注射用亮菌甲素	zhu'she'yong'liang'jun'jia'su	0
注射用磷霉素钠	zhu'she'yong'lin'mei'su'na	0
注射用灭菌用水	zhu'she'yong'mie'jun'yong'shui	0
注射用脑蛋白水解物	zhu'she'yong'nao'dan'bai'shui'jie'wu	0
注射用哌拉西林钠	zhu'she'yong'pai'la'xi'lin'na	0
注射用哌拉西林钠舒巴坦钠	zhu'she'yong'pai'la'xi'lin'na'shu'ba'tan'na	0
注射用泮托拉唑钠	zhu'she'yong'pan'tuo'la'zuo'na	0
注射用七叶皂苷钠	zhu'she'yong'qi'ye'zao'gan'na	0
注射用前列地尔	zhu'she'yong'qian'lie'di'er	0
注射用青霉素钠	zhu'she'yong'qing'mei'su'na	0
注射用乳糖酸阿奇霉素	zhu'she'yong'ru'tang'suan'a'qi'mei'su	0
注射用双黄连冻干	zhu'she'yong'shuang'huang'lian'dong'gan	0
注射用头孢呋辛钠	zhu'she'yong'tou'bao'fu'xin'na	0
注射用头孢米诺钠	zhu'she'yong'tou'bao'mi'nuo'na	0
注射用头孢哌酮钠舒巴坦钠	zhu'she'yong'tou'bao'pai'tong'na'shu'ba'tan'na	0
注射用头孢曲松钠	zhu'she'yong'tou'bao'qu'song'na	0
注射用头孢他啶	zhu'she'yong'tou'bao'ta'ding	0
注射用头孢替唑钠	zhu'she'yong'tou'bao'ti'zuo'na	0
注射用头孢西丁钠	zhu'she'yong'tou'bao'xi'ding'na	0
注射用细辛脑	zhu'she'yong'xi'xin'nao	0
注射用血塞通冻干	zhu'she'yong'xie'sai'tong'dong'gan	0
注射用胸腺五肽	zhu'she'yong'xiong'xian'wu'tai	0
注射用血栓通冻干	zhu'she'yong'xue'shuan'tong'dong'gan	0
注射用炎琥宁	zhu'she'yong'yan'hu'ning	0
注射用盐酸氨溴索	zhu'she'yong'yan'suan'an'xiu'suo	0
注射用盐酸大观霉素	zhu'she'yong'yan'suan'da'guan'mei'su	0
注射用盐酸多西环素	zhu'she'yong'yan'suan'duo'xi'huan'su	0
注射用盐酸头孢吡肟	zhu'she'yong'yan'suan'tou'bao'bi'wo	0
注射用盐酸溴已新	zhu'she'yong'yan'suan'xiu'yi'xin	0
助听器耳背式	zhu'ting'qi'er'bei'shi	0
珠牙蓼止泻颗粒	zhu'ya'liao'zhi'xie'ke'li	0
株洲千金药业股份有限公司	zhu'zhou'qian'jin'yao'ye'gu'fen'you'xian'gong'si	0
珠子肝泰胶囊	zhu'zi'gan'tai'jiao'nang	0
转移因子口服溶液	zhuan'yi'yin'zi'kou'fu'rong'ye	0
壮骨关节丸	zhuang'gu'guan'jie'wan	0
壮腰健肾片	zhuang'yao'jian'shen'pian	0
壮腰健肾丸	zhuang'yao'jian'shen'wan	0
追风透骨丸	zhui'feng'tou'gu'wan	0
自发热鞋垫	zi'fa're'xie'dian	0
紫晶葡萄避孕套	zi'jing'pu'tao'bi'yun'tao	0
紫蔻丸	zi'kou'wan	0
紫外线灯	zi'wai'xian'deng	0
足臭皂	zu'chou'zao	0
足光散	zu'guang'san	0
祖师麻关节止痛膏	zu'shi'ma'guan'jie'zhi'tong'gao	0
族维生素咀嚼片	zu'wei'sheng'su'ju'jue'pian	0
族维生素片	zu'wei'sheng'su'pian	0
族维生素软胶囊维尔健	zu'wei'sheng'su'ruan'jiao'nang'wei'er'jian	0
坐骨神经贴	zuo'gu'shen'jing'tie	0
左归丸	zuo'gui'wan	0
左甲状腺素钠片	zuo'jia'zhuang'xian'su'na'pian	0
左炔诺孕酮片	zuo'que'nuo'yun'tong'pian	0
左炔诺孕酮炔雌醚片	zuo'que'nuo'yun'tong'que'ci'mi'pian	0
