阿柏麻属	a'bai'ma'shu	0
阿米属	a'mi'shu	0
阿魏属	a'wei'shu	0
矮刺苏属	ai'ci'su'shu	0
爱地草属	ai'di'cao'shu	0
艾堇属	ai'jin'shu	0
艾麻属	ai'ma'shu	0
艾纳香属	ai'na'xiang'shu	0
矮伞芹属	ai'san'qin'shu	0
矮生百慕大草	ai'sheng'bai'mu'da'cao	0
矮生高羊茅	ai'sheng'gao'yang'mao	0
矮生美人蕉	ai'sheng'mei'ren'jiao	0
矮泽芹属	ai'ze'qin'shu	0
矮柱兰属	ai'zhu'lan'shu	0
安旱苋属	an'han'xian'shu	0
安兰属	an'lan'shu	0
安龙花属	an'long'hua'shu	0
暗罗属	an'luo'shu	0
安石榴科	an'shi'liu'ke	0
安石榴属	an'shi'liu'shu	0
桉属	an'shu	0
暗叶柳	an'ye'liu	0
桉叶藤属	an'ye'teng'shu	0
凹唇姜属	ao'chun'jiang'shu	0
凹乳芹属	ao'ru'qin'shu	0
凹舌兰属	ao'she'lan'shu	0
澳杨属	ao'yang'shu	0
凹叶厚朴	ao'ye'hou'pu	0
澳洲坚果属	ao'zhou'jian'guo'shu	0
八宝景天	ba'bao'jing'tian	0
巴豆属	ba'dou'shu	0
巴豆藤属	ba'dou'teng'shu	0
巴戟天属	ba'ji'tian'shu	0
芭蕉	ba'jiao	0
八角枫	ba'jiao'feng	0
八角枫科	ba'jiao'feng'ke	0
八角枫属	ba'jiao'feng'shu	0
八角金盘	ba'jiao'jin'pan	0
八角金盘属	ba'jiao'jin'pan'shu	0
芭蕉科	ba'jiao'ke	0
八角科	ba'jiao'ke	0
八角莲属	ba'jiao'lian'shu	0
芭蕉属	ba'jiao'shu	0
八角属	ba'jiao'shu	0
芭蕾舞美人	ba'lei'wu'mei'ren	0
巴拿马草科	ba'na'ma'cao'ke	0
巴拿马草科环花科	ba'na'ma'cao'ke'huan'hua'ke	0
巴拿马草属	ba'na'ma'cao'shu	0
菝葜	ba'qia	0
八蕊花属	ba'rui'hua'shu	0
八仙花	ba'xian'hua	0
八月瓜属	ba'yue'gua'shu	0
白苞芹属	bai'bao'qin'shu	0
白茶树属	bai'cha'shu'shu	0
白刺	bai'ci	0
白刺菊属	bai'ci'ju'shu	0
白刺属	bai'ci'shu	0
白点兰属	bai'dian'lan'shu	0
白蝶兰属	bai'die'lan'shu	0
白丁香	bai'ding'xiang	0
白豆杉属	bai'dou'shan'shu	0
白饭树属	bai'fan'shu'shu	0
白粉藤属	bai'fen'teng'shu	0
白鼓丁属	bai'gu'ding'shu	0
百合科	bai'he'ke	0
白鹤灵芝属	bai'he'ling'zhi'shu	0
百合属	bai'he'shu	0
白鹤藤属	bai'he'teng'shu	0
白桦	bai'hua	0
白花菜科	bai'hua'cai'ke	0
白花菜属	bai'hua'cai'shu	0
百花蒿属	bai'hua'hao'shu	0
白花苋属	bai'hua'xian'shu	0
白芨	bai'ji	0
白及属	bai'ji'shu	0
败酱科	bai'jiang'ke	0
败酱属	bai'jiang'shu	0
白接骨属	bai'jie'gu'shu	0
百金花属	bai'jin'hua'shu	0
稗荩属	bai'jin'shu	0
白菊木属	bai'ju'mu'shu	0
白鹃梅属	bai'juan'mei'shu	0
柏科	bai'ke	0
白蜡	bai'la	0
柏拉木属	bai'la'mu'shu	0
白腊树	bai'la'shu	0
白蜡树属	bai'la'shu'shu	0
柏蕾荠属	bai'lei'ji'shu	0
百里香	bai'li'xiang	0
百里香属	bai'li'xiang'shu	0
白蔹	bai'lian	0
白灵菇	bai'ling'gu	0
白麻属	bai'ma'shu	0
百脉根属	bai'mai'gen'shu	0
白茅属	bai'mao'shu	0
百慕大草	bai'mu'da'cao	0
柏木属	bai'mu'shu	0
白牛子	bai'niu'zi	0
白皮松	bai'pi'song	0
白杞柳	bai'qi'liu	0
白千层属	bai'qian'ceng'shu	0
白杄云杉	bai'qian'yun'shan	0
白屈莱属	bai'qu'lai'shu	0
百日菊属	bai'ri'ju'shu	0
百蕊草属	bai'rui'cao'shu	0
白三叶草	bai'san'ye'cao	0
稗属	bai'shu	0
白树属	bai'shu'shu	0
白丝草属	bai'si'cao'shu	0
白穗花属	bai'sui'hua'shu	0
白檀山矾	bai'tan'shan'fan	0
白桐树属	bai'tong'shu'shu	0
白头翁属	bai'tou'weng'shu	0
白鲜属	bai'xian'shu	0
白颜树属	bai'yan'shu'shu	0
白叶藤属	bai'ye'teng'shu	0
白榆	bai'yu	0
白玉兰	bai'yu'lan	0
白玉簪	bai'yu'zan	0
白珠树属	bai'zhu'shu'shu	0
百子莲属	bai'zi'lian'shu	0
半边莲科	ban'bian'lian'ke	0
半边莲属	ban'bian'lian'shu	0
半枫荷属	ban'feng'he'shu	0
绊根草	ban'gen'cao	0
半脊荠属	ban'ji'ji'shu	0
斑鸠菊属	ban'jiu'ju'shu	0
板蓝属	ban'lan'shu	0
板栗	ban'li	0
瓣鳞花科	ban'lin'hua'ke	0
瓣鳞花属	ban'lin'hua'shu	0
斑龙芋属	ban'long'yu'shu	0
斑膜芹属	ban'mo'qin'shu	0
半日花科	ban'ri'hua'ke	0
半日花属	ban'ri'hua'shu	0
半蒴苣苔属	ban'shuo'ju'tai'shu	0
半夏属	ban'xia'shu	0
斑叶兰属	ban'ye'lan'shu	0
斑枝卫矛	ban'zhi'wei'mao	0
斑种草属	ban'zhong'cao'shu	0
半柱花属	ban'zhu'hua'shu	0
斑籽属	ban'zi'shu	0
棒柄花属	bang'bing'hua'shu	0
棒锤瓜属	bang'chui'gua'shu	0
棒瓜属	bang'gua'shu	0
棒果芥属	bang'guo'jie'shu	0
棒头草属	bang'tou'cao'shu	0
报春花科	bao'chun'hua'ke	0
报春花属	bao'chun'hua'shu	0
报春苣苔属	bao'chun'ju'tai'shu	0
报春茜属	bao'chun'qian'shu	0
苞护豆属	bao'hu'dou'shu	0
枹栎	bao'li	0
苞藜属	bao'li'shu	0
苞裂芹属	bao'lie'qin'shu	0
暴马子	bao'ma'zi	0
苞茅属	bao'mao'shu	0
刨木	bao'mu	0
豹皮花属	bao'pi'hua'shu	0
苞舌兰属	bao'she'lan'shu	0
保亭花属	bao'ting'hua'shu	0
苞叶兰属	bao'ye'lan'shu	0
苞叶木属	bao'ye'mu'shu	0
苞叶藤属	bao'ye'teng'shu	0
豹子花属	bao'zi'hua'shu	0
杯冠木属	bei'guan'mu'shu	0
北海道黄杨	bei'hai'dao'huang'yang	0
北极花属	bei'ji'hua'shu	0
北京丁香	bei'jing'ding'xiang	0
北京桧柏	bei'jing'gui'bai	0
北京桧柏球	bei'jing'gui'bai'qiu	0
北京山梅花	bei'jing'shan'mei'hua	0
北京杨	bei'jing'yang	0
被菊属	bei'ju'shu	0
杯菊属	bei'ju'shu	0
贝壳杉属	bei'ke'shan'shu	0
北美海棠系列	bei'mei'hai'tang'xi'lie	0
北美红杉属	bei'mei'hong'shan'shu	0
贝母兰属	bei'mu'lan'shu	0
贝母属	bei'mu'shu	0
倍蕊苔属	bei'rui'tai'shu	0
杯苋属	bei'xian'shu	0
被子植物	bei'zi'zhi'wu	0
本特一号草	ben'te'yi'hao'cao	0
荸艾属	bi'ai'shu	0
笔花豆属	bi'hua'dou'shu	0
闭花木属	bi'hua'mu'shu	0
薜荔	bi'li	0
蓖麻属	bi'ma'shu	0
荸荠	bi'qi	0
荸荠属	bi'qi'shu	0
闭鞘姜属	bi'qiao'jiang'shu	0
碧桃	bi'tao	0
臂形草属	bi'xing'cao'shu	0
扁柏属	bian'bai'shu	0
扁柄草属	bian'bing'cao'shu	0
扁担杆属	bian'dan'gan'shu	0
扁担格子	bian'dan'ge'zi	0
变豆菜属	bian'dou'cai'shu	0
藊豆属	bian'dou'shu	0
蝙蝠草属	bian'fu'cao'shu	0
蝙蝠葛属	bian'fu'ge'shu	0
扁果草属	bian'guo'cao'shu	0
扁果藤属	bian'guo'teng'shu	0
扁核木属	bian'he'mu'shu	0
扁蕾属	bian'lei'shu	0
扁芒草属	bian'mang'cao'shu	0
扁芒菊属	bian'mang'ju'shu	0
扁蒴苣苔属	bian'shuo'ju'tai'shu	0
扁蒴藤属	bian'shuo'teng'shu	0
扁穗草属	bian'sui'cao'shu	0
扁穗莞属	bian'sui'guan'shu	0
扁莎草属	bian'suo'cao'shu	0
鞭藤科	bian'teng'ke	0
鞭藤属	bian'teng'shu	0
变叶木属	bian'ye'mu'shu	0
扁轴木属	bian'zhou'mu'shu	0
藨草属	biao'cao'shu	0
鳔冠花属	biao'guan'hua'shu	0
藨寄生属	biao'ji'sheng'shu	0
杓兰属	biao'lan'shu	0
滨菊属	bin'ju'shu	0
滨藜属	bin'li'shu	0
滨木患属	bin'mu'huan'shu	0
滨紫草属	bin'zi'cao'shu	0
冰草属	bing'cao'shu	0
柄翅果属	bing'chi'guo'shu	0
柄唇兰属	bing'chun'lan'shu	0
冰岛蓼属	bing'dao'liao'shu	0
兵豆属	bing'dou'shu	0
冰防风属	bing'fang'feng'shu	0
柄果木属	bing'guo'mu'shu	0
槟榔青属	bing'lang'qing'shu	0
槟榔属	bing'lang'shu	0
菠菜属	bo'cai'shu	0
薄稃草属	bo'fu'cao'shu	0
驳骨草属	bo'gu'cao'shu	0
薄果草属	bo'guo'cao'shu	0
薄果荠属	bo'guo'ji'shu	0
薄荷属	bo'he'shu	0
薄核藤属	bo'he'teng'shu	0
伯乐树科	bo'le'shu'ke	0
伯乐树属	bo'le'shu'shu	0
波棱瓜属	bo'leng'gua'shu	0
玻璃苣属	bo'li'ju'shu	0
薄鳞菊属	bo'lin'ju'shu	0
博落回属	bo'luo'hui'shu	0
薄毛绣线菊	bo'mao'xiu'xian'ju	0
播娘蒿属	bo'niang'hao'shu	0
波漆属	bo'qi'shu	0
薄壳山核桃	bo'qiao'shan'he'tao	0
薄蒴草属	bo'shuo'cao'shu	0
波喜荡草科	bo'xi'dang'cao'ke	0
波喜荡草属	bo'xi'dang'cao'shu	0
波叶忍冬	bo'ye'ren'dong	0
薄钟花属	bo'zhong'hua'shu	0
薄柱草属	bo'zhu'cao'shu	0
薄竹属	bo'zhu'shu	0
捕虫堇属	bu'chong'jin'shu	0
布袋兰属	bu'dai'lan'shu	0
补骨脂属	bu'gu'zhi'shu	0
哺鸡竹	bu'ji'zhu	0
补血草属	bu'xue'cao'shu	0
布渣叶属	bu'zha'ye'shu	0
菜豆属	cai'dou'shu	0
菜豆树属	cai'dou'shu'shu	0
彩花菰属	cai'hua'gu'shu	0
菜蓟属	cai'ji'shu	0
采木属	cai'mu'shu	0
彩叶花木类	cai'ye'hua'mu'lei	0
蚕豆属	can'dou'shu	0
藏百合属	cang'bai'he'shu	0
藏豆属	cang'dou'shu	0
苍耳属	cang'er'shu	0
藏瓜属	cang'gua'shu	0
藏花忍冬	cang'hua'ren'dong	0
藏荠属	cang'ji'shu	0
藏芥属	cang'jie'shu	0
藏菊属	cang'ju'shu	0
藏榄属	cang'lan'shu	0
藏瓦莲属	cang'wa'lian'shu	0
苍术属	cang'zhu'shu	0
糙草属	cao'cao'shu	0
草苁蓉属	cao'cong'rong'shu	0
草菇	cao'gu	0
草海桐科	cao'hai'tong'ke	0
草海桐属	cao'hai'tong'shu	0
草胡椒属	cao'hu'jiao'shu	0
草莓果冻海棠	cao'mei'guo'dong'hai'tang	0
草莓属	cao'mei'shu	0
草棉属	cao'mian'shu	0
草木犀属	cao'mu'xi'shu	0
草沙蚕属	cao'sha'can'shu	0
草珊瑚属	cao'shan'hu'shu	0
槽舌兰属	cao'she'lan'shu	0
糙苏属	cao'su'shu	0
草绣球属	cao'xiu'qiu'shu	0
糙叶树属	cao'ye'shu'shu	0
草茱萸属	cao'zhu'yu'shu	0
侧柏	ce'bai	0
侧柏属	ce'bai'shu	0
侧金盏花属	ce'jin'zhan'hua'shu	0
侧蕊属	ce'rui'shu	0
箣柊属	ce'zhong'shu	0
箣竹属	ce'zhu'shu	0
茶藨子属	cha'biao'zi'shu	0
茶秆竹属	cha'gan'zhu'shu	0
叉喙兰属	cha'hui'lan'shu	0
茶科	cha'ke	0
茶梨属	cha'li'shu	0
茶菱属	cha'ling'shu	0
茶鹿子科	cha'lu'zi'ke	0
叉毛蓬属	cha'mao'peng'shu	0
茶梅	cha'mei	0
檫木属	cha'mu'shu	0
茶属	cha'shu	0
茶条木属	cha'tiao'mu'shu	0
茶条槭	cha'tiao'qi	0
茶新菇	cha'xin'gu	0
叉序草属	cha'xu'cao'shu	0
叉叶蓝属	cha'ye'lan'shu	0
叉柱花属	cha'zhu'hua'shu	0
叉柱兰属	cha'zhu'lan'shu	0
茶茱萸科	cha'zhu'yu'ke	0
柴胡属	chai'hu'shu	0
柴龙树属	chai'long'shu'shu	0
钗子股属	chai'zi'gu'shu	0
蝉翼藤属	chan'yi'teng'shu	0
长白茶藨子	chang'bai'cha'biao'zi	0
长白落叶松	chang'bai'luo'ye'song	0
长白忍冬	chang'bai'ren'dong	0
长柄侧耳	chang'bing'ce'er	0
长柄荚属	chang'bing'jia'shu	0
长柄芥属	chang'bing'jie'shu	0
长柄山蚂蝗属	chang'bing'shan'ma'huang'shu	0
长春花属	chang'chun'hua'shu	0
常春木属	chang'chun'mu'shu	0
常春藤	chang'chun'teng	0
常春藤属	chang'chun'teng'shu	0
长隔木属	chang'ge'mu'shu	0
长梗郁李	chang'geng'yu'li	0
长冠苣苔属	chang'guan'ju'tai'shu	0
长果姜属	chang'guo'jiang'shu	0
长喙兰属	chang'hui'lan'shu	0
长节珠属	chang'jie'zhu'shu	0
常绿类	chang'lv'lei	0
菖蒲属	chang'pu'shu	0
长蕊琉璃草属	chang'rui'liu'li'cao'shu	0
长蕊木兰属	chang'rui'mu'lan'shu	0
长蕊青兰属	chang'rui'qing'lan'shu	0
常山属	chang'shan'shu	0
长舌蓍属	chang'she'shi'shu	0
长生草属	chang'sheng'cao'shu	0
长蒴苣苔属	chang'shuo'ju'tai'shu	0
长穗花属	chang'sui'hua'shu	0
长穗马蓝属	chang'sui'ma'lan'shu	0
常夏石竹	chang'xia'shi'zhu	0
肠须草属	chang'xu'cao'shu	0
长柱琉璃草属	chang'zhu'liu'li'cao'shu	0
长柱山丹属	chang'zhu'shan'dan'shu	0
长足兰属	chang'zu'lan'shu	0
朝鲜丁香	chao'xian'ding'xiang	0
朝鲜黄杨	chao'xian'huang'yang	0
朝鲜柳	chao'xian'liu	0
朝鲜山茱萸	chao'xian'shan'zhu'yu	0
朝鲜鼠李	chao'xian'shu'li	0
朝鲜鱼鳞松	chao'xian'yu'lin'song	0
朝鲜越桔	chao'xian'yue'ju	0
朝鲜栀子花	chao'xian'zhi'zi'hua	0
车梁木	che'liang'mu	0
车前草科	che'qian'cao'ke	0
车前草属	che'qian'cao'shu	0
车前紫草属	che'qian'zi'cao'shu	0
车叶草属	che'ye'cao'shu	0
车轴草属	che'zhou'cao'shu	0
沉香属	chen'xiang'shu	0
秤钩风属	cheng'gou'feng'shu	0
澄广花属	cheng'guang'hua'shu	0
柽柳	cheng'liu	0
柽柳科	cheng'liu'ke	0
柽柳属	cheng'liu'shu	0
赪桐属	cheng'tong'shu	0
赤壁草属	chi'bi'cao'shu	0
赤瓟属	chi'bo'shu	0
赤才属	chi'cai'shu	0
赤苍藤属	chi'cang'teng'shu	0
赤车属	chi'che'shu	0
齿唇兰属	chi'chun'lan'shu	0
匙唇兰属	chi'chun'lan'shu	0
翅春榆	chi'chun'yu	0
齿稃草属	chi'fu'cao'shu	0
匙羹藤属	chi'geng'teng'shu	0
齿冠草属	chi'guan'cao'shu	0
齿果草属	chi'guo'cao'shu	0
翅果蓼属	chi'guo'liao'shu	0
翅果麻属	chi'guo'ma'shu	0
翅果藤属	chi'guo'teng'shu	0
翅鹤虱属	chi'he'shi'shu	0
匙荠属	chi'ji'shu	0
翅荚木属	chi'jia'mu'shu	0
赤箭莎属	chi'jian'sha'shu	0
翅棱芹属	chi'leng'qin'shu	0
齿鳞草属	chi'lin'cao'shu	0
翅鳞莎属	chi'lin'sha'shu	0
池杉	chi'shan	0
翅实藤属	chi'shi'teng'shu	0
赤松	chi'song	0
赤杨	chi'yang	0
赤杨属	chi'yang'shu	0
匙叶草属	chi'ye'cao'shu	0
翅叶木属	chi'ye'mu'shu	0
翅子瓜属	chi'zi'gua'shu	0
翅子藤科	chi'zi'teng'ke	0
翅子藤属	chi'zi'teng'shu	0
虫豆属	chong'dou'shu	0
重楼属	chong'lou'shu	0
虫实属	chong'shi'shu	0
重阳木	chong'yang'mu	0
重阳木属	chong'yang'mu'shu	0
臭草属	chou'cao'shu	0
臭常山属	chou'chang'shan'shu	0
臭椿	chou'chun	0
稠李	chou'li	0
臭松	chou'song	0
臭松属	chou'song'shu	0
臭樱属	chou'ying'shu	0
雏菊属	chu'ju'shu	0
楮树	chu'shu	0
船唇兰属	chuan'chun'lan'shu	0
串果藤属	chuan'guo'teng'shu	0
川蔓藻科	chuan'man'zao'ke	0
川蔓藻属	chuan'man'zao'shu	0
川明参属	chuan'ming'can'shu	0
川木香属	chuan'mu'xiang'shu	0
穿鞘花属	chuan'qiao'hua'shu	0
川苔草科	chuan'tai'cao'ke	0
川苔草属	chuan'tai'cao'shu	0
穿心草属	chuan'xin'cao'shu	0
穿心莲属	chuan'xin'lian'shu	0
川续断科	chuan'xu'duan'ke	0
川续断属	chuan'xu'duan'shu	0
川藻属	chuan'zao'shu	0
槌果藤属	chui'guo'teng'shu	0
垂柳	chui'liu	0
垂丝海棠	chui'si'hai'tang	0
垂头菊属	chui'tou'ju'shu	0
垂枝梅	chui'zhi'mei	0
垂枝桃	chui'zhi'tao	0
垂枝榆	chui'zhi'yu	0
槌柱兰属	chui'zhu'lan'shu	0
莼菜	chun'cai	0
莼菜科	chun'cai'ke	0
莼菜属	chun'cai'shu	0
唇萼苣苔属	chun'e'ju'tai'shu	0
春黄菊属	chun'huang'ju'shu	0
春鹃	chun'juan	0
唇兰属	chun'lan'shu	0
唇形科	chun'xing'ke	0
春雪海棠	chun'xue'hai'tang	0
春榆	chun'yu	0
唇柱苣苔属	chun'zhu'ju'tai'shu	0
刺柏球	ci'bai'qiu	0
刺柏属	ci'bai'shu	0
刺苞果属	ci'bao'guo'shu	0
刺苞术属	ci'bao'shu'shu	0
刺儿菜属	ci'er'cai'shu	0
慈姑	ci'gu	0
慈姑属	ci'gu'shu	0
刺冠菊属	ci'guan'ju'shu	0
刺果茶藨子	ci'guo'cha'biao'zi	0
刺果芹属	ci'guo'qin'shu	0
刺果树属	ci'guo'shu'shu	0
刺核藤属	ci'he'teng'shu	0
刺槐	ci'huai	0
刺槐属	ci'huai'shu	0
刺矶松属	ci'ji'song'shu	0
刺葵属	ci'kui'shu	0
刺榄属	ci'lan'shu	0
刺篱木属	ci'li'mu'shu	0
刺鳞草科	ci'lin'cao'ke	0
刺鳞草属	ci'lin'cao'shu	0
刺龙牙	ci'long'ya	0
刺锚草属	ci'mao'cao'shu	0
刺茉莉科	ci'mo'li'ke	0
刺茉莉属	ci'mo'li'shu	0
刺芹属	ci'qin'shu	0
刺楸	ci'qiu	0
刺楸属	ci'qiu'shu	0
刺蕊草属	ci'rui'cao'shu	0
刺蒴麻属	ci'shuo'ma'shu	0
刺桐属	ci'tong'shu	0
刺头菊属	ci'tou'ju'shu	0
刺五加	ci'wu'jia	0
慈孝竹	ci'xiao'zhu	0
刺续断属	ci'xu'duan'shu	0
刺叶南蛇藤	ci'ye'nan'she'teng	0
刺叶属	ci'ye'shu	0
刺罂粟属	ci'ying'su'shu	0
刺榆	ci'yu	0
刺芋属	ci'yu'shu	0
刺榆属	ci'yu'shu	0
茨藻科	ci'zao'ke	0
茨藻属	ci'zao'shu	0
刺枝豆属	ci'zhi'dou'shu	0
刺子莞属	ci'zi'guan'shu	0
丛菔属	cong'fu'shu	0
葱芥属	cong'jie'shu	0
葱兰	cong'lan	0
楤木属	cong'mu'shu	0
丛生福禄考	cong'sheng'fu'lu'kao	0
葱属	cong'shu	0
葱叶兰属	cong'ye'lan'shu	0
簇花芹属	cu'hua'qin'shu	0
簇芥属	cu'jie'shu	0
簇毛槭	cu'mao'qi	0
粗毛藤属	cu'mao'teng'shu	0
粗丝木属	cu'si'mu'shu	0
簇序草属	cu'xu'cao'shu	0
粗叶木属	cu'ye'mu'shu	0
翠柏	cui'bai	0
翠柏球	cui'bai'qiu	0
翠柏属	cui'bai'shu	0
翠菊属	cui'ju'shu	0
脆兰属	cui'lan'shu	0
翠雀属	cui'que'shu	0
大百合属	da'bai'he'shu	0
大白柳	da'bai'liu	0
大苞寄生属	da'bao'ji'sheng'shu	0
大苞姜属	da'bao'jiang'shu	0
大苞兰属	da'bao'lan'shu	0
大苞鞘花属	da'bao'qiao'hua'shu	0
大参属	da'can'shu	0
大翅蓟属	da'chi'ji'shu	0
大翅卫矛	da'chi'wei'mao	0
大丁草属	da'ding'cao'shu	0
大豆蔻属	da'dou'kou'shu	0
大豆属	da'dou'shu	0
大萼葵属	da'e'kui'shu	0
大风子科	da'feng'zi'ke	0
大风子属	da'feng'zi'shu	0
大果五加属	da'guo'wu'jia'shu	0
大合欢属	da'he'huan'shu	0
大胡椒属	da'hu'jiao'shu	0
大花草科	da'hua'cao'ke	0
大花秋葵	da'hua'qiu'kui	0
大花溲疏	da'hua'sou'shu	0
大花藤属	da'hua'teng'shu	0
大花萱草	da'hua'xuan'cao	0
大花月季	da'hua'yue'ji	0
大花醉鱼草	da'hua'zui'yu'cao	0
大黄柳	da'huang'liu	0
大黄属	da'huang'shu	0
大戟科	da'ji'ke	0
大戟属	da'ji'shu	0
大节竹属	da'jie'zhu'shu	0
大丽花属	da'li'hua'shu	0
大麻科	da'ma'ke	0
大麻属	da'ma'shu	0
大麦属	da'mai'shu	0
大米草属	da'mi'cao'shu	0
大漂属	da'piao'shu	0
大青杨	da'qing'yang	0
大沙叶属	da'sha'ye'shu	0
大山樱花	da'shan'ying'hua	0
大蒜芥属	da'suan'jie'shu	0
大头茶属	da'tou'cha'shu	0
打碗花属	da'wan'hua'shu	0
大吴风草	da'wu'feng'cao	0
大吴风草属	da'wu'feng'cao'shu	0
大血藤科	da'xue'teng'ke	0
大血藤属	da'xue'teng'shu	0
大叶垂榆	da'ye'chui'yu	0
大叶海菜花	da'ye'hai'cai'hua	0
大叶槲栎	da'ye'hu'li	0
大叶华北绣线菊	da'ye'hua'bei'xiu'xian'ju	0
大叶黄杨	da'ye'huang'yang	0
大叶黄杨球	da'ye'huang'yang'qiu	0
大叶朴	da'ye'pu	0
大叶鼠李	da'ye'shu'li	0
大叶藤属	da'ye'teng'shu	0
大叶小檗	da'ye'xiao'bo	0
大叶藻科	da'ye'zao'ke	0
大叶藻属	da'ye'zao'shu	0
大叶钻天杨	da'ye'zuan'tian'yang	0
大叶柞	da'ye'zuo	0
大油芒属	da'you'mang'shu	0
大枣	da'zao	0
大爪草属	da'zhao'cao'shu	0
大钟花属	da'zhong'hua'shu	0
大柱藤属	da'zhu'teng'shu	0
大字香	da'zi'xiang	0
袋唇兰属	dai'chun'lan'shu	0
带唇兰属	dai'chun'lan'shu	0
代儿茶属	dai'er'cha'shu	0
戴星草属	dai'xing'cao'shu	0
带叶兰属	dai'ye'lan'shu	0
单瓣茶花	dan'ban'cha'hua	0
单瓣红花油茶花	dan'ban'hong'hua'you'cha'hua	0
单侧花属	dan'ce'hua'shu	0
单刺蓬属	dan'ci'peng'shu	0
丹桂	dan'gui	0
萏雷草属	dan'lei'cao'shu	0
丹麦草	dan'mai'cao	0
单球芹属	dan'qiu'qin'shu	0
单蕊草属	dan'rui'cao'shu	0
单蕊麻属	dan'rui'ma'shu	0
单室茱萸属	dan'shi'zhu'yu'shu	0
单性木兰属	dan'xing'mu'lan'shu	0
单叶豆属	dan'ye'dou'shu	0
单叶藤桔属	dan'ye'teng'ju'shu	0
淡竹	dan'zhu	0
淡竹叶属	dan'zhu'ye'shu	0
当归属	dang'gui'shu	0
党参属	dang'shen'shu	0
稻槎菜属	dao'cha'cai'shu	0
倒地铃属	dao'di'ling'shu	0
倒吊笔属	dao'diao'bi'shu	0
刀豆属	dao'dou'shu	0
倒挂金钟属	dao'gua'jin'zhong'shu	0
稻属	dao'shu	0
倒提壶属	dao'ti'hu'shu	0
倒缨木属	dao'ying'mu'shu	0
德国景天	de'guo'jing'tian	0
德国鸢尾	de'guo'yuan'wei	0
灯台树	deng'tai'shu	0
灯心草	deng'xin'cao	0
灯心草科	deng'xin'cao'ke	0
灯心草属	deng'xin'cao'shu	0
地宝兰属	di'bao'lan'shu	0
地被菊	di'bei'ju	0
地胆草属	di'dan'cao'shu	0
地肤属	di'fu'shu	0
地构叶属	di'gou'ye'shu	0
地桂属	di'gui'shu	0
地黄连属	di'huang'lian'zhu	0
第伦桃科	di'lun'tao'ke	0
第伦桃科五丫果科	di'lun'tao'ke'wu'ya'guo'ke	0
第伦桃属	di'lun'tao'shu	0
地蔷薇属	di'qiang'wei'shu	0
地笋属	di'sun'shu	0
地毯草属	di'tan'cao'shu	0
棣棠	di'tang	0
棣棠花	di'tang'hua	0
棣棠属	di'tang'shu	0
地杨梅属	di'yang'mei'shu	0
地杨桃属	di'yang'tao'shu	0
地涌金莲属	di'yong'jin'lian'shu	0
地榆属	di'yu'shu	0
点柄粘盖牛肝菌	dian'bing'zhan'gai'niu'gan'jun	0
滇赤才属	dian'chi'cai'shu	0
电灯花属	dian'deng'hua'shu	0
点地梅属	dian'di'mei'shu	0
滇丁香属	dian'ding'xiang'shu	0
滇黄芩属	dian'huang'qin'shu	0
滇兰属	dian'lan'shu	0
滇芹属	dian'qin'shu	0
滇桐属	dian'tong'shu	0
滇芎属	dian'xiong'shu	0
滇竹属	dian'zhu'shu	0
垫紫草属	dian'zi'cao'shu	0
滇紫草属	dian'zi'cao'shu	0
吊灯花属	diao'deng'hua'shu	0
吊灯树属	diao'deng'shu'shu	0
吊兰属	diao'lan'shu	0
吊石苣苔属	diao'shi'ju'tai'shu	0
凋缨菊属	diao'ying'ju'shu	0
吊钟花属	diao'zhong'hua'shu	0
蝶豆属	die'dou'shu	0
蝶兰属	die'lan'shu	0
蝶形花科	die'xing'hua'ke	0
蝶须属	die'xu'shu	0
顶冰花属	ding'bing'hua'shu	0
丁公藤属	ding'gong'teng'shu	0
丁癸草属	ding'gui'cao'shu	0
顶果树属	ding'guo'shu'shu	0
丁茜属	ding'qian'shu	0
钉头果属	ding'tou'guo'shu	0
丁香	ding'xiang	0
丁香蓼属	ding'xiang'liao'shu	0
丁香属	ding'xiang'shu	0
顶羽菊属	ding'yu'ju'shu	0
丁座草属	ding'zuo'cao'shu	0
东北扁核木	dong'bei'bian'he'mu	0
东北茶藨子	dong'bei'cha'biao'zi	0
东北刺人参	dong'bei'ci'ren'can	0
东北接骨木	dong'bei'jie'gu'mu	0
东北雷公藤	dong'bei'lei'gong'teng	0
东北连翘	dong'bei'lian'qiao	0
东北木蓼	dong'bei'mu'liao	0
东北山梅花	dong'bei'shan'mei'hua	0
东北鼠李	dong'bei'shu'li	0
东北溲疏	dong'bei'sou'shu	0
东北杏	dong'bei'xing	0
东北柞	dong'bei'zuo	0
东风菜属	dong'feng'cai'shu	0
东谷芹属	dong'gu'qin'shu	0
冬瓜属	dong'gua'shu	0
冬红花属	dong'hong'hua'shu	0
东京桐属	dong'jing'tong'shu	0
冬麻豆属	dong'ma'dou'shu	0
冬青科	dong'qing'ke	0
冬青属	dong'qing'shu	0
动蕊花属	dong'rui'hua'shu	0
苳叶科	dong'ye'ke	0
苳叶属	dong'ye'shu	0
东爪草属	dong'zhao'cao'shu	0
豆瓣菜属	dou'ban'cai'shu	0
兜被兰属	dou'bei'lan'shu	0
豆腐柴属	dou'fu'chai'shu	0
豆科	dou'ke	0
豆蔻属	dou'kou'shu	0
兜兰属	dou'lan'shu	0
都丽菊属	dou'li'ju'shu	0
兜藜属	dou'li'shu	0
豆列当属	dou'lie'dang'shu	0
兜蕊兰属	dou'rui'lan'shu	0
豆薯属	dou'shu'shu	0
毒参属	du'can'shu	0
毒豆属	du'dou'shu	0
杜根藤属	du'gen'teng'shu	0
毒瓜属	du'gua'shu	0
独花报春属	du'hua'bao'chun'shu	0
独花兰属	du'hua'lan'shu	0
独活属	du'huo'shu	0
杜茎山属	du'jing'shan'shu	0
杜鹃花科	du'juan'hua'ke	0
杜鹃花属	du'juan'hua'shu	0
杜鹃兰属	du'juan'lan'shu	0
杜梨	du'li	0
独丽花属	du'li'hua'shu	0
杜楝属	du'lian'shu	0
度量草属	du'liang'cao'shu	0
毒马草属	du'ma'cao'shu	0
毒麦属	du'mai'shu	0
毒芹属	du'qin'shu	0
杜若属	du'ruo'shu	0
毒鼠子科	du'shu'zi'ke	0
毒鼠子属	du'shu'zi'shu	0
杜松	du'song	0
独蒜兰属	du'suan'lan'shu	0
独尾草属	du'wei'cao'shu	0
独行菜属	du'xing'cai'shu	0
独叶草属	du'ye'cao'shu	0
独一味属	du'yi'wei'shu	0
杜英	du'ying	0
杜英科	du'ying'ke	0
杜英属	du'ying'shu	0
杜仲	du'zhong	0
杜仲科	du'zhong'ke	0
杜仲属	du'zhong'shu	0
杜仲藤属	du'zhong'teng'shu	0
独子藤属	du'zi'teng'shu	0
短瓣兰属	duan'ban'lan'shu	0
短瓣石竹属	duan'ban'shi'zhu'shu	0
短柄草属	duan'bing'cao'shu	0
短萼齿木属	duan'e'chi'mu'shu	0
断节莎草属	duan'jie'suo'cao'shu	0
短舌菊属	duan'she'ju'shu	0
椴树科	duan'shu'ke	0
椴树属	duan'shu'shu	0
短穗竹属	duan'sui'zhu'shu	0
短筒苣苔属	duan'tong'ju'tai'shu	0
短星菊属	duan'xing'ju'shu	0
短序胡枝子	duan'xu'hu'zhi'zi	0
短序花属	duan'xu'hua'shu	0
短檐苣苔属	duan'yan'ju'tai'shu	0
短颖草属	duan'ying'cao'shu	0
对刺藤属	dui'ci'teng'shu	0
对节刺属	dui'jie'ci'shu	0
对穗草属	dui'sui'cao'shu	0
堆心菊属	dui'xin'ju'shu	0
对叶兰属	dui'ye'lan'shu	0
对叶盐蓬属	dui'ye'yan'peng'shu	0
盾苞藤属	dun'bao'teng'shu	0
钝背草属	dun'bei'cao'shu	0
盾翅果属	dun'chi'guo'shu	0
盾果草属	dun'guo'cao'shu	0
钝果寄生属	dun'guo'ji'sheng'shu	0
钝叶草属	dun'ye'cao'shu	0
盾柱木属	dun'zhu'mu'shu	0
盾柱卫矛属	dun'zhu'wei'mao'shu	0
盾座苣苔属	dun'zuo'ju'tai'shu	0
多瓣核果茶属	duo'ban'he'guo'cha'shu	0
多核果属	duo'he'guo'shu	0
多花胡枝子	duo'hua'hu'zhi'zi	0
多荚草属	duo'jia'cao'shu	0
多榔菊属	duo'lang'ju'shu	0
多蕊木属	duo'rui'mu'shu	0
多穗兰属	duo'sui'lan'shu	0
多香木属	duo'xiang'mu'shu	0
多裔黍属	duo'yi'shu'shu	0
多枝苦荬菜属	duo'zhi'ku'mai'cai'shu	0
鹅不食草属	e'bu'shi'cao'shu	0
峨参属	e'can'shu	0
鹅肠菜属	e'chang'cai'shu	0
鹅耳枥	e'er'li	0
鹅耳枥属	e'er'li'shu	0
鹅观草属	e'guan'cao'shu	0
萼距花属	e'ju'hua'shu	0
鳄咀花属	e'ju'hua'shu	0
遏蓝菜属	e'lan'cai'shu	0
鳄梨属	e'li'shu	0
鹅绒藤属	e'rong'teng'shu	0
鹅掌柴属	e'zhang'chai'shu	0
鹅掌楸	e'zhang'qiu	0
鹅掌楸属	e'zhang'qiu'shu	0
耳草属	er'cao'shu	0
耳唇兰属	er'chun'lan'shu	0
二行芥属	er'hang'jie'shu	0
二花六道木	er'hua'liu'dao'mu	0
二节豆属	er'jie'dou'shu	0
二乔玉兰	er'qiao'yu'lan	0
二台枸骨球	er'tai'gou'gu'qiu	0
二尾兰属	er'wei'lan'shu	0
耳药花属	er'yao'hua'shu	0
二药藻属	er'yao'zao'shu	0
耳叶爵床属	er'ye'jue'chuang'shu	0
发草属	fa'cao'shu	0
法国梧桐	fa'guo'wu'tong	0
法桐	fa'tong	0
反唇兰属	fan'chun'lan'shu	0
翻唇兰属	fan'chun'lan'shu	0
番红花属	fan'hong'hua'shu	0
番荔枝科	fan'li'zhi'ke	0
番荔枝属	fan'li'zhi'shu	0
番龙眼属	fan'long'yan'shu	0
繁缕属	fan'lv'shu	0
番木瓜科	fan'mu'gua'ke	0
番木瓜属	fan'mu'gua'shu	0
番石榴属	fan'shi'liu'shu	0
番薯属	fan'shu'shu	0
梵天花属	fan'tian'hua'shu	0
番杏科	fan'xing'ke	0
番杏属	fan'xing'shu	0
番樱桃属	fan'ying'tao'shu	0
防风属	fang'feng'shu	0
防已科	fang'yi'ke	0
方竹属	fang'zhu'shu	0
肺草属	fei'cao'shu	0
飞蛾藤属	fei'e'teng'shu	0
肥根兰属	fei'gen'lan'shu	0
飞廉属	fei'lian'shu	0
飞龙掌血属	fei'long'zhang'xue'shu	0
肥牛木属	fei'niu'mu'shu	0
飞蓬属	fei'peng'shu	0
榧树	fei'shu	0
榧树属	fei'shu'shu	0
飞燕草属	fei'yan'cao'shu	0
飞鸢果属	fei'yuan'guo'shu	0
肥皂草属	fei'zao'cao'shu	0
非洲楝属	fei'zhou'lian'shu	0
非洲凌霄属	fei'zhou'ling'xiao'shu	0
菲柞属	fei'zuo'shu	0
粉苞苣属	fen'bao'ju'shu	0
粉花凌霄属	fen'hua'ling'xiao'shu	0
粉花麦李	fen'hua'mai'li	0
粉口兰属	fen'kou'lan'shu	0
粉绿藤属	fen'lv'teng'shu	0
粉条儿菜属	fen'tiao'er'cai'shu	0
分药花属	fen'yao'hua'shu	0
粉枝柳	fen'zhi'liu	0
风车藤属	feng'che'teng'shu	0
蜂出巢属	feng'chu'chao'shu	0
风吹楠属	feng'chui'nan'shu	0
风吹萧属	feng'chui'xiao'shu	0
蜂斗菜属	feng'dou'cai'shu	0
蜂斗草属	feng'dou'cao'shu	0
丰花草属	feng'hua'cao'shu	0
丰花月季	feng'hua'yue'ji	0
凤凰木属	feng'huang'mu'shu	0
风兰属	feng'lan'shu	0
凤梨科	feng'li'ke	0
凤梨属	feng'li'shu	0
风铃草属	feng'ling'cao'shu	0
风龙属	feng'long'shu	0
风轮菜属	feng'lun'cai'shu	0
风轮桐属	feng'lun'tong'shu	0
风毛菊属	feng'mao'ju'shu	0
凤头黍属	feng'tou'shu'shu	0
凤尾竹	feng'wei'zhu	0
凤仙花科	feng'xian'hua'ke	0
凤仙花属	feng'xian'hua'shu	0
枫香	feng'xiang	0
风箱果属	feng'xiang'guo'shu	0
枫香属	feng'xiang'shu	0
风箱树属	feng'xiang'shu'shu	0
风信子属	feng'xin'zi'shu	0
凤眼蓝属	feng'yan'lan'shu	0
枫杨	feng'yang	0
枫杨属	feng'yang'shu	0
蜂腰兰属	feng'yao'lan'shu	0
佛肚苣苔属	fo'du'ju'tai'shu	0
佛手瓜属	fo'shou'gua'shu	0
附地菜属	fu'di'cai'shu	0
扶芳藤	fu'fang'teng	0
富贵草属	fu'gui'cao'shu	0
辐花属	fu'hua'shu	0
福建柏属	fu'jian'bai'shu	0
馥兰属	fu'lan'shu	0
茯苓	fu'ling	0
复芒菊属	fu'mang'ju'shu	0
富宁藤属	fu'ning'teng'shu	0
浮萍科	fu'ping'ke	0
浮萍属	fu'ping'shu	0
腹脐草属	fu'qi'cao'shu	0
拂子茅属	fu'zi'mao'shu	0
盖裂木属	gai'lie'mu'shu	0
甘草属	gan'cao'shu	0
干果木属	gan'guo'mu'shu	0
干花豆属	gan'hua'dou'shu	0
橄榄科	gan'lan'ke	0
橄榄属	gan'lan'shu	0
柑属	gan'shu	0
甘松香属	gan'song'xiang'shu	0
感应草属	gan'ying'cao'shu	0
甘蔗属	gan'zhe'shu	0
杠柳	gang'liu	0
刚毛药花属	gang'mao'yao'hua'shu	0
岗松属	gang'song'shu	0
刚竹	gang'zhu	0
藁本属	gao'ben'shu	0
高河菜属	gao'he'cai'shu	0
高粱属	gao'liang'shu	0
高山豆属	gao'shan'dou'shu	0
高山漆姑草属	gao'shan'qi'gu'cao'shu	0
高山芹属	gao'shan'qin'shu	0
高羊茅	gao'yang'mao	0
高原芥属	gao'yuan'jie'shu	0
高原之火海棠	gao'yuan'zhi'huo'hai'tang	0
革苞菊属	ge'bao'ju'shu	0
戈壁藜属	ge'bi'li'shu	0
割鸡芒属	ge'ji'mang'shu	0
隔距兰属	ge'ju'lan'shu	0
格兰马草属	ge'lan'ma'cao'shu	0
葛缕子属	ge'lv'zi'shu	0
格木属	ge'mu'shu	0
哥纳香属	ge'na'xiang'shu	0
割舌树属	ge'she'shu'shu	0
葛属	ge'shu	0
隔蒴苘属	ge'shuo'qing'shu	0
葛藤	ge'teng	0
革叶荠属	ge'ye'ji'shu	0
葛枣子	ge'zao'zi	0
弓果黍属	gong'guo'shu'shu	0
弓果藤	gong'guo'teng	0
珙桐科	gong'tong'ke	0
珙桐属	gong'tong'shu	0
沟瓣木属	gou'ban'mu'shu	0
钩豆属	gou'dou'shu	0
钩萼草属	gou'e'cao'shu	0
勾儿茶属	gou'er'cha'shu	0
沟繁缕科	gou'fan'lv'ke	0
沟繁缕属	gou'fan'lv'shu	0
钩粉草属	gou'fen'cao'shu	0
沟稃草属	gou'fu'cao'shu	0
狗肝菜属	gou'gan'cai'shu	0
枸骨	gou'gu	0
狗骨柴属	gou'gu'chai'shu	0
枸骨球	gou'gu'qiu	0
狗筋蔓属	gou'jin'man'shu	0
钩毛草属	gou'mao'cao'shu	0
钩毛果属	gou'mao'guo'shu	0
枸杞	gou'qi	0
构属	gou'shu	0
构树	gou'shu	0
钩藤属	gou'teng'shu	0
狗哇花属	gou'wa'hua'shu	0
狗尾草属	gou'wei'cao'shu	0
狗牙根属	gou'ya'gen'shu	0
狗牙花属	gou'ya'hua'shu	0
钩叶藤属	gou'ye'teng'shu	0
沟颖草属	gou'ying'cao'shu	0
狗枣子	gou'zao'zi	0
钩枝藤科	gou'zhi'teng'ke	0
钩枝藤属	gou'zhi'teng'shu	0
沟子荠属	gou'zi'ji'shu	0
钩子木属	gou'zi'mu'shu	0
古当归属	gu'dang'gui'shu	0
谷精草科	gu'jing'cao'ke	0
谷精草属	gu'jing'cao'shu	0
古柯科	gu'ke'ke	0
古柯属	gu'ke'shu	0
谷木属	gu'mu'shu	0
固沙草属	gu'sha'cao'shu	0
古山龙属	gu'shan'long'shu	0
菰属	gu'shu	0
瓜馥木属	gua'fu'mu'shu	0
栝楼属	gua'lou'shu	0
寡毛菊属	gua'mao'ju'shu	0
瓜叶菊属	gua'ye'ju'shu	0
瓜子黄杨	gua'zi'huang'yang	0
瓜子黄杨球	gua'zi'huang'yang'qiu	0
冠唇花属	guan'chun'hua'shu	0
管唇兰属	guan'chun'lan'shu	0
关东丁香	guan'dong'ding'xiang	0
冠盖藤属	guan'gai'teng'shu	0
观光木属	guan'guang'mu'shu	0
冠果草属	guan'guo'cao'shu	0
管花兰属	guan'hua'lan'shu	0
冠芒草属	guan'mang'cao'shu	0
冠毛草属	guan'mao'cao'shu	0
广东万年青属	guang'dong'wan'nian'qing'shu	0
光萼溲疏	guang'e'sou'shu	0
广防风属	guang'fang'feng'shu	0
桄榔属	guang'lang'shu	0
广叶参属	guang'ye'can'shu	0
光叶榉	guang'ye'ju	0
广玉兰	guang'yu'lan	0
桧柏	gui'bai	0
龟背竹属	gui'bei'zhu'shu	0
龟甲冬青	gui'jia'dong'qing	0
桂木属	gui'mu'shu	0
鬼针草属	gui'zhen'cao'shu	0
桂竹香属	gui'zhu'xiang'shu	0
国槐	guo'huai	0
过江藤属	guo'jiang'teng'shu	0
过路黄	guo'lu'huang	0
果梅	guo'mei	0
果石榴	guo'shi'liu	0
果树类	guo'shu'lei	0
海岸桐属	hai'an'tong'shu	0
海滨木槿	hai'bin'mu'jin	0
海滨莎属	hai'bin'sha'shu	0
海菖蒲属	hai'chang'pu'shu	0
海岛藤属	hai'dao'teng'shu	0
孩儿参属	hai'er'can'shu	0
孩儿草属	hai'er'cao'shu	0
海红豆属	hai'hong'dou'shu	0
海榄雌属	hai'lan'ci'shu	0
海马齿属	hai'ma'chi'shu	0
海杧果属	hai'mang'guo'shu	0
海南椴属	hai'nan'duan'shu	0
海葡萄属	hai'pu'tao'shu	0
海漆属	hai'qi'shu	0
海乳草属	hai'ru'cao'shu	0
海檀木属	hai'tan'mu'shu	0
海棠果	hai'tang'guo	0
海桐	hai'tong	0
海桐花科	hai'tong'hua'ke	0
海桐花属	hai'tong'hua'shu	0
海桐球	hai'tong'qiu	0
海罂粟属	hai'ying'su'shu	0
海芋属	hai'yu'shu	0
海州常山	hai'zhou'chang'shan	0
蔊菜属	han'cai'shu	0
旱垂柳	han'chui'liu	0
旱花属	han'hua'shu	0
旱金莲科	han'jin'lian'ke	0
旱柳	han'liu	0
旱麦草属	han'mai'cao'shu	0
寒蓬属	han'peng'shu	0
旱伞草	han'san'cao	0
汉松科	han'song'ke	0
含笑	han'xiao	0
含笑属	han'xiao'shu	0
含羞草科	han'xiu'cao'ke	0
含羞草属	han'xiu'cao'shu	0
寒原荠属	han'yuan'ji'shu	0
蒿柳	hao'liu	0
蒿属	hao'shu	0
河八王属	he'ba'wang'shu	0
合苞菊属	he'bao'ju'shu	0
荷包牡丹科	he'bao'mu'dan'ke	0
荷包牡丹科紫堇科	he'bao'mu'dan'ke'zi'jin'ke	0
荷包牡丹属	he'bao'mu'dan'shu	0
荷包藤属	he'bao'teng'shu	0
禾本科	he'ben'ke	0
鹤顶兰属	he'ding'lan'shu	0
核果茶属	he'guo'cha'shu	0
合果含笑属	he'guo'han'xiao'shu	0
核果木属	he'guo'mu'shu	0
盒果藤属	he'guo'teng'shu	0
荷花	he'hua	0
合欢	he'huan	0
合欢草属	he'huan'cao'shu	0
合欢属	he'huan'shu	0
荷兰菊	he'lan'ju	0
荷莲豆属	he'lian'dou'shu	0
褐鳞木属	he'lin'mu'shu	0
合萌属	he'meng'shu	0
河南桧	he'nan'gui	0
河南桧柏球	he'nan'gui'bai'qiu	0
荷青花属	he'qing'hua'shu	0
鹤虱属	he'shi'shu	0
核桃	he'tao	0
合头草属	he'tou'cao'shu	0
合头菊属	he'tou'ju'shu	0
禾叶兰属	he'ye'lan'shu	0
合叶子属	he'ye'zi'shu	0
貉藻属	he'zao'shu	0
合柱兰属	he'zhu'lan'shu	0
合子草属	he'zi'cao'shu	0
核子木属	he'zi'mu'shu	0
黑钩叶	hei'gou'ye	0
黑钩叶属	hei'gou'ye'shu	0
黑桦	hei'hua	0
黑麦草	hei'mai'cao	0
黑麦属	hei'mai'shu	0
黑鳗藤属	hei'man'teng'shu	0
黑面神属	hei'mian'shen'shu	0
黑木耳	hei'mu'er	0
黑松	hei'song	0
黑莎草属	hei'suo'cao'shu	0
黑杨	hei'yang	0
黑榆	hei'yu	0
黑藻属	hei'zao'shu	0
黑种草属	hei'zhong'cao'shu	0
横蒴苣苔属	heng'shuo'ju'tai'shu	0
红宝石海棠	hong'bao'shi'hai'tang	0
红葱属	hong'cong'shu	0
红丁香	hong'ding'xiang	0
红豆杉科	hong'dou'shan'ke	0
红豆杉属	hong'dou'shan'shu	0
红豆属	hong'dou'shu	0
红枫	hong'feng	0
红菇	hong'gu	0
红瓜属	hong'gua'shu	0
红光树属	hong'guang'shu'shu	0
红果冬青	hong'guo'dong'qing	0
红果海棠	hong'guo'hai'tang	0
红果山楂	hong'guo'shan'zha	0
红果树属	hong'guo'shu'shu	0
红厚壳属	hong'hou'ke'shu	0
红槲栎	hong'hu'li	0
红花荷属	hong'hua'he'shu	0
红花继木	hong'hua'ji'mu	0
红花继木球	hong'hua'ji'mu'qiu	0
红花金丝桃属	hong'hua'jin'si'tao'shu	0
红花麦李	hong'hua'mai'li	0
红花木莲	hong'hua'mu'lian	0
红花属	hong'hua'shu	0
红花酢浆草	hong'hua'zuo'jiang'cao	0
红胶木属	hong'jiao'mu'shu	0
红景天属	hong'jing'tian'shu	0
红丽海棠	hong'li'hai'tang	0
红毛草属	hong'mao'cao'shu	0
红毛七属	hong'mao'qi'shu	0
红帽子月季	hong'mao'zi'yue'ji	0
红梅	hong'mei	0
红玫瑰	hong'mei'gui	0
红门兰属	hong'men'lan'shu	0
红木科	hong'mu'ke	0
红木属	hong'mu'shu	0
红楠	hong'nan	0
红钮子属	hong'niu'zi'shu	0
红千层属	hong'qian'ceng'shu	0
红杄云杉	hong'qian'yun'shan	0
红雀珊瑚属	hong'que'shan'hu'shu	0
红乳牛肝菌	hong'ru'niu'gan'jun	0
红瑞木	hong'rui'mu	0
红沙属	hong'sha'shu	0
红树科	hong'shu'ke	0
红树属	hong'shu'shu	0
红松	hong'song	0
红王子锦带	hong'wang'zi'jin'dai	0
红小麻属	hong'xiao'ma'shu	0
红雪果	hong'xue'guo	0
红芽大戟属	hong'ya'da'ji'shu	0
红叶碧桃	hong'ye'bi'tao	0
红叶红花垂枝海棠	hong'ye'hong'hua'chui'zhi'hai'tang	0
红叶景天	hong'ye'jing'tian	0
红叶李	hong'ye'li	0
红叶石楠	hong'ye'shi'nan	0
红叶桃	hong'ye'tao	0
红叶藤属	hong'ye'teng'shu	0
红玉海棠	hong'yu'hai'tang	0
红玉兰	hong'yu'lan	0
红子木属	hong'zi'mu'shu	0
厚翅荠属	hou'chi'ji'shu	0
厚唇兰属	hou'chun'lan'shu	0
猴耳环属	hou'er'huan'shu	0
猴欢喜属	hou'huan'xi'shu	0
厚喙菊属	hou'hui'ju'shu	0
厚距花属	hou'ju'hua'shu	0
厚壳桂属	hou'ke'gui'shu	0
厚壳树属	hou'ke'shu'shu	0
厚肋苦荬菜属	hou'lei'ku'mai'cai'shu	0
厚棱芹属	hou'leng'qin'shu	0
厚皮树属	hou'pi'shu'shu	0
厚皮香	hou'pi'xiang	0
厚皮香属	hou'pi'xiang'shu	0
后蕊苣苔属	hou'rui'ju'tai'shu	0
猴头菇	hou'tou'gu	0
虎刺属	hu'ci'shu	0
蝴蝶果属	hu'die'guo'shu	0
蝴蝶花	hu'die'hua	0
蝴蝶槐	hu'die'huai	0
虎耳草科	hu'er'cao'ke	0
湖瓜草属	hu'gua'cao'shu	0
槲寄生	hu'ji'sheng	0
槲寄生属	hu'ji'sheng'shu	0
胡椒科	hu'jiao'ke	0
胡椒属	hu'jiao'shu	0
槲栎	hu'li	0
胡莲属	hu'lian'shu	0
胡卢巴属	hu'lu'ba'shu	0
葫芦草属	hu'lu'cao'shu	0
葫芦茶属	hu'lu'cha'shu	0
葫芦科	hu'lu'ke	0
葫芦属	hu'lu'shu	0
胡萝卜属	hu'luo'bo'shu	0
胡麻花属	hu'ma'hua'shu	0
胡麻科	hu'ma'ke	0
胡麻属	hu'ma'shu	0
胡蔓藤属	hu'man'teng'shu	0
虎皮花属	hu'pi'hua'shu	0
虎舌兰属	hu'she'lan'shu	0
胡桃	hu'tao	0
胡桃科	hu'tao'ke	0
胡桃楸	hu'tao'qiu	0
胡桃属	hu'tao'shu	0
胡颓子	hu'tui'zi	0
胡颓子科	hu'tui'zi'ke	0
胡颓子球	hu'tui'zi'qiu	0
虎尾草属	hu'wei'cao'shu	0
虎尾兰属	hu'wei'lan'shu	0
狐尾藻	hu'wei'zao	0
虎颜花属	hu'yan'hua'shu	0
虎眼万年青属	hu'yan'wan'nian'qing'shu	0
胡杨	hu'yang	0
互叶铁线莲属	hu'ye'tie'xian'lian'shu	0
虎掌菌	hu'zhang'jun	0
胡榛属	hu'zhen'shu	0
胡榛子	hu'zhen'zi	0
虎榛子	hu'zhen'zi	0
胡枝子	hu'zhi'zi	0
胡枝子属	hu'zhi'zi'shu	0
花柏	hua'bai	0
花柏球	hua'bai'qiu	0
华北柽柳	hua'bei'cheng'liu	0
华北落叶松	hua'bei'luo'ye'song	0
华北卫矛	hua'bei'wei'mao	0
华北紫丁香	hua'bei'zi'ding'xiang	0
画笔菊属	hua'bi'ju'shu	0
华参属	hua'can'shu	0
花菖蒲	hua'chang'pu	0
花点草属	hua'dian'cao'shu	0
华福花属	hua'fu'hua'shu	0
华盖木属	hua'gai'mu'shu	0
滑菇	hua'gu	0
花灌木类	hua'guan'mu'lei	0
花红	hua'hong	0
花花柴属	hua'hua'chai'shu	0
花椒	hua'jiao	0
花椒属	hua'jiao'shu	0
花楷槭	hua'kai'qi	0
花葵属	hua'kui'shu	0
花蔺	hua'lin	0
花蔺科	hua'lin'ke	0
花蔺属	hua'lin'shu	0
花菱草属	hua'ling'cao'shu	0
花锚属	hua'mao'shu	0
画眉草属	hua'mei'cao'shu	0
桦木科	hua'mu'ke	0
花木兰	hua'mu'lan	0
桦木属	hua'mu'shu	0
花佩菊属	hua'pei'ju'shu	0
花皮胶藤属	hua'pi'jiao'teng'shu	0
花旗竿属	hua'qi'gan'shu	0
花楸	hua'qiu	0
花楸属	hua'qiu'shu	0
花曲柳	hua'qu'liu	0
花荵科	hua'ren'ke	0
花荵属	hua'ren'shu	0
华箬竹属	hua'ruo'zhu'shu	0
华山松	hua'shan'song	0
花石榴	hua'shi'liu	0
滑桃树属	hua'tao'shu'shu	0
滑藤属	hua'teng'shu	0
化香属	hua'xiang'shu	0
花叶丁香	hua'ye'ding'xiang	0
花叶芦苇	hua'ye'lu'wei	0
花叶水葱	hua'ye'shui'cong	0
花叶万年青属	hua'ye'wan'nian'qing'shu	0
花叶芋属	hua'ye'yu'shu	0
花叶玉簪	hua'ye'yu'zan	0
花叶泽苔	hua'ye'ze'tai	0
花蜘蛛兰属	hua'zhi'zhu'lan'shu	0
华中木兰	hua'zhong'mu'lan	0
花烛属	hua'zhu'shu	0
怀槐	huai'huai	0
槐蓝属	huai'lan'shu	0
槐属	huai'shu	0
槐树	huai'shu	0
环根芹属	huan'gen'qin'shu	0
环花科	huan'hua'ke	0
还阳参属	huan'yang'can'shu	0
黄鹌菜属	huang'an'cai'shu	0
黄柏属	huang'bai'shu	0
黄波萝	huang'bo'luo	0
黄蝉属	huang'chan'shu	0
黄菖蒲	huang'chang'pu	0
黄刺梅	huang'ci'mei	0
黄刺玫	huang'ci'mei	0
黄冠菊属	huang'guan'ju'shu	0
黄果木属	huang'guo'mu'shu	0
黄桦	huang'hua	0
黄花夹竹桃属	huang'hua'jia'zhu'tao'shu	0
黄花锦鸡儿	huang'hua'jin'ji'er	0
黄花蔺	huang'hua'lin	0
黄花茅属	huang'hua'mao'shu	0
黄花木属	huang'hua'mu'shu	0
黄花忍冬	huang'hua'ren'dong	0
黄花稔属	huang'hua'ren'shu	0
黄金槐	huang'jin'huai	0
黄金树	huang'jin'shu	0
黄精属	huang'jing'shu	0
黄葵属	huang'kui'shu	0
黄兰属	huang'lan'shu	0
黄梨木属	huang'li'mu'shu	0
黄连木	huang'lian'mu	0
黄连木属	huang'lian'mu'shu	0
黄连属	huang'lian'shu	0
黄柳	huang'liu	0
黄栌属	huang'lu'shu	0
黄麻属	huang'ma'shu	0
黄脉爵床属	huang'mai'jue'chuang'shu	0
黄茅属	huang'mao'shu	0
黄牛肝菌	huang'niu'gan'jun	0
黄牛木属	huang'niu'mu'shu	0
黄皮属	huang'pi'shu	0
黄杞属	huang'qi'shu	0
黄芩属	huang'qin'shu	0
黄球花属	huang'qiu'hua'shu	0
黄雀儿属	huang'que'er'shu	0
黄蓉花属	huang'rong'hua'shu	0
黄肉楠属	huang'rou'nan'shu	0
幌伞枫属	huang'san'feng'shu	0
黄伞菇	huang'san'gu	0
黄三七属	huang'san'qi'shu	0
黄山栾树	huang'shan'luan'shu	0
黄山梅属	huang'shan'mei'shu	0
黄杉属	huang'shan'shu	0
黄丝草	huang'si'cao	0
黄藤属	huang'teng'shu	0
黄筒花属	huang'tong'hua'shu	0
黄桐属	huang'tong'shu	0
黄薇属	huang'wei'shu	0
黄细心属	huang'xi'xin'shu	0
黄眼草科	huang'yan'cao'ke	0
黄眼草属	huang'yan'cao'shu	0
黄杨科	huang'yang'ke	0
黄杨属	huang'yang'shu	0
黄叶树属	huang'ye'shu'shu	0
黄榆	huang'yu	0
黄钟花属	huang'zhong'hua'shu	0
喙核桃属	hui'he'tao'shu	0
喙花姜属	hui'hua'jiang'shu	0
灰莉属	hui'li'shu	0
荟蔓藤属	hui'man'teng'shu	0
茴芹属	hui'qin'shu	0
灰树花	hui'shu'hua	0
茴香砂仁属	hui'xiang'sha'ren'shu	0
茴香属	hui'xiang'shu	0
灰叶属	hui'ye'shu	0
火把花属	huo'ba'hua'shu	0
火棘	huo'ji	0
火棘球	huo'ji'qiu	0
火棘属	huo'ji'shu	0
火炬	huo'ju	0
火炬树	huo'ju'shu	0
火绒草属	huo'rong'cao'shu	0
火烧花属	huo'shao'hua'shu	0
火烧兰属	huo'shao'lan'shu	0
火筒树属	huo'tong'shu'shu	0
藿香属	huo'xiang'shu	0
活血丹属	huo'xue'dan'shu	0
火焰海棠	huo'yan'hai'tang	0
火焰花属	huo'yan'hua'shu	0
火焰兰属	huo'yan'lan'shu	0
火焰树属	huo'yan'shu'shu	0
棘苞菊属	ji'bao'ju'shu	0
鸡枞菌	ji'cong'jun	0
鸡蛋花属	ji'dan'hua'shu	0
棘豆属	ji'dou'shu	0
姬菇	ji'gu	0
鸡骨常山属	ji'gu'chang'shan'shu	0
芨芨草属	ji'ji'cao'shu	0
基及树属	ji'ji'shu'shu	0
鸡脚参属	ji'jiao'can'shu	0
蒺藜草属	ji'li'cao'shu	0
蒺藜科	ji'li'ke	0
蒺藜属	ji'li'shu	0
鸡麻	ji'ma	0
鸡麻属	ji'ma'shu	0
姬苗属	ji'miao'shu	0
继木属	ji'mu'shu	0
寄生花属	ji'sheng'hua'shu	0
寄生鳞叶草属	ji'sheng'lin'ye'cao'shu	0
寄生藤属	ji'sheng'teng'shu	0
鸡矢藤属	ji'shi'teng'shu	0
荠属	ji'shu	0
蓟属	ji'shu	0
寄树兰属	ji'shu'lan'shu	0
鸡树条子	ji'shu'tiao'zi	0
姬松茸	ji'song'rong	0
吉粟草属	ji'su'cao'shu	0
鸡嗉子树	ji'su'zi'shu	0
棘头花属	ji'tou'hua'shu	0
鸡腿菇	ji'tui'gu	0
吉祥草属	ji'xiang'cao'shu	0
积雪草属	ji'xue'cao'shu	0
鸡血藤	ji'xue'teng	0
鸡眼草属	ji'yan'cao'shu	0
鸡油菌	ji'you'jun	0
鲫鱼藤属	ji'yu'teng'shu	0
鸡爪草属	ji'zhua'cao'shu	0
鸡爪槭	ji'zhua'qi	0
假百合属	jia'bai'he'shu	0
假报春属	jia'bao'chun'shu	0
假贝母属	jia'bei'mu'shu	0
假扁果草属	jia'bian'guo'cao'shu	0
假摈榔属	jia'bin'lang'shu	0
假糙苏属	jia'cao'su'shu	0
假柴龙树属	jia'chai'long'shu'shu	0
假葱属	jia'cong'shu	0
假稻属	jia'dao'shu	0
假地胆草属	jia'di'dan'cao'shu	0
假杜鹃属	jia'du'juan'shu	0
假繁缕科	jia'fan'lv'ke	0
假海齿属	jia'hai'chi'shu	0
假海桐属	jia'hai'tong'shu	0
假含羞草属	jia'han'xiu'cao'shu	0
假鹤虱属	jia'he'shi'shu	0
假虎刺属	jia'hu'ci'shu	0
假还阳参属	jia'huan'yang'can'shu	0
假金发草属	jia'jin'fa'cao'shu	0
假金桔属	jia'jin'ju'shu	0
假兰科	jia'lan'ke	0
假蓝属	jia'lan'shu	0
假兰属	jia'lan'shu	0
嘉兰属	jia'lan'shu	0
嘉榄属	jia'lan'shu	0
假狼毒属	jia'lang'du'shu	0
假狼紫草属	jia'lang'zi'cao'shu	0
假连翘属	jia'lian'qiao'shu	0
嘉陵花属	jia'ling'hua'shu	0
假龙胆属	jia'long'dan'shu	0
假龙头	jia'long'tou	0
假耧斗菜属	jia'lou'dou'cai'shu	0
假楼梯草属	jia'lou'ti'cao'shu	0
假马鞭属	jia'ma'bian'shu	0
荚蒾属	jia'mi'shu	0
假木豆属	jia'mu'dou'shu	0
假木荷属	jia'mu'he'shu	0
假木贼属	jia'mu'zei'shu	0
加拿大杨	jia'na'da'yang	0
假囊距兰属	jia'nang'ju'lan'shu	0
假牛鞭草属	jia'niu'bian'cao'shu	0
假蓬属	jia'peng'shu	0
假婆婆纳属	jia'po'po'na'shu	0
假千里光属	jia'qian'li'guang'shu	0
家桑	jia'sang	0
假色槭	jia'se'qi	0
假山龙眼属	jia'shan'long'yan'shu	0
假山萝属	jia'shan'luo'shu	0
假韶子属	jia'shao'zi'shu	0
假蛇尾草属	jia'she'wei'cao'shu	0
假升麻属	jia'sheng'ma'shu	0
假石柑属	jia'shi'gan'shu	0
假水晶兰属	jia'shui'jing'lan'shu	0
假水苏属	jia'shui'su'shu	0
假铁秆草属	jia'tie'gan'cao'shu	0
假万带兰属	jia'wan'dai'lan'shu	0
假卫矛属	jia'wei'mao'shu	0
假吻兰属	jia'wen'lan'shu	0
假小喙菊属	jia'xiao'hui'ju'shu	0
假叶树科	jia'ye'shu'ke	0
假叶树属	jia'ye'shu'shu	0
假野芝麻属	jia'ye'zhi'ma'shu	0
假鹰爪属	jia'ying'zhao'shu	0
家榆	jia'yu	0
假泽兰属	jia'ze'lan'shu	0
假奓包叶属	jia'zha'bao'ye'shu	0
夹竹桃	jia'zhu'tao	0
夹竹桃科	jia'zhu'tao'ke	0
夹竹桃属	jia'zhu'tao'shu	0
假紫草属	jia'zi'cao'shu	0
假紫万年青属	jia'zi'wan'nian'qing'shu	0
尖稃草属	jian'fu'cao'shu	0
箭杆杨	jian'gan'yang	0
剪股颖草	jian'gu'ying'cao	0
剪股颖属	jian'gu'ying'shu	0
坚桦	jian'hua	0
尖花藤属	jian'hua'teng'shu	0
尖槐藤属	jian'huai'teng'shu	0
剑麻	jian'ma	0
硷茅属	jian'mao'shu	0
尖囊兰属	jian'nang'lan'shu	0
碱蓬属	jian'peng'shu	0
剪秋罗属	jian'qiu'luo'shu	0
尖蕊花属	jian'rui'hua'shu	0
尖舌苣苔属	jian'she'ju'tai'shu	0
菅属	jian'shu	0
尖头花属	jian'tou'hua'shu	0
碱菀属	jian'wan'shu	0
见血飞属	jian'xue'fei'shu	0
见血封喉属	jian'xue'feng'hou'shu	0
健杨	jian'yang	0
尖药花属	jian'yao'hua'shu	0
尖药兰属	jian'yao'lan'shu	0
箭药藤属	jian'yao'teng'shu	0
尖叶木属	jian'ye'mu'shu	0
剑叶莎属	jian'ye'sha'shu	0
箭叶水苏属	jian'ye'shui'su'shu	0
箭竹属	jian'zhu'shu	0
尖子木属	jian'zi'mu'shu	0
尖子藤属	jian'zi'teng'shu	0
尖柞	jian'zuo	0
豇豆属	jiang'dou'shu	0
浆果楝属	jiang'guo'lian'shu	0
浆果苋属	jiang'guo'xian'shu	0
姜花属	jiang'hua'shu	0
姜黄属	jiang'huang'shu	0
疆堇属	jiang'jin'shu	0
疆菊属	jiang'ju'shu	0
姜科	jiang'ke	0
江南槐	jiang'nan'huai	0
江南桤木	jiang'nan'qi'mu	0
疆南星属	jiang'nan'xing'shu	0
姜属	jiang'shu	0
姜味草属	jiang'wei'cao'shu	0
胶东卫矛	jiao'dong'wei'mao	0
绞股蓝属	jiao'gu'lan'shu	0
角果藜属	jiao'guo'li'shu	0
角果毛茛属	jiao'guo'mao'gen'shu	0
角果木属	jiao'guo'mu'shu	0
角果藻科	jiao'guo'zao'ke	0
角果藻属	jiao'guo'zao'shu	0
角蒿属	jiao'hao'shu	0
胶核木属	jiao'he'mu'shu	0
角花属	jiao'hua'shu	0
角茴香属	jiao'hui'xiang'shu	0
铰剪藤属	jiao'jian'teng'shu	0
胶木属	jiao'mu'shu	0
蕉木属	jiao'mu'shu	0
角盘兰属	jiao'pan'lan'shu	0
交让木科	jiao'rang'mu'ke	0
交让木属	jiao'rang'mu'shu	0
胶州卫矛	jiao'zhou'wei'mao	0
角柱花属	jiao'zhu'hua'shu	0
睫苞豆属	jie'bao'dou'shu	0
桔梗科	jie'geng'ke	0
桔梗属	jie'geng'shu	0
接骨木	jie'gu'mu	0
接骨木属	jie'gu'mu'shu	0
节节菜属	jie'jie'cai'shu	0
节节木属	jie'jie'mu'shu	0
结缕草属	jie'lv'cao'shu	0
节蒴木属	jie'shuo'mu'shu	0
结香	jie'xiang	0
结香属	jie'xiang'shu	0
截叶榆叶梅	jie'ye'yu'ye'mei	0
金边扶芳藤	jin'bian'fu'fang'teng	0
金边黄杨	jin'bian'huang'yang	0
金边黄杨球	jin'bian'huang'yang'qiu	0
堇菜科	jin'cai'ke	0
堇菜属	jin'cai'shu	0
荩草属	jin'cao'shu	0
金唇兰属	jin'chun'lan'shu	0
锦带花	jin'dai'hua	0
锦带花属	jin'dai'hua'shu	0
金发草属	jin'fa'cao'shu	0
金凤藤属	jin'feng'teng'shu	0
金佛山兰属	jin'fo'shan'lan'shu	0
金钢鼠李	jin'gang'shu'li	0
金钩花属	jin'gou'hua'shu	0
筋骨草属	jin'gu'cao'shu	0
金瓜属	jin'gua'shu	0
金光菊属	jin'guang'ju'shu	0
金桂	jin'gui	0
金合欢	jin'he'huan	0
金合欢属	jin'he'huan'shu	0
金虎尾科	jin'hu'wei'ke	0
金虎尾属	jin'hu'wei'shu	0
锦鸡儿	jin'ji'er	0
锦鸡儿属	jin'ji'er'shu	0
金鸡菊属	jin'ji'ju'shu	0
金鸡纳属	jin'ji'na'shu	0
金锦香属	jin'jin'xiang'shu	0
金桔	jin'ju	0
金桔属	jin'ju'shu	0
锦葵科	jin'kui'ke	0
锦葵属	jin'kui'shu	0
堇兰属	jin'lan'shu	0
金老梅	jin'lao'mei	0
金栗兰科	jin'li'lan'ke	0
金莲花科	jin'lian'hua'ke	0
金莲花属	jin'lian'hua'shu	0
金莲木科	jin'lian'mu'ke	0
金莲木属	jin'lian'mu'shu	0
金露梅	jin'lu'mei	0
金缕梅科	jin'lv'mei'ke	0
金缕梅属	jin'lv'mei'shu	0
金玛丽月季	jin'ma'li'yue'ji	0
金茅属	jin'mao'shu	0
金梅草属	jin'mei'cao'shu	0
金钮扣属	jin'niu'kou'shu	0
金平藤属	jin'ping'teng'shu	0
金钱豹属	jin'qian'bao'shu	0
金钱槭属	jin'qian'qi'shu	0
金钱松	jin'qian'song	0
金钱松属	jin'qian'song'shu	0
金雀儿属	jin'que'er'shu	0
金雀锦鸡儿	jin'que'jin'ji'er	0
金山绣线菊	jin'shan'xiu'xian'ju	0
金石斛属	jin'shi'hu'shu	0
金丝垂柳	jin'si'chui'liu	0
金丝梅	jin'si'mei	0
金丝桃	jin'si'tao	0
金丝桃科	jin'si'tao'ke	0
金丝桃属	jin'si'tao'shu	0
金松属	jin'song'shu	0
金粟兰科	jin'su'lan'ke	0
金粟兰属	jin'su'lan'shu	0
锦绦花属	jin'tao'hua'shu	0
金铁锁属	jin'tie'suo'shu	0
金娃娃萱草	jin'wa'wa'xuan'cao	0
金线草属	jin'xian'cao'shu	0
锦香草属	jin'xiang'cao'shu	0
金须茅属	jin'xu'mao'shu	0
金焰绣线菊	jin'yan'xiu'xian'ju	0
金腰箭属	jin'yao'jian'shu	0
金叶垂槐	jin'ye'chui'huai	0
金叶风箱果	jin'ye'feng'xiang'guo	0
金叶复叶槭	jin'ye'fu'ye'qi	0
金叶红瑞木	jin'ye'hong'rui'mu	0
金叶接骨木	jin'ye'jie'gu'mu	0
堇叶芥属	jin'ye'jie'shu	0
金叶锦带	jin'ye'jin'dai	0
金叶景天	jin'ye'jing'tian	0
金叶连翘	jin'ye'lian'qiao	0
金叶裂叶接骨木	jin'ye'lie'ye'jie'gu'mu	0
金叶女贞	jin'ye'nv'zhen	0
金叶女贞球	jin'ye'nv'zhen'qiu	0
金叶山梅花	jin'ye'shan'mei'hua	0
堇叶山梅花	jin'ye'shan'mei'hua	0
金叶树属	jin'ye'shu'shu	0
金叶莸	jin'ye'you	0
金叶榆	jin'ye'yu	0
金银花	jin'yin'hua	0
金银木	jin'yin'mu	0
金银忍冬	jin'yin'ren'dong	0
金英属	jin'ying'shu	0
金罂粟属	jin'ying'su'shu	0
金鱼花属	jin'yu'hua'shu	0
金鱼藻	jin'yu'zao	0
金鱼藻科	jin'yu'zao'ke	0
金盏花属	jin'zhan'hua'shu	0
金盏苣苔属	jin'zhan'ju'tai'shu	0
金枝红瑞木	jin'zhi'hong'rui'mu	0
金枝梾木	jin'zhi'lai'mu	0
金钟	jin'zhong	0
金钟花	jin'zhong'hua	0
金钟连翘	jin'zhong'lian'qiao	0
金州锦鸡儿	jin'zhou'jin'ji'er	0
金州绣线菊	jin'zhou'xiu'xian'ju	0
颈果草属	jing'guo'cao'shu	0
荆芥属	jing'jie'shu	0
景天科	jing'tian'ke	0
景天属	jing'tian'shu	0
荆条	jing'tiao	0
秔子梢属	jing'zi'shao'shu	0
酒饼簕属	jiu'bing'le'shu	0
九节属	jiu'jie'shu	0
韭兰	jiu'lan	0
九里香属	jiu'li'xiang'shu	0
九头狮子草属	jiu'tou'shi'zi'cao'shu	0
九子母科	jiu'zi'mu'ke	0
九子母属	jiu'zi'mu'shu	0
距瓣豆属	ju'ban'dou'shu	0
聚草	ju'cao	0
菊蒿属	ju'hao'shu	0
聚花草属	ju'hua'cao'shu	0
距花黍属	ju'hua'shu'shu	0
菊花桃	ju'hua'tao	0
菊苣属	ju'ju'shu	0
菊科	ju'ke	0
巨盘木属	ju'pan'mu'shu	0
咀签属	ju'qian'shu	0
菊芹属	ju'qin'shu	0
蒟蒻薯科	ju'ruo'shu'ke	0
蒟蒻薯属	ju'ruo'shu'shu	0
巨杉属	ju'shan'shu	0
菊属	ju'shu	0
榉属	ju'shu	0
榉树	ju'shu	0
距药姜属	ju'yao'jiang'shu	0
桔子	ju'zi	0
卷瓣兰属	juan'ban'lan'shu	0
卷边柳	juan'bian'liu	0
卷耳属	juan'er'shu	0
卷花丹属	juan'hua'dan'shu	0
绢毛苣属	juan'mao'ju'shu	0
爵床科	jue'chuang'ke	0
爵床属	jue'chuang'shu	0
决明属	jue'ming'shu	0
君迁子	jun'qian'zi	0
君子兰属	jun'zi'lan'shu	0
咖啡属	ka'fei'shu	0
喀什菊属	ka'shi'ju'shu	0
开唇兰属	kai'chun'lan'shu	0
凯尔斯海棠	kai'er'si'hai'tang	0
开口箭属	kai'kou'jian'shu	0
铠兰属	kai'lan'shu	0
勘察加费菜	kan'cha'jia'fei'cai	0
看麦娘属	kan'mai'niang'shu	0
糠椴	kang'duan	0
可爱花属	ke'ai'hua'shu	0
柯树属	ke'shu'shu	0
榼藤子属	ke'teng'zi'shu	0
棵柱花属	ke'zhu'hua'shu	0
铿木属	keng'mu'shu	0
孔唇兰属	kong'chun'lan'shu	0
空棱芹属	kong'leng'qin'shu	0
孔药花属	kong'yao'hua'shu	0
孔颖草属	kong'ying'cao'shu	0
空竹属	kong'zhu'shu	0
口蘑	kou'mo	0
苦草	ku'cao	0
苦草属	ku'cao'shu	0
苦瓜属	ku'gua'shu	0
苦苣菜属	ku'ju'cai'shu	0
苦苣苔科	ku'ju'tai'ke	0
苦苣苔属	ku'ju'tai'shu	0
苦槛蓝科	ku'kan'lan'ke	0
苦槛蓝属	ku'kan'lan'shu	0
苦楝	ku'lian	0
库林木属	ku'lin'mu'shu	0
苦马豆属	ku'ma'dou'shu	0
苦荬菜属	ku'mai'cai'shu	0
苦木	ku'mu	0
苦木科	ku'mu'ke	0
苦参	ku'shen	0
库页悬钩子	ku'ye'xuan'gou'zi	0
苦槠	ku'zhu	0
苦竹	ku'zhu	0
苦竹属	ku'zhu'shu	0
块茎芹属	kuai'jing'qin'shu	0
款冬属	kuan'dong'shu	0
宽萼苣苔属	kuan'e'ju'tai'shu	0
宽距兰属	kuan'ju'lan'shu	0
宽框荠属	kuan'kuang'ji'shu	0
宽叶泽苔	kuan'ye'ze'tai	0
昆栏树科	kun'lan'shu'ke	0
昆栏树属	kun'lan'shu'shu	0
阔带芹属	kuo'dai'qin'shu	0
阔蕊兰属	kuo'rui'lan'shu	0
阔叶十大功劳	kuo'ye'shi'da'gong'lao	0
喇叭茶属	la'ba'cha'shu	0
喇叭陀螺菌	la'ba'tuo'luo'jun	0
蜡瓣花属	la'ban'hua'shu	0
辣根属	la'gen'shu	0
蜡菊属	la'ju'shu	0
拉拉藤属	la'la'teng'shu	0
腊梅	la'mei	0
蜡梅	la'mei	0
蜡梅科	la'mei'ke	0
蜡梅属	la'mei'shu	0
辣木科	la'mu'ke	0
辣木属	la'mu'shu	0
辣莸属	la'you'shu	0
蜡烛果属	la'zhu'guo'shu	0
辣子瓜属	la'zi'gua'shu	0
赖草属	lai'cao'shu	0
梾木属	lai'mu'shu	0
蓝刺头属	lan'ci'tou'shu	0
兰锭果忍冬	lan'ding'guo'ren'dong	0
蓝耳草属	lan'er'cao'shu	0
兰花蕉科	lan'hua'jiao'ke	0
兰花蕉属	lan'hua'jiao'shu	0
蓝花参属	lan'hua'shen'shu	0
蓝花楹属	lan'hua'ying'shu	0
兰花莸	lan'hua'you	0
蓝花鸢尾	lan'hua'yuan'wei	0
篮蓟属	lan'ji'shu	0
篮堇草属	lan'jin'cao'shu	0
兰科	lan'ke	0
榄李属	lan'li'shu	0
兰嵌马蓝属	lan'qian'ma'lan'shu	0
蓝雀花属	lan'que'hua'shu	0
榄仁树属	lan'ren'shu'shu	0
兰属	lan'shu	0
蓝雪科	lan'xue'ke	0
蓝雪属	lan'xue'shu	0
蓝叶景天	lan'ye'jing'tian	0
蓝钟花属	lan'zhong'hua'shu	0
郎德木属	lang'de'mu'shu	0
狼毒属	lang'du'shu	0
榔色木属	lang'se'mu'shu	0
狼尾草属	lang'wei'cao'shu	0
榔榆	lang'yu	0
狼紫草属	lang'zi'cao'shu	0
老虎刺属	lao'hu'ci'shu	0
老颧草属	lao'quan'cao'shu	0
老人头	lao'ren'tou	0
老鼠拉冬瓜属	lao'shu'la'dong'gua'shu	0
老鼠簕属	lao'shu'le'shu	0
老鸦咀属	lao'ya'ju'shu	0
乐昌含笑	le'chang'han'xiao	0
乐东藤属	le'dong'teng'shu	0
雷公连属	lei'gong'lian'zhu	0
雷公藤属	lei'gong'teng'shu	0
擂鼓艻属	lei'gu'ji'shu	0
肋果蓟属	lei'guo'ji'shu	0
类芦属	lei'lu'shu	0
类雀稗属	lei'que'bai'shu	0
类蜀黍属	lei'shu'shu'shu	0
雷丸	lei'wan	0
类叶升麻属	lei'ye'sheng'ma'shu	0
雷竹	lei'zhu	0
棱萼茜属	leng'e'qian'shu	0
棱果芥属	leng'guo'jie'shu	0
冷杉属	leng'shan'shu	0
冷水花属	leng'shui'hua'shu	0
棱子芹属	leng'zi'qin'shu	0
离瓣寄生属	li'ban'ji'sheng'shu	0
鳢肠属	li'chang'shu	0
黎豆属	li'dou'shu	0
丽豆属	li'dou'shu	0
栗豆藤属	li'dou'teng'shu	0
梨果寄生属	li'guo'ji'sheng'shu	0
栗寄生属	li'ji'sheng'shu	0
藜科	li'ke	0
李榄属	li'lan'shu	0
藜芦属	li'lu'shu	0
栎木	li'mu	0
藜属	li'shu	0
栎属	li'shu	0
栗属	li'shu	0
梨属	li'shu	0
梨树	li'shu	0
犁头尖属	li'tou'jian'shu	0
狸尾豆属	li'wei'dou'shu	0
丽薇属	li'wei'shu	0
李叶溲疏	li'ye'sou'shu	0
狸藻科	li'zao'ke	0
狸藻属	li'zao'shu	0
荔枝属	li'zhi'shu	0
梨竹属	li'zhu'shu	0
李子	li'zi	0
离子芥属	li'zi'jie'shu	0
镰稃草属	lian'fu'cao'shu	0
莲桂属	lian'gui'shu	0
链荚豆属	lian'jia'dou'shu	0
链荚木属	lian'jia'mu'shu	0
楝科	lian'ke	0
连理藤属	lian'li'teng'shu	0
莲楠草属	lian'nan'cao'shu	0
连翘	lian'qiao	0
连翘属	lian'qiao'shu	0
连蕊芥属	lian'rui'jie'shu	0
连蕊藤属	lian'rui'teng'shu	0
莲属	lian'shu	0
楝属	lian'shu	0
连香树科	lian'xiang'shu'ke	0
连香树属	lian'xiang'shu'shu	0
莲叶桐科	lian'ye'tong'ke	0
莲叶桐属	lian'ye'tong'shu	0
帘子藤属	lian'zi'teng'shu	0
凉粉草属	liang'fen'cao'shu	0
亮花木属	liang'hua'mu'shu	0
两节荠属	liang'jie'ji'shu	0
亮蛇床属	liang'she'chuang'shu	0
量天尺属	liang'tian'chi'shu	0
梁王茶属	liang'wang'cha'shu	0
两型豆属	liang'xing'dou'shu	0
辽东丁香	liao'dong'ding'xiang	0
辽东桦	liao'dong'hua	0
辽东杨	liao'dong'yang	0
辽东柞	liao'dong'zuo	0
蓼科	liao'ke	0
辽宁山楂	liao'ning'shan'zha	0
蓼属	liao'shu	0
蓼树属	liao'shu'shu	0
鬣刺属	lie'ci'shu	0
列当科	lie'dang'ke	0
列当属	lie'dang'shu	0
裂稃草属	lie'fu'cao'shu	0
裂稃茅属	lie'fu'mao'shu	0
裂瓜属	lie'gua'shu	0
裂果金花属	lie'guo'jin'hua'shu	0
裂叶荆芥属	lie'ye'jing'jie'shu	0
裂叶罂粟属	lie'ye'ying'su'shu	0
裂叶榆	lie'ye'yu	0
裂颖茅属	lie'ying'mao'shu	0
林地苋属	lin'di'xian'shu	0
鳞隔堇属	lin'ge'jin'shu	0
鳞果草属	lin'guo'cao'shu	0
鳞花草属	lin'hua'cao'shu	0
鳞花木属	lin'hua'mu'shu	0
鳞蕊藤属	lin'rui'teng'shu	0
林石草属	lin'shi'cao'shu	0
鳞叶寄生木属	lin'ye'ji'sheng'mu'shu	0
鳞子莎属	lin'zi'sha'shu	0
领春木科	ling'chun'mu'ke	0
领春木属	ling'chun'mu'shu	0
凌风草属	ling'feng'cao'shu	0
令箭荷花属	ling'jian'he'hua'shu	0
苓菊属	ling'ju'shu	0
菱科	ling'ke	0
铃兰属	ling'lan'shu	0
菱属	ling'shu	0
柃属	ling'shu	0
凌霄	ling'xiao	0
菱叶元宝草属	ling'ye'yuan'bao'cao'shu	0
灵芝	ling'zhi	0
铃子香属	ling'zi'xiang'shu	0
柳安属	liu'an'shu	0
六瓣景天属	liu'ban'jing'tian'shu	0
琉苞菊属	liu'bao'ju'shu	0
六翅木属	liu'chi'mu'shu	0
六道木	liu'dao'mu	0
六道木属	liu'dao'mu'shu	0
留萼木属	liu'e'mu'shu	0
瘤果芹属	liu'guo'qin'shu	0
柳兰属	liu'lan'shu	0
六棱菊属	liu'leng'ju'shu	0
琉璃草属	liu'li'cao'shu	0
琉璃繁缕属	liu'li'fan'lv'shu	0
榴莲属	liu'lian'shu	0
柳杉属	liu'shan'shu	0
柳属	liu'shu	0
流苏树	liu'su'shu	0
流苏树属	liu'su'shu'shu	0
流苏子属	liu'su'zi'shu	0
柳叶菜科	liu'ye'cai'ke	0
柳叶菜属	liu'ye'cai'shu	0
柳叶箬属	liu'ye'ruo'shu	0
柳叶绣线菊	liu'ye'xiu'xian'ju	0
六月雪	liu'yue'xue	0
六月雪属	liu'yue'xue'shu	0
瘤子草属	liu'zi'cao'shu	0
龙柏	long'bai	0
龙柏球	long'bai'qiu	0
龙常草属	long'chang'cao'shu	0
龙船草属	long'chuan'cao'shu	0
龙船花属	long'chuan'hua'shu	0
龙胆科	long'dan'ke	0
龙胆木属	long'dan'mu'shu	0
龙胆属	long'dan'shu	0
龙老根属	long'lao'gen'shu	0
龙脑香科	long'nao'xiang'ke	0
龙脑香属	long'nao'xiang'shu	0
龙舌兰科	long'she'lan'ke	0
龙舌兰属	long'she'lan'shu	0
龙头草属	long'tou'cao'shu	0
龙须海棠属	long'xu'hai'tang'shu	0
龙须柳	long'xu'liu	0
龙血树属	long'xue'shu'shu	0
龙牙草属	long'ya'cao'shu	0
龙眼属	long'yan'shu	0
龙爪槐	long'zhao'huai	0
龙爪柳	long'zhua'liu	0
龙爪茅属	long'zhua'mao'shu	0
龙爪枣	long'zhua'zao	0
龙爪紫花槐	long'zhua'zi'hua'huai	0
耧斗菜属	lou'dou'cai'shu	0
漏斗苣苔属	lou'dou'ju'tai'shu	0
楼梯草属	lou'ti'cao'shu	0
路边青属	lu'bian'qing'shu	0
露兜树科	lu'dou'shu'ke	0
露兜树属	lu'dou'shu'shu	0
颅果草属	lu'guo'cao'shu	0
芦荟属	lu'hui'shu	0
鹿霍属	lu'huo'shu	0
鹿角兰属	lu'jiao'lan'shu	0
鹿角藤属	lu'jiao'teng'shu	0
栌菊木属	lu'ju'mu'shu	0
陆均松属	lu'jun'song'shu	0
芦莉草属	lu'li'cao'shu	0
鹿茸木属	lu'rong'mu'shu	0
鹭鸶兰属	lu'si'lan'shu	0
鹿蹄草科	lu'ti'cao'ke	0
鹿蹄草属	lu'ti'cao'shu	0
芦苇属	lu'wei'shu	0
鹿药属	lu'yao'shu	0
露珠草属	lu'zhu'cao'shu	0
芦竹属	lu'zhu'shu	0
露籽草属	lu'zi'cao'shu	0
栾树	luan'shu	0
栾树属	luan'shu'shu	0
孪叶豆属	luan'ye'dou'shu	0
乱子草属	luan'zi'cao'shu	0
轮冠木属	lun'guan'mu'shu	0
轮环藤属	lun'huan'teng'shu	0
轮叶黑藻	lun'ye'hei'zao	0
萝卜属	luo'bo'shu	0
罗布麻属	luo'bu'ma'shu	0
罗顿豆属	luo'dun'dou'shu	0
萝芙木属	luo'fu'mu'shu	0
裸果木属	luo'guo'mu'shu	0
罗汉柏属	luo'han'bai'shu	0
罗汉松	luo'han'song	0
罗汉松球	luo'han'song'qiu	0
罗汉松属	luo'han'song'shu	0
裸花草属	luo'hua'cao'shu	0
落花生属	luo'hua'sheng'shu	0
螺喙荠属	luo'hui'ji'shu	0
落葵科	luo'kui'ke	0
落葵属	luo'kui'shu	0
落葵薯属	luo'kui'shu'shu	0
罗勒属	luo'le'shu	0
落芒草属	luo'mang'cao'shu	0
萝藦科	luo'mo'ke	0
萝藦属	luo'mo'shu	0
罗伞属	luo'san'shu	0
络石	luo'shi	0
络石属	luo'shi'shu	0
骆驼刺属	luo'tuo'ci'shu	0
骆驼蓬属	luo'tuo'peng'shu	0
裸菀属	luo'wan'shu	0
落尾木属	luo'wei'mu'shu	0
落新妇	luo'xin'fu	0
螺序草属	luo'xu'cao'shu	0
落檐属	luo'yan'shu	0
落叶松属	luo'ye'song'shu	0
落羽杉	luo'yu'shan	0
落羽松属	luo'yu'song'shu	0
裸芸香属	luo'yun'xiang'shu	0
罗志藤属	luo'zhi'teng'shu	0
裸柱菊属	luo'zhu'ju'shu	0
葎草属	lv'cao'shu	0
驴臭草属	lv'chou'cao'shu	0
驴豆属	lv'dou'shu	0
绿梅	lv'mei	0
绿绒篙属	lv'rong'gao'shu	0
驴蹄草属	lv'ti'cao'shu	0
绿叶碧桃	lv'ye'bi'tao	0
马鞍树属	ma'an'shu'shu	0
马鞭草科	ma'bian'cao'ke	0
马鞭草属	ma'bian'cao'shu	0
马贬儿属	ma'bian'er'shu	0
马齿苋科	ma'chi'xian'ke	0
马齿苋属	ma'chi'xian'shu	0
马蛋果属	ma'dan'guo'shu	0
马兜铃科	ma'dou'ling'ke	0
马兜铃属	ma'dou'ling'shu	0
麻疯树属	ma'feng'shu'shu	0
麻核藤属	ma'he'teng'shu	0
麻花头属	ma'hua'tou'shu	0
麻黄	ma'huang	0
麻黄科	ma'huang'ke	0
麻黄属	ma'huang'shu	0
马甲子属	ma'jia'zi'shu	0
马兰	ma'lan	0
马兰木属	ma'lan'mu'shu	0
马蓝属	ma'lan'shu	0
马兰属	ma'lan'shu	0
马兰藤属	ma'lan'teng'shu	0
马利筋属	ma'li'jin'shu	0
马莲鞍属	ma'lian'an'shu	0
麻楝属	ma'lian'shu	0
马铃苣苔属	ma'ling'ju'tai'shu	0
玛瑙石榴	ma'nao'shi'liu	0
马尼拉草	ma'ni'la'cao	0
马钱科	ma'qian'ke	0
马钱属	ma'qian'shu	0
马桑科	ma'sang'ke	0
马桑属	ma'sang'shu	0
马蹄果属	ma'ti'guo'shu	0
马蹄荷属	ma'ti'he'shu	0
马蹄黄属	ma'ti'huang'shu	0
马蹄筋草	ma'ti'jin'cao	0
马蹄金属	ma'ti'jin'shu	0
马蹄莲属	ma'ti'lian'shu	0
马蹄芹属	ma'ti'qin'shu	0
马蹄香属	ma'ti'xiang'shu	0
麻菀属	ma'wan'shu	0
马尾树科	ma'wei'shu'ke	0
马尾树属	ma'wei'shu'shu	0
马缨丹属	ma'ying'dan'shu	0
蚂蚱腿子	ma'zha'tui'zi	0
蚂蚱腿子属	ma'zha'tui'zi'shu	0
马醉木属	ma'zui'mu'shu	0
麦冬草	mai'dong'cao	0
买麻藤科	mai'ma'teng'ke	0
买麻藤属	mai'ma'teng'shu	0
麦仙翁属	mai'xian'weng'shu	0
麦珠子属	mai'zhu'zi'shu	0
蔓长春花属	man'chang'chun'hua'shu	0
曼海姆月季	man'hai'mu'yue'ji	0
蔓虎刺属	man'hu'ci'shu	0
蔓芹属	man'qin'shu	0
馒头柳	man'tou'liu	0
芒苞草属	mang'bao'cao'shu	0
芒柄花属	mang'bing'hua'shu	0
杧果属	mang'guo'shu	0
芒麦草属	mang'mai'cao'shu	0
芒毛苣苔属	mang'mao'ju'tai'shu	0
牻牛儿苗科	mang'niu'er'miao'ke	0
牻牛儿苗属	mang'niu'er'miao'shu	0
芒属	mang'shu	0
毛白杨	mao'bai'yang	0
毛茶属	mao'cha'shu	0
毛车藤属	mao'che'teng'shu	0
毛稠李	mao'chou'li	0
毛刺槐	mao'ci'huai	0
毛丁香	mao'ding'xiang	0
猫儿菊属	mao'er'ju'shu	0
猫儿子属	mao'er'zi'shu	0
茅膏菜科	mao'gao'cai'ke	0
茅膏菜属	mao'gao'cai'shu	0
毛茛科	mao'gen'ke	0
茅根属	mao'gen'shu	0
毛茛属	mao'gen'shu	0
毛梗兰属	mao'geng'lan'shu	0
茅瓜属	mao'gua'shu	0
毛冠菊属	mao'guan'ju'shu	0
毛果草属	mao'guo'cao'shu	0
毛果苦木	mao'guo'ku'mu	0
毛果绣线菊	mao'guo'xiu'xian'ju	0
毛核木属	mao'he'mu'shu	0
毛胡枝子	mao'hu'zhi'zi	0
毛花瑞香属	mao'hua'rui'xiang'shu	0
毛黄栌	mao'huang'lu	0
毛俭草属	mao'jian'cao'shu	0
毛接骨木	mao'jie'gu'mu	0
毛鹃	mao'juan	0
毛兰属	mao'lan'shu	0
毛棱芹属	mao'leng'qin'shu	0
毛连菜属	mao'lian'cai'shu	0
毛莨泽泻属	mao'liang'ze'xie'shu	0
茅莓悬钩子	mao'mei'xuan'gou'zi	0
毛蒙古桑	mao'meng'gu'sang	0
毛木耳	mao'mu'er	0
毛泡桐	mao'pao'tong	0
猫乳属	mao'ru'shu	0
帽蕊草属	mao'rui'cao'shu	0
毛蕊草属	mao'rui'cao'shu	0
毛蕊菊属	mao'rui'ju'shu	0
毛舌兰属	mao'she'lan'shu	0
毛束草属	mao'shu'cao'shu	0
猫尾树属	mao'wei'shu'shu	0
茅香属	mao'xiang'shu	0
毛药花属	mao'yao'hua'shu	0
毛药苣苔属	mao'yao'ju'tai'shu	0
毛药藤属	mao'yao'teng'shu	0
毛颖草属	mao'ying'cao'shu	0
毛樱桃	mao'ying'tao	0
毛竹	mao'zhu	0
帽柱木属	mao'zhu'mu'shu	0
毛竹属	mao'zhu'shu	0
毛足菊属	mao'zu'ju'shu	0
霉草科	mei'cao'ke	0
霉草属	mei'cao'shu	0
美登木属	mei'deng'mu'shu	0
美冠兰属	mei'guan'lan'shu	0
玫瑰木属	mei'gui'mu'shu	0
玫瑰树属	mei'gui'shu'shu	0
美国薄荷属	mei'guo'bo'he'shu	0
美国短叶松	mei'guo'duan'ye'song	0
美国花曲柳	mei'guo'hua'qu'liu	0
美国黄松	mei'guo'huang'song	0
美国梧桐	mei'guo'wu'tong	0
美国五叶松	mei'guo'wu'ye'song	0
美国五针松	mei'guo'wu'zhen'song	0
美国榆	mei'guo'yu	0
美花草属	mei'hua'cao'shu	0
梅兰属	mei'lan'shu	0
美人蕉科	mei'ren'jiao'ke	0
美人蕉属	mei'ren'jiao'shu	0
美人梅	mei'ren'mei	0
美桐	mei'tong	0
美味牛肝菌	mei'wei'niu'gan'jun	0
栂樱属	mei'ying'shu	0
美柱草属	mei'zhu'cao'shu	0
蒙篙子属	meng'gao'zi'shu	0
蒙古椴	meng'gu'duan	0
蒙古柳	meng'gu'liu	0
蒙古桑	meng'gu'sang	0
蒙古柞	meng'gu'zuo	0
檬果樟属	meng'guo'zhang'shu	0
勐腊藤属	meng'la'teng'shu	0
萌芽松	meng'ya'song	0
迷迭香属	mi'die'xiang'shu	0
蜜蜂花属	mi'feng'hua'shu	0
迷果芹属	mi'guo'qin'shu	0
猕猴桃	mi'hou'tao	0
猕猴桃科	mi'hou'tao'ke	0
猕猴桃属	mi'hou'tao'shu	0
密花豆属	mi'hua'dou'shu	0
密花兰属	mi'hua'lan'shu	0
米花树科	mi'hua'shu'ke	0
密花树属	mi'hua'shu'shu	0
密花藤属	mi'hua'teng'shu	0
米口袋属	mi'kou'dai'shu	0
密脉木属	mi'mai'mu'shu	0
米面蓊属	mi'mian'weng'shu	0
密穗桔梗属	mi'sui'jie'geng'shu	0
米团花属	mi'tuan'hua'shu	0
密叶苣苔属	mi'ye'ju'tai'shu	0
米仔兰属	mi'zai'lan'shu	0
蜜茱萸属	mi'zhu'yu'shu	0
密子豆属	mi'zi'dou'shu	0
绵参属	mian'can'shu	0
绵刺属	mian'ci'shu	0
绵果荠属	mian'guo'ji'shu	0
绵果芹属	mian'guo'qin'shu	0
棉藜属	mian'li'shu	0
棉毛草属	mian'mao'cao'shu	0
缅茄属	mian'qie'shu	0
绵穗苏属	mian'sui'su'shu	0
绵枣儿属	mian'zao'er'shu	0
苗木名称	miao'mu'ming'cheng	0
皿果草属	min'guo'cao'shu	0
明党参属	ming'dang'shen'shu	0
膜萼花属	mo'e'hua'shu	0
膜稃草属	mo'fu'cao'shu	0
墨鳞木属	mo'lin'mu'shu	0
魔芋属	mo'yu'shu	0
木瓣树属	mu'ban'shu'shu	0
牡丹草属	mu'dan'cao'shu	0
木豆属	mu'dou'shu	0
牧豆树属	mu'dou'shu'shu	0
木防己属	mu'fang'ji'shu	0
木芙蓉	mu'fu'rong	0
牧根草属	mu'gen'cao'shu	0
木瓜	mu'gua	0
木瓜属	mu'gua'shu	0
木果楝属	mu'guo'lian'shu	0
木荷	mu'he	0
木姜子属	mu'jiang'zi'shu	0
木槿	mu'jin	0
木槿属	mu'jin'shu	0
牡荆属	mu'jing'shu	0
木桔属	mu'ju'shu	0
木兰科	mu'lan'ke	0
木兰属	mu'lan'shu	0
木榄属	mu'lan'shu	0
木藜芦属	mu'li'lu'shu	0
木莲属	mu'lian'shu	0
木麻黄科	mu'ma'huang'ke	0
木麻黄属	mu'ma'huang'shu	0
木莓属	mu'mei'shu	0
木棉科	mu'mian'ke	0
木棉属	mu'mian'shu	0
木奶果属	mu'nai'guo'shu	0
木苹果属	mu'ping'guo'shu	0
木薯属	mu'shu'shu	0
木通	mu'tong	0
木筒篙属	mu'tong'gao'shu	0
木通科	mu'tong'ke	0
木通属	mu'tong'shu	0
木樨科	mu'xi'ke	0
木犀科	mu'xi'ke	0
木犀榄属	mu'xi'lan'shu	0
木犀属	mu'xi'shu	0
木香	mu'xiang	0
木绣球	mu'xiu'qiu	0
苜蓿属	mu'xu'shu	0
牡竹属	mu'zhu'shu	0
纳茜菜属	na'qian'cai'shu	0
奶子藤属	nai'zi'teng'shu	0
南方红豆杉	nan'fang'hong'dou'shan	0
南瓜属	nan'gua'shu	0
南芥属	nan'jie'shu	0
南美稔属	nan'mei'ren'shu	0
南山藤属	nan'shan'teng'shu	0
南蛇藤	nan'she'teng	0
南蛇藤属	nan'she'teng'shu	0
楠属	nan'shu	0
南酸枣属	nan'suan'zao'shu	0
南天竺	nan'tian'zhu	0
南天竹属	nan'tian'zhu'shu	0
南亚苦荬菜属	nan'ya'ku'mai'cai'shu	0
南洋参属	nan'yang'can'shu	0
南洋杉科	nan'yang'sha'ke	0
南烛属	nan'zhu'shu	0
囊瓣木属	nang'ban'mu'shu	0
囊瓣芹属	nang'ban'qin'shu	0
囊苞花属	nang'bao'hua'shu	0
囊稃竹属	nang'fu'zhu'shu	0
囊舌兰属	nang'she'lan'shu	0
囊颖草属	nang'ying'cao'shu	0
拟艾脑属	ni'ai'nao'shu	0
拟大豆属	ni'da'dou'shu	0
拟单性木兰属	ni'dan'xing'mu'lan'shu	0
拟地皮消属	ni'di'pi'xiao'shu	0
泥胡菜属	ni'hu'cai'shu	0
拟花蔺属	ni'hua'lin'shu	0
拟金茅属	ni'jin'mao'shu	0
拟九节属	ni'jiu'jie'shu	0
拟南芥属	ni'nan'jie'shu	0
拟水晶兰属	ni'shui'jing'lan'shu	0
拟紫草属	ni'zi'cao'shu	0
念珠芥属	nian'zhu'jie'shu	0
念珠藤属	nian'zhu'teng'shu	0
鸟巢兰属	niao'chao'lan'shu	0
茑萝属	niao'luo'shu	0
鸟舌兰属	niao'she'lan'shu	0
鸟头荠属	niao'tou'ji'shu	0
鸟足兰属	niao'zu'lan'shu	0
牛蒡属	niu'bang'shu	0
牛鼻栓属	niu'bi'shuan'shu	0
牛鞭草属	niu'bian'cao'shu	0
扭柄花属	niu'bing'hua'shu	0
牛齿兰属	niu'chi'lan'shu	0
牛果藤属	niu'guo'teng'shu	0
扭藿香属	niu'huo'xiang'shu	0
牛角瓜属	niu'jiao'gua'shu	0
牛角兰属	niu'jiao'lan'shu	0
牛筋藤属	niu'jin'teng'shu	0
牛筋条属	niu'jin'tiao'shu	0
扭靳子	niu'jin'zi	0
扭连钱属	niu'lian'qian'shu	0
牛奶菜属	niu'nai'cai'shu	0
牛漆姑草属	niu'qi'gu'cao'shu	0
牛舌草属	niu'she'cao'shu	0
牛栓藤科	niu'shuan'teng'ke	0
牛栓藤属	niu'shuan'teng'shu	0
牛膝菊属	niu'xi'ju'shu	0
牛膝属	niu'xi'shu	0
牛眼菊属	niu'yan'ju'shu	0
牛至属	niu'zhi'shu	0
纽子花属	niu'zi'hua'shu	0
脓疮草属	nong'chuang'cao'shu	0
暖木条子	nuan'mu'tiao'zi	0
糯米条	nuo'mi'tiao	0
挪威枫	nuo'wei'feng	0
挪威云杉	nuo'wei'yun'shan	0
女蒿属	nv'hao'shu	0
女娄菜属	nv'lou'cai'shu	0
女菀属	nv'wan'shu	0
女贞	nv'zhen	0
女贞属	nv'zhen'shu	0
欧白芥属	ou'bai'jie'shu	0
欧当归属	ou'dang'gui'shu	0
欧防风属	ou'fang'feng'shu	0
欧李	ou'li	0
欧芹属	ou'qin'shu	0
欧夏至草属	ou'xia'zhi'cao'shu	0
欧洲赤松	ou'zhou'chi'song	0
欧洲椴	ou'zhou'duan	0
爬地柏	pa'di'bai	0
爬兰属	pa'lan'shu	0
爬墙虎	pa'qiang'hu	0
爬山虎属	pa'shan'hu'shu	0
排钱草属	pai'qian'cao'shu	0
排香草属	pai'xiang'cao'shu	0
盘果草属	pan'guo'cao'shu	0
盘果菊属	pan'guo'ju'shu	0
盘槐	pan'huai	0
炮弹果属	pao'dan'guo'shu	0
泡果苘属	pao'guo'qing'shu	0
泡花树属	pao'hua'shu'shu	0
泡桐	pao'tong	0
炮仗花属	pao'zhang'hua'shu	0
泡竹属	pao'zhu'shu	0
喷瓜属	pen'gua'shu	0
盆架树属	pen'jia'shu'shu	0
盆距兰属	pen'ju'lan'shu	0
蓬莱藤属	peng'lai'teng'shu	0
蟚蜞菊属	peng'qi'ju'shu	0
披硷草属	pi'jian'cao'shu	0
枇杷	pi'pa	0
枇杷柴属	pi'pa'chai'shu	0
枇杷属	pi'pa'shu	0
偏瓣花属	pian'ban'hua'shu	0
偏穗姜属	pian'sui'jiang'shu	0
飘拂草属	piao'fu'cao'shu	0
平菇	ping'gu	0
苹果	ping'guo	0
苹果属	ping'guo'shu	0
瓶花木属	ping'hua'mu'shu	0
萍蓬草	ping'peng'cao	0
萍篷草属	ping'peng'cao'shu	0
瓶头菊属	ping'tou'ju'shu	0
平枝栒子	ping'zhi'xun'zi	0
破布木属	po'bu'mu'shu	0
珀菊属	po'ju'shu	0
坡垒属	po'lei'shu	0
坡柳属	po'liu'shu	0
婆罗门参属	po'luo'men'can'shu	0
婆婆娜	po'po'na	0
坡油甘属	po'you'gan'shu	0
蒲草属	pu'cao'shu	0
铺地柏	pu'di'bai	0
蒲公英属	pu'gong'ying'shu	0
蒲葵属	pu'kui'shu	0
朴树属	pu'shu'shu	0
葡萄	pu'tao	0
葡萄科	pu'tao'ke	0
葡萄属	pu'tao'shu	0
蒲桃属	pu'tao'shu	0
蒲苇属	pu'wei'shu	0
蕲艾属	qi'ai'shu	0
七瓣莲属	qi'ban'lian'shu	0
旗唇兰属	qi'chun'lan'shu	0
齐墩果	qi'dun'guo	0
旗竿芥属	qi'gan'jie'shu	0
漆姑草属	qi'gu'cao'shu	0
鳍蓟属	qi'ji'shu	0
七角白蔹	qi'jiao'bai'lian	0
七姐妹	qi'jie'mei	0
七筋菇属	qi'jin'gu'shu	0
麒麟尾属	qi'lin'wei'shu	0
桤木	qi'mu	0
棋盘花属	qi'pan'hua'shu	0
歧伞花属	qi'san'hua'shu	0
歧伞菊属	qi'san'ju'shu	0
槭属	qi'shu	0
漆树	qi'shu	0
槭树科	qi'shu'ke	0
漆树科	qi'shu'ke	0
漆树属	qi'shu'shu	0
齐头绒属	qi'tou'rong'shu	0
七叶树	qi'ye'shu	0
七叶树科	qi'ye'shu'ke	0
七叶树属	qi'ye'shu'shu	0
祈州漏卢属	qi'zhou'lou'lu'shu	0
棋子豆属	qi'zi'dou'shu	0
七子花属	qi'zi'hua'shu	0
洽草属	qia'cao'shu	0
铅笔柏	qian'bi'bai	0
茜草科	qian'cao'ke	0
茜草属	qian'cao'shu	0
前胡属	qian'hu'shu	0
钳喙兰瞩	qian'hui'lan'zhu	0
千解草属	qian'jie'cao'shu	0
千斤拔属	qian'jin'ba'shu	0
千金藤属	qian'jin'teng'shu	0
千金榆	qian'jin'yu	0
千金子属	qian'jin'zi'shu	0
黔苣苔属	qian'ju'tai'shu	0
千里光属	qian'li'guang'shu	0
荨麻科	qian'ma'ke	0
荨麻属	qian'ma'shu	0
千年健属	qian'nian'jian'shu	0
牵牛属	qian'niu'shu	0
千屈菜	qian'qu'cai	0
千屈菜科	qian'qu'cai'ke	0
千屈菜属	qian'qu'cai'shu	0
千日红属	qian'ri'hong'shu	0
千山山梅花	qian'shan'shan'mei'hua	0
芡实	qian'shi	0
芡实属	qian'shi'shu	0
千头柏	qian'tou'bai	0
千头椿	qian'tou'chun	0
千张纸属	qian'zhang'zhi'shu	0
千针苋属	qian'zhen'xian'shu	0
墙草属	qiang'cao'shu	0
枪刀药属	qiang'dao'yao'shu	0
羌活属	qiang'huo'shu	0
蔷薇	qiang'wei	0
蔷薇科	qiang'wei'ke	0
蔷薇属	qiang'wei'shu	0
鞘苞花属	qiao'bao'hua'shu	0
鞘柄木科	qiao'bing'mu'ke	0
鞘柄木属	qiao'bing'mu'shu	0
壳菜果属	qiao'cai'guo'shu	0
壳斗科	qiao'dou'ke	0
鞘花属	qiao'hua'shu	0
荞麦属	qiao'mai'shu	0
乔木类	qiao'mu'lei	0
鞘蕊属	qiao'rui'shu	0
茄科	qie'ke	0
伽蓝菜属	qie'lan'cai'shu	0
窃衣属	qie'yi'shu	0
秦岭藤属	qin'ling'teng'shu	0
芹属	qin'shu	0
芹叶荠属	qin'ye'ji'shu	0
清风藤科	qing'feng'teng'ke	0
清风藤属	qing'feng'teng'shu	0
青冈栎	qing'gang'li	0
青荚叶属	qing'jia'ye'shu	0
青楷槭	qing'kai'qi	0
青兰属	qing'lan'shu	0
青篱柴属	qing'li'chai'shu	0
苘麻属	qing'ma'shu	0
青梅属	qing'mei'shu	0
清明花属	qing'ming'hua'shu	0
轻木属	qing'mu'shu	0
青牛胆属	qing'niu'dan'shu	0
青钱柳属	qing'qian'liu'shu	0
青杄云杉	qing'qian'yun'shan	0
青藤属	qing'teng'shu	0
蜻蜓兰属	qing'ting'lan'shu	0
青桐	qing'tong	0
青葙属	qing'xiang'shu	0
青杨	qing'yang	0
琼豆属	qiong'dou'shu	0
琼花	qiong'hua	0
琼榄属	qiong'lan'shu	0
琼梅属	qiong'mei'shu	0
琼楠属	qiong'nan'shu	0
筇竹属	qiong'zhu'shu	0
琼棕属	qiong'zong'shu	0
球柄兰属	qiu'bing'lan'shu	0
秋分草属	qiu'fen'cao'shu	0
球根阿魏属	qiu'gen'a'wei'shu	0
球果荠属	qiu'guo'ji'shu	0
球果藤属	qiu'guo'teng'shu	0
球果紫堇属	qiu'guo'zi'jin'shu	0
秋海棠科	qiu'hai'tang'ke	0
秋海棠属	qiu'hai'tang'shu	0
秋胡颓子	qiu'hu'tui'zi	0
球花豆属	qiu'hua'dou'shu	0
毬菊属	qiu'ju'shu	0
球兰属	qiu'lan'shu	0
球米草属	qiu'mi'cao'shu	0
秋茄树属	qiu'qie'shu'shu	0
楸树	qiu'shu	0
球穗草属	qiu'sui'cao'shu	0
秋英属	qiu'ying'shu	0
球柱草属	qiu'zhu'cao'shu	0
球子草属	qiu'zi'cao'shu	0
曲苞芋属	qu'bao'yu'shu	0
曲唇兰属	qu'chun'lan'shu	0
屈曲花属	qu'qu'hua'shu	0
曲蕊花属	qu'rui'hua'shu	0
曲蕊马蓝属	qu'rui'ma'lan'shu	0
曲籽芋属	qu'zi'yu'shu	0
全唇花属	quan'chun'hua'shu	0
全唇兰属	quan'chun'lan'shu	0
全光菊属	quan'guang'ju'shu	0
全能花属	quan'neng'hua'shu	0
泉七属	quan'qi'shu	0
雀稗属	que'bai'shu	0
雀儿豆属	que'er'dou'shu	0
雀苣属	que'ju'shu	0
雀苣苔属	que'ju'tai'shu	0
雀脷珠属	que'li'zhu'shu	0
雀麦属	que'mai'shu	0
雀梅藤属	que'mei'teng'shu	0
雀舌黄杨球	que'she'huang'yang'qiu	0
鹊肾树属	que'shen'shu'shu	0
群心菜属	qun'xin'cai'shu	0
髯管花属	ran'guan'hua'shu	0
染木树属	ran'mu'shu'shu	0
荛花属	rao'hua'shu	0
忍冬	ren'dong	0
忍冬科	ren'dong'ke	0
忍冬属	ren'dong'shu	0
人面子属	ren'mian'zi'shu	0
人参属	ren'shen'shu	0
人字果属	ren'zi'guo'shu	0
日本地毯草	ri'ben'di'tan'cao	0
日本黑松	ri'ben'hei'song	0
日本厚朴	ri'ben'hou'pu	0
日本冷杉	ri'ben'leng'shan	0
日本柳杉	ri'ben'liu'shan	0
日本落叶松	ri'ben'luo'ye'song	0
日本晚樱	ri'ben'wan'ying	0
日本卫矛	ri'ben'wei'mao	0
日本绣线菊	ri'ben'xiu'xian'ju	0
日本樱花	ri'ben'ying'hua	0
绒果芹属	rong'guo'qin'shu	0
绒藜属	rong'li'shu	0
绒毛草属	rong'mao'cao'shu	0
榕属	rong'shu	0
肉苁蓉属	rou'cong'rong'shu	0
肉豆蔻科	rou'dou'kou'ke	0
肉荚草属	rou'jia'cao'shu	0
肉珊瑚属	rou'shan'hu'shu	0
肉实属	rou'shi'shu	0
肉穗草属	rou'sui'cao'shu	0
肉托果属	rou'tuo'guo'shu	0
肉药兰属	rou'yao'lan'shu	0
柔籽草属	rou'zi'cao'shu	0
乳豆属	ru'dou'shu	0
乳突果属	ru'tu'guo'shu	0
乳菀属	ru'wan'shu	0
软骨草属	ruan'gu'cao'shu	0
软枣子	ruan'zao'zi	0
锐齿鼠李	rui'chi'shu'li	0
蕊木属	rui'mu'shu	0
瑞香科	rui'xiang'ke	0
瑞香属	rui'xiang'shu	0
润肺草属	run'fei'cao'shu	0
润楠属	run'nan'shu	0
箬竹	ruo'zhu	0
箬竹属	ruo'zhu'shu	0
洒金柏	sa'jin'bai	0
洒金柏球	sa'jin'bai'qiu	0
赛黑桦	sai'hei'hua	0
赛金莲木属	sai'jin'lian'mu'shu	0
赛菊芋属	sai'ju'yu'shu	0
赛葵属	sai'kui'shu	0
赛楠属	sai'nan'shu	0
赛山蓝属	sai'shan'lan'shu	0
三白草	san'bai'cao	0
三瓣果属	san'ban'guo'shu	0
三宝木属	san'bao'mu'shu	0
三叉刺属	san'cha'ci'shu	0
伞花木属	san'hua'mu'shu	0
伞花蔷薇	san'hua'qiang'wei	0
三尖杉科	san'jian'shan'ke	0
三尖杉属	san'jian'shan'shu	0
三角瓣花属	san'jiao'ban'hua'shu	0
三角车属	san'jiao'che'shu	0
三角枫	san'jiao'feng	0
三肋果属	san'lei'guo'shu	0
三棱栎属	san'leng'li'shu	0
三裂瓜属	san'lie'gua'shu	0
三裂叶绣线菊	san'lie'ye'xiu'xian'ju	0
三芒草属	san'mang'cao'shu	0
三毛草属	san'mao'cao'shu	0
三七草属	san'qi'cao'shu	0
三七景天	san'qi'jing'tian	0
三蕊草属	san'rui'cao'shu	0
三蕊兰属	san'rui'lan'shu	0
三蕊柳	san'rui'liu	0
椮属	san'shu	0
三穗草属	san'sui'cao'shu	0
三台枸骨球	san'tai'gou'gu'qiu	0
散尾葵属	san'wei'kui'shu	0
三腺金丝桃属	san'xian'jin'si'tao'shu	0
三星果属	san'xing'guo'shu	0
伞形科	san'xing'ke	0
三桠钓樟	san'ya'diao'zhang	0
三叶地锦	san'ye'di'jin	0
三叶漆属	san'ye'qi'shu	0
三叶藤桔属	san'ye'teng'ju'shu	0
桑草属	sang'cao'shu	0
桑橙属	sang'cheng'shu	0
桑寄生科	sang'ji'sheng'ke	0
桑寄生属	sang'ji'sheng'shu	0
桑科	sang'ke	0
桑属	sang'shu	0
色赤杨	se'chi'yang	0
色萼花属	se'e'hua'shu	0
涩荠属	se'ji'shu	0
色木槭	se'mu'qi	0
沙鞭属	sha'bian'shu	0
沙地柏	sha'di'bai	0
沙拐枣属	sha'guai'zao'shu	0
莎禾属	sha'he'shu	0
沙棘	sha'ji	0
沙芥属	sha'jie'shu	0
沙兰杨	sha'lan'yang	0
杉木属	sha'mu'shu	0
沙蓬属	sha'peng'shu	0
沙朴	sha'pu	0
沙丘草属	sha'qiu'cao'shu	0
沙参属	sha'shen'shu	0
沙松	sha'song	0
沙穗属	sha'sui'shu	0
莎菀属	sha'wan'shu	0
砂苋属	sha'xian'shu	0
砂引草属	sha'yin'cao'shu	0
沙枣	sha'zao	0
沙针属	sha'zhen'shu	0
山白树属	shan'bai'shu'shu	0
山槟榔属	shan'bing'lang'shu	0
山橙属	shan'cheng'shu	0
山慈姑属	shan'ci'gu'shu	0
山地榄属	shan'di'lan'shu	0
山靛属	shan'dian'shu	0
山定子	shan'ding'zi	0
山豆根属	shan'dou'gen'shu	0
山矾科	shan'fan'ke	0
山柑科	shan'gan'ke	0
山拐枣属	shan'guai'zao'shu	0
山桂花属	shan'gui'hua'shu	0
山核桃属	shan'he'tao'shu	0
山荷叶属	shan'he'ye'shu	0
山黑豆属	shan'hei'dou'shu	0
山红树属	shan'hong'shu'shu	0
珊瑚	shan'hu	0
珊瑚菜属	shan'hu'cai'shu	0
珊瑚花属	shan'hu'hua'shu	0
山胡椒属	shan'hu'jiao'shu	0
珊瑚苣苔属	shan'hu'ju'tai'shu	0
珊瑚菌	shan'hu'jun	0
珊瑚兰属	shan'hu'lan'shu	0
珊瑚朴	shan'hu'pu	0
珊瑚球	shan'hu'qiu	0
珊瑚藤属	shan'hu'teng'shu	0
山花椒	shan'hua'jiao	0
山黄菊属	shan'huang'ju'shu	0
山黄麻属	shan'huang'ma'shu	0
山黄皮属	shan'huang'pi'shu	0
山茴香属	shan'hui'xiang'shu	0
山鸡谷草属	shan'ji'gu'cao'shu	0
山涧草属	shan'jian'cao'shu	0
山菅兰属	shan'jian'lan'shu	0
山姜属	shan'jiang'shu	0
山芥属	shan'jie'shu	0
杉科	shan'ke	0
山葵属	shan'kui'shu	0
山榄科	shan'lan'ke	0
山兰属	shan'lan'shu	0
山榄属	shan'lan'shu	0
山里红	shan'li'hong	0
山楝属	shan'lian'shu	0
山寥属	shan'liao'shu	0
山柳菊属	shan'liu'ju'shu	0
山柳科	shan'liu'ke	0
山琉璃草属	shan'liu'li'cao'shu	0
山柳属	shan'liu'shu	0
山龙眼科	shan'long'yan'ke	0
山龙眼属	shan'long'yan'shu	0
山萝卜属	shan'luo'bo'shu	0
山麻杆	shan'ma'gan	0
山麻杆属	shan'ma'gan'shu	0
山蚂蝗属	shan'ma'huang'shu	0
山麦冬属	shan'mai'dong'shu	0
山毛桃	shan'mao'tao	0
山莓草属	shan'mei'cao'shu	0
山梅花属	shan'mei'hua'shu	0
山茉莉芹属	shan'mo'li'qin'shu	0
山柰属	shan'nai'shu	0
山牛蒡属	shan'niu'bang'shu	0
山葡萄	shan'pu'tao	0
山芹属	shan'qin'shu	0
山桑	shan'sang	0
山珊瑚属	shan'shan'hu'shu	0
山檨子属	shan'she'zi'shu	0
扇穗茅属	shan'sui'mao'shu	0
山桃草属	shan'tao'cao'shu	0
山桃稠李	shan'tao'chou'li	0
鳝藤属	shan'teng'shu	0
山铜材属	shan'tong'cai'shu	0
山桐子属	shan'tong'zi'shu	0
山香属	shan'xiang'shu	0
山小桔属	shan'xiao'ju'shu	0
山杏	shan'xing	0
山芎属	shan'xiong'shu	0
山芫荽属	shan'yan'sui'shu	0
山杨	shan'yang	0
山羊草属	shan'yang'cao'shu	0
山羊豆属	shan'yang'dou'shu	0
山羊角树属	shan'yang'jiao'shu'shu	0
杉叶杜鹃属	shan'ye'du'juan'shu	0
杉叶藻科	shan'ye'zao'ke	0
杉叶藻属	shan'ye'zao'shu	0
山一笼鸡属	shan'yi'long'ji'shu	0
山樱桃	shan'ying'tao	0
山油柑属	shan'you'gan'shu	0
山萮菜属	shan'yu'cai'shu	0
山玉兰	shan'yu'lan	0
山皂角	shan'zao'jiao	0
山楂	shan'zha	0
山楂属	shan'zha'shu	0
山茱萸科	shan'zhu'yu'ke	0
山茱萸属	shan'zhu'yu'shu	0
山竹子	shan'zhu'zi	0
山竹子科	shan'zhu'zi'ke	0
山竹子科藤黄科	shan'zhu'zi'ke'teng'huang'ke	0
山竹子属	shan'zhu'zi'shu	0
商陆科	shang'lu'ke	0
商陆属	shang'lu'shu	0
上树南星属	shang'shu'nan'xing'shu	0
上天柳	shang'tian'liu	0
芍药属	shao'yao'shu	0
韶子属	shao'zi'shu	0
蛇白蔹	she'bai'lian	0
蛇鞭菊	she'bian'ju	0
蛇床属	she'chuang'shu	0
舌唇苣苔属	she'chun'ju'tai'shu	0
舌唇兰属	she'chun'lan'shu	0
射干属	she'gan'shu	0
蛇根草属	she'gen'cao'shu	0
蛇根叶属	she'gen'ye'shu	0
蛇菰科	she'gu'ke	0
蛇菰属	she'gu'shu	0
舌喙兰属	she'hui'lan'shu	0
蛇莓属	she'mei'shu	0
蛇目菊属	she'mu'ju'shu	0
蛇葡萄属	she'pu'tao'shu	0
蛇舌兰属	she'she'lan'shu	0
蛇藤属	she'teng'shu	0
蛇头荠属	she'tou'ji'shu	0
蛇尾草属	she'wei'cao'shu	0
射香兰属	she'xiang'lan'shu	0
舌柱麻属	she'zhu'ma'shu	0
肾苞草属	shen'bao'cao'shu	0
肾茶属	shen'cha'shu	0
肾果荠属	shen'guo'ji'shu	0
深山含笑	shen'shan'han'xiao	0
深山樱	shen'shan'ying	0
神香草属	shen'xiang'cao'shu	0
肾子藤属	shen'zi'teng'shu	0
省姑油	sheng'gu'you	0
省姑油科	sheng'gu'you'ke	0
胜红蓟属	sheng'hong'ji'shu	0
升麻属	sheng'ma'shu	0
省藤属	sheng'teng'shu	0
石斑木属	shi'ban'mu'shu	0
石笔木属	shi'bi'mu'shu	0
石菖蒲	shi'chang'pu	0
矢车菊属	shi'che'ju'shu	0
十大功劳属	shi'da'gong'lao'shu	0
湿地松	shi'di'song	0
石丁香属	shi'ding'xiang'shu	0
石豆兰属	shi'dou'lan'shu	0
十萼花属	shi'e'hua'shu	0
石柑属	shi'gan'shu	0
石海椒属	shi'hai'jiao'shu	0
石核木属	shi'he'mu'shu	0
石蝴蝶属	shi'hu'die'shu	0
石斛属	shi'hu'shu	0
石胡荽属	shi'hu'sui'shu	0
石荠苧属	shi'ji'ning'shu	0
石椒草属	shi'jiao'cao'shu	0
什锦丁香	shi'jin'ding'xiang	0
使君子科	shi'jun'zi'ke	0
使君子属	shi'jun'zi'shu	0
柿科	shi'ke	0
石栎	shi'li	0
石栗属	shi'li'shu	0
石莲属	shi'lian'shu	0
十裂葵属	shi'lie'kui'shu	0
莳萝属	shi'luo'shu	0
石楠	shi'nan	0
石楠球	shi'nan'qiu	0
石楠属	shi'nan'shu	0
蓍属	shi'shu	0
柿属	shi'shu	0
柿树	shi'shu	0
柿树科	shi'shu'ke	0
石蒜	shi'suan	0
石蒜科	shi'suan'ke	0
十万错属	shi'wan'cuo'shu	0
石仙桃属	shi'xian'tao'shu	0
时钟花科	shi'zhong'hua'ke	0
时钟花属	shi'zhong'hua'shu	0
石钟花属	shi'zhong'hua'shu	0
石竹科	shi'zhu'ke	0
石竹属	shi'zhu'shu	0
虱子草属	shi'zi'cao'shu	0
十字花科	shi'zi'hua'ke	0
十字苣苔属	shi'zi'ju'tai'shu	0
十字爵床属	shi'zi'jue'chuang'shu	0
十姊妹	shi'zi'mei	0
柿子树	shi'zi'shu	0
石梓属	shi'zi'shu	0
手参属	shou'can'shu	0
绶草属	shou'cao'shu	0
瘦房兰属	shou'fang'lan'shu	0
守宫木属	shou'gong'mu'shu	0
寿星桃	shou'xing'tao	0
鼠鞭草属	shu'bian'cao'shu	0
树参属	shu'can'shu	0
鼠刺科	shu'ci'ke	0
鼠刺属	shu'ci'shu	0
蜀桧	shu'gui	0
蜀桧球	shu'gui'qiu	0
疏花马蓝属	shu'hua'ma'lan'shu	0
树锦鸡儿	shu'jin'ji'er	0
蜀葵	shu'kui	0
蜀葵属	shu'kui'shu	0
鼠李科	shu'li'ke	0
鼠李属	shu'li'shu	0
树罗卜属	shu'luo'bu'shu	0
鼠毛菊属	shu'mao'ju'shu	0
属名刺参属	shu'ming'ci'shen'shu	0
属名梵天花属	shu'ming'fan'tian'hua'shu	0
属名南洋杉属	shu'ming'nan'yang'sha'shu	0
曙南芥属	shu'nan'jie'shu	0
鼠皮树属	shu'pi'shu'shu	0
鼠曲草属	shu'qu'cao'shu	0
黍属	shu'shu	0
鼠尾草属	shu'wei'cao'shu	0
束尾草属	shu'wei'cao'shu	0
鼠尾粟属	shu'wei'su'shu	0
薯蓣科	shu'yu'ke	0
薯蓣属	shu'yu'shu	0
数珠珊瑚属	shu'zhu'shan'hu'shu	0
栓翅芹属	shuan'chi'qin'shu	0
栓果菊属	shuan'guo'ju'shu	0
栓果芹属	shuan'guo'qin'shu	0
栓槲栎	shuan'hu'li	0
栓皮栎	shuan'pi'li	0
栓皮槭	shuan'pi'qi	0
双孢蘑菇	shuang'bao'mo'gu	0
双臂兰属	shuang'bi'lan'shu	0
双翅爵床属	shuang'chi'jue'chuang'shu	0
双唇兰属	shuang'chun'lan'shu	0
双袋兰属	shuang'dai'lan'shu	0
双盾木属	shuang'dun'mu'shu	0
双果荠属	shuang'guo'ji'shu	0
双花草属	shuang'hua'cao'shu	0
双花木属	shuang'hua'mu'shu	0
双脊荠属	shuang'ji'ji'shu	0
双荚决明	shuang'jia'jue'ming	0
双球芹属	shuang'qiu'qin'shu	0
双蕊兰属	shuang'rui'lan'shu	0
双丸兰属	shuang'wan'lan'shu	0
双柱蛇菰属	shuang'zhu'she'gu'shu	0
双籽藤属	shuang'zi'teng'shu	0
水柏枝属	shui'bai'zhi'shu	0
水鳖	shui'bie	0
水鳖科	shui'bie'ke	0
水鳖属	shui'bie'shu	0
睡菜属	shui'cai'shu	0
水车前	shui'che'qian	0
水车前属	shui'che'qian'shu	0
水葱	shui'cong	0
水东哥科	shui'dong'ge'ke	0
水东哥属	shui'dong'ge'shu	0
水飞蓟属	shui'fei'ji'shu	0
水甘草属	shui'gan'cao'shu	0
水鬼蕉属	shui'gui'jiao'shu	0
水禾	shui'he	0
水禾属	shui'he'shu	0
水葫芦苗属	shui'hu'lu'miao'shu	0
水黄皮属	shui'huang'pi'shu	0
水茴草属	shui'hui'cao'shu	0
水棘针属	shui'ji'zhen'shu	0
水角属	shui'jiao'shu	0
水锦树属	shui'jin'shu'shu	0
水晶兰科	shui'jing'lan'ke	0
水晶兰属	shui'jing'lan'shu	0
水蜡	shui'la	0
水腊树	shui'la'shu	0
水蜡烛属	shui'la'zhu'shu	0
睡莲	shui'lian	0
睡莲科	shui'lian'ke	0
睡莲属	shui'lian'shu	0
水柳属	shui'liu'shu	0
水龙属	shui'long'shu	0
水马齿科	shui'ma'chi'ke	0
水马齿属	shui'ma'chi'shu	0
水麻属	shui'ma'shu	0
水麦冬科	shui'mai'dong'ke	0
水麦冬属	shui'mai'dong'shu	0
水毛茛属	shui'mao'gen'shu	0
水茅属	shui'mao'shu	0
水芹属	shui'qin'shu	0
水青冈属	shui'qing'gang'shu	0
水青树科	shui'qing'shu'ke	0
水青树属	shui'qing'shu'shu	0
水曲柳	shui'qu'liu	0
水榕属	shui'rong'shu	0
水筛属	shui'shai'shu	0
水杉	shui'shan	0
水杉属	shui'shan'shu	0
水石衣属	shui'shi'yi'shu	0
水丝梨属	shui'si'li'shu	0
水丝麻属	shui'si'ma'shu	0
水松	shui'song	0
水松属	shui'song'shu	0
水苏属	shui'su'shu	0
水莎草属	shui'suo'cao'shu	0
水蓑衣属	shui'suo'yi'shu	0
水塔花属	shui'ta'hua'shu	0
水团花属	shui'tuan'hua'shu	0
水蕹科	shui'weng'ke	0
水蕹属	shui'weng'shu	0
水苋菜属	shui'xian'cai'shu	0
水仙属	shui'xian'shu	0
水栒子	shui'xun'zi	0
水椰属	shui'ye'shu	0
水罂粟	shui'ying'su	0
水芋	shui'yu	0
水榆	shui'yu	0
水娱蚣属	shui'yu'gong'shu	0
水芋属	shui'yu'shu	0
水玉簪科	shui'yu'zan'ke	0
水玉簪属	shui'yu'zan'shu	0
水芫花属	shui'yuan'hua'shu	0
水蔗草属	shui'zhe'cao'shu	0
水竹草属	shui'zhu'cao'shu	0
水竹叶属	shui'zhu'ye'shu	0
蒴莲属	shuo'lian'shu	0
丝瓣芹属	si'ban'qin'shu	0
四苞蓝属	si'bao'lan'shu	0
四齿芥属	si'chi'jie'shu	0
丝粉藻属	si'fen'zao'shu	0
丝瓜属	si'gua'shu	0
四合木属	si'he'mu'shu	0
四季丁香	si'ji'ding'xiang	0
四季桂	si'ji'gui	0
四季锦带	si'ji'jin'dai	0
四季竹	si'ji'zhu	0
四角果科	si'jiao'guo'ke	0
丝兰	si'lan	0
丝兰属	si'lan'shu	0
思劳竹属	si'lao'zhu'shu	0
四棱草属	si'leng'cao'shu	0
四棱豆属	si'leng'dou'shu	0
四棱荠属	si'leng'ji'shu	0
四轮香属	si'lun'xiang'shu	0
四脉麻属	si'mai'ma'shu	0
思茅藤属	si'mao'teng'shu	0
丝绵木	si'mian'mu	0
丝石竹属	si'shi'zhu'shu	0
四数金丝桃属	si'shu'jin'si'tao'shu	0
四数苣苔属	si'shu'ju'tai'shu	0
四数木科	si'shu'mu'ke	0
四数木属	si'shu'mu'shu	0
四台枸骨球	si'tai'gou'gu'qiu	0
四药门花属	si'yao'men'hua'shu	0
丝叶芥属	si'ye'jie'shu	0
丝叶芹属	si'ye'qin'shu	0
四照花科	si'zhao'hua'ke	0
四照花属	si'zhao'hua'shu	0
嵩草属	song'cao'shu	0
松科	song'ke	0
菘蓝属	song'lan'shu	0
松萝科	song'luo'ke	0
松茸	song'rong	0
松属	song'shu	0
松下兰属	song'xia'lan'shu	0
溲疏	sou'shu	0
溲疏属	sou'shu'shu	0
宿苞豆属	su'bao'dou'shu	0
宿苞兰属	su'bao'lan'shu	0
粟草属	su'cao'shu	0
宿萼木属	su'e'mu'shu	0
宿根地被花卉	su'gen'di'bei'hua'hui	0
宿根福禄考	su'gen'fu'lu'kao	0
粟麻属	su'ma'shu	0
粟米草科	su'mi'cao'ke	0
粟米草属	su'mi'cao'shu	0
苏木科	su'mu'ke	0
速生柳	su'sheng'liu	0
苏铁	su'tie	0
苏铁科	su'tie'ke	0
苏铁属	su'tie'shu	0
素心腊梅	su'xin'la'mei	0
素馨属	su'xin'shu	0
酸豆属	suan'dou'shu	0
酸果蔓属	suan'guo'man'shu	0
酸脚杆属	suan'jiao'gan'shu	0
酸模芒属	suan'mo'mang'shu	0
酸模属	suan'mo'shu	0
算盘子属	suan'pan'zi'shu	0
酸藤子属	suan'teng'zi'shu	0
酸枣	suan'zao	0
算珠豆属	suan'zhu'dou'shu	0
酸竹属	suan'zhu'shu	0
酸子	suan'zi	0
穗花韭属	sui'hua'jiu'shu	0
穗花杉属	sui'hua'shan'shu	0
碎米荠属	sui'mi'ji'shu	0
笋兰属	sun'lan'shu	0
莎草科	suo'cao'ke	0
莎草兰属	suo'cao'lan'shu	0
莎草属	suo'cao'shu	0
梭果爵床属	suo'guo'jue'chuang'shu	0
梭梭属	suo'suo'shu	0
锁阳属	suo'yang'shu	0
梭鱼草	suo'yu'cao	0
梭子果属	suo'zi'guo'shu	0
塔形罗汉松	ta'xing'luo'han'song	0
台地黄属	tai'di'huang'shu	0
太行花属	tai'hang'hua'shu	0
太行菊属	tai'hang'ju'shu	0
泰来藻属	tai'lai'zao'shu	0
太平花	tai'ping'hua	0
台钱草属	tai'qian'cao'shu	0
苔属	tai'shu	0
台湾杉属	tai'wan'shan'shu	0
台湾五加属	tai'wan'wu'jia'shu	0
泰竹属	tai'zhu'shu	0
坛花兰属	tan'hua'lan'shu	0
昙花属	tan'hua'shu	0
檀栗属	tan'li'shu	0
檀梨属	tan'li'shu	0
檀属	tan'shu	0
檀香科	tan'xiang'ke	0
唐菖蒲属	tang'chang'pu'shu	0
唐棣属	tang'di'shu	0
糖芥属	tang'jie'shu	0
棠梨	tang'li	0
糖蜜草属	tang'mi'cao'shu	0
糖槭	tang'qi	0
唐松草属	tang'song'cao'shu	0
唐竹属	tang'zhu'shu	0
桃儿七属	tao'er'qi'shu	0
桃花心木属	tao'hua'xin'mu'shu	0
桃金娘科	tao'jin'niang'ke	0
桃金娘属	tao'jin'niang'shu	0
桃榄属	tao'lan'shu	0
桃色忍冬	tao'se'ren'dong	0
桃树	tao'shu	0
套叶兰属	tao'ye'lan'shu	0
桃叶珊瑚	tao'ye'shan'hu	0
桃叶珊瑚属	tao'ye'shan'hu'shu	0
桃叶卫矛	tao'ye'wei'mao	0
藤本类	teng'ben'lei	0
藤春属	teng'chun'shu	0
藤槐属	teng'huai'shu	0
藤黄科	teng'huang'ke	0
藤梨竹属	teng'li'zhu'shu	0
藤露兜属	teng'lu'dou'shu	0
藤麻属	teng'ma'shu	0
藤牡丹属	teng'mu'dan'shu	0
藤漆属	teng'qi'shu	0
藤山柳属	teng'shan'liu'shu	0
腾小檗	teng'xiao'bo	0
藤芋属	teng'yu'shu	0
藤枣属	teng'zao'shu	0
梯牧草属	ti'mu'cao'shu	0
梯木属	ti'mu'shu	0
甜菜属	tian'cai'shu	0
田葱科	tian'cong'ke	0
田葱属	tian'cong'shu	0
天鹅绒黄波罗	tian'e'rong'huang'bo'luo	0
田繁缕属	tian'fan'lv'shu	0
甜瓜属	tian'gua'shu	0
甜果藤属	tian'guo'teng'shu	0
天胡荽属	tian'hu'sui'shu	0
田基黄属	tian'ji'huang'shu	0
田基麻科	tian'ji'ma'ke	0
田基麻属	tian'ji'ma'shu	0
天芥菜属	tian'jie'cai'shu	0
田菁属	tian'jing'shu	0
甜菊属	tian'ju'shu	0
天葵属	tian'kui'shu	0
天蓝绣球属	tian'lan'xiu'qiu'shu	0
天料木科	tian'liao'mu'ke	0
天栌属	tian'lu'shu	0
天麻	tian'ma	0
天麻属	tian'ma'shu	0
田麻属	tian'ma'shu	0
甜茅属	tian'mao'shu	0
天门冬属	tian'men'dong'shu	0
天名精属	tian'ming'jing'shu	0
天目琼花	tian'mu'qiong'hua	0
天南星科	tian'nan'xing'ke	0
天南星属	tian'nan'xing'shu	0
天女木兰	tian'nv'mu'lan	0
天人菊属	tian'ren'ju'shu	0
天山芹属	tian'shan'qin'shu	0
天山蓍属	tian'shan'shi'shu	0
天山邪蒿属	tian'shan'xie'hao'shu	0
天山泽芹属	tian'shan'ze'qin'shu	0
天仙藤属	tian'xian'teng'shu	0
天星藤属	tian'xing'teng'shu	0
天竺葵属	tian'zhu'kui'shu	0
条果芥属	tiao'guo'jie'shu	0
贴梗海棠	tie'geng'hai'tang	0
铁筷子属	tie'kuai'zi'shu	0
铁榄属	tie'lan'shu	0
铁力木属	tie'li'mu'shu	0
铁木属	tie'mu'shu	0
铁破锣属	tie'po'luo'shu	0
铁青树科	tie'qing'shu'ke	0
铁青树属	tie'qing'shu'shu	0
铁杉属	tie'shan'shu	0
铁苋菜属	tie'xian'cai'shu	0
铁线莲	tie'xian'lian	0
铁线莲属	tie'xian'lian'shu	0
铁线子属	tie'xian'zi'shu	0
铁仔属	tie'zai'shu	0
庭菖蒲属	ting'chang'pu'shu	0
庭荠属	ting'ji'shu	0
葶菊属	ting'ju'shu	0
葶苈属	ting'li'shu	0
莛子藨属	ting'zi'biao'shu	0
同瓣草属	tong'ban'cao'shu	0
筒瓣兰属	tong'ban'lan'shu	0
铜锤玉带草属	tong'chui'yu'dai'cao'shu	0
筒冠花属	tong'guan'hua'shu	0
桐花树属	tong'hua'shu'shu	0
筒距兰属	tong'ju'lan'shu	0
铜色牛肝菌	tong'se'niu'gan'jun	0
筒穗草属	tong'sui'cao'shu	0
通脱木属	tong'tuo'mu'shu	0
同心结属	tong'xin'jie'shu	0
筒轴茅属	tong'zhou'mao'shu	0
透骨草科	tou'gu'cao'ke	0
透骨草属	tou'gu'cao'shu	0
头九节属	tou'jiu'jie'shu	0
头蕊兰属	tou'rui'lan'shu	0
头嘴苣属	tou'zui'ju'shu	0
秃疮花属	tu'chuang'hua'shu	0
兔唇花属	tu'chun'hua'shu	0
土丁桂属	tu'ding'gui'shu	0
兔儿风属	tu'er'feng'shu	0
兔儿伞属	tu'er'san'shu	0
土伏苓	tu'fu'ling	0
兔苣属	tu'ju'shu	0
菟葵属	tu'kui'shu	0
土连翘属	tu'lian'qiao'shu	0
土圞儿属	tu'luan'er'shu	0
土密树属	tu'mi'shu'shu	0
土楠属	tu'nan'shu	0
土人参属	tu'ren'can'shu	0
菟丝子属	tu'si'zi'shu	0
土田七属	tu'tian'qi'shu	0
兔尾草属	tu'wei'cao'shu	0
团花属	tuan'hua'shu	0
团扇荠属	tuan'shan'ji'shu	0
豚草属	tun'cao'shu	0
臀果木属	tun'guo'mu'shu	0
驼峰藤属	tuo'feng'teng'shu	0
脱喙荠属	tuo'hui'ji'shu	0
托盘幌	tuo'pan'huang	0
驼绒藜属	tuo'rong'li'shu	0
驼舌草属	tuo'she'cao'shu	0
橐吾属	tuo'wu'shu	0
洼瓣花属	wa'ban'hua'shu	0
娃儿藤属	wa'er'teng'shu	0
瓦莲属	wa'lian'shu	0
瓦松属	wa'song'shu	0
万带兰属	wan'dai'lan'shu	0
豌豆属	wan'dou'shu	0
万锋桧	wan'feng'gui	0
弯梗芥属	wan'geng'jie'shu	0
弯管花属	wan'guan'hua'shu	0
弯果鹤虱属	wan'guo'he'shi'shu	0
晚花杨	wan'hua'yang	0
万年蒿	wan'nian'hao	0
万年青属	wan'nian'qing'shu	0
弯蕊芥属	wan'rui'jie'shu	0
万寿菊属	wan'shou'ju'shu	0
万寿竹属	wan'shou'zhu'shu	0
晚香玉属	wan'xiang'yu'shu	0
弯柱杜鹃属	wan'zhu'du'juan'shu	0
王不留行属	wang'bu'liu'xing'shu	0
菵草属	wang'cao'shu	0
望都塔桧	wang'du'ta'gui	0
网萼木属	wang'e'mu'shu	0
王莲	wang'lian	0
王莲属	wang'lian'shu	0
网球花属	wang'qiu'hua'shu	0
网籽草属	wang'zi'cao'shu	0
王棕属	wang'zong'shu	0
王族海棠	wang'zu'hai'tang	0
猬草属	wei'cao'shu	0
尾稃草属	wei'fu'cao'shu	0
苇谷草属	wei'gu'cao'shu	0
微核草属	wei'he'cao'shu	0
微花兰属	wei'hua'lan'shu	0
微花藤属	wei'hua'teng'shu	0
蝟菊属	wei'ju'shu	0
微兰属	wei'lan'shu	0
委陵菜属	wei'ling'cai'shu	0
卫茅	wei'mao	0
卫矛	wei'mao	0
卫矛科	wei'mao'ke	0
卫矛属	wei'mao'shu	0
尾囊草属	wei'nang'cao'shu	0
微萍属	wei'ping'shu	0
猥实	wei'shi	0
猬实属	wei'shi'shu	0
伪针茅属	wei'zhen'mao'shu	0
葨芝属	wei'zhi'shu	0
微柱麻属	wei'zhu'ma'shu	0
微紫草属	wei'zi'cao'shu	0
纹苞菊属	wen'bao'ju'shu	0
文定果属	wen'ding'guo'shu	0
文冠果	wen'guan'guo	0
文冠果属	wen'guan'guo'shu	0
紊蒿属	wen'hao'shu	0
吻兰属	wen'lan'shu	0
蚊母	wen'mu	0
蚊母树属	wen'mu'shu'shu	0
榅桲属	wen'po'shu	0
文珠兰属	wen'zhu'lan'shu	0
莴苣属	wo'ju'shu	0
倭竹属	wo'zhu'shu	0
雾冰藜属	wu'bing'li'shu	0
五彩石竹	wu'cai'shi'zhu	0
五层龙属	wu'ceng'long'shu	0
五翅莓属	wu'chi'mei'shu	0
五唇兰属	wu'chun'lan'shu	0
无刺枸骨	wu'ci'gou'gu	0
无刺枸骨球	wu'ci'gou'gu'qiu	0
无耳兰属	wu'er'lan'shu	0
乌饭树科	wu'fan'shu'ke	0
乌饭树属	wu'fan'shu'shu	0
五福花科	wu'fu'hua'ke	0
五福花属	wu'fu'hua'shu	0
无隔芥属	wu'ge'jie'shu	0
无根藤属	wu'gen'teng'shu	0
舞鹤草属	wu'he'cao'shu	0
无花果	wu'hua'guo	0
舞花姜属	wu'hua'jiang'shu	0
无患子	wu'huan'zi	0
无患子科	wu'huan'zi'ke	0
无患子属	wu'huan'zi'shu	0
无喙兰属	wu'hui'lan'shu	0
五加	wu'jia	0
五加科	wu'jia'ke	0
五加属	wu'jia'shu	0
五角枫	wu'jiao'feng	0
无茎荠属	wu'jing'ji'shu	0
乌桕	wu'jiu	0
乌桕属	wu'jiu'shu	0
无距花属	wu'ju'hua'shu	0
无距兰属	wu'ju'lan'shu	0
乌口树属	wu'kou'shu'shu	0
乌蔹莓属	wu'lian'mei'shu	0
五列木科	wu'lie'mu'ke	0
五列木属	wu'lie'mu'shu	0
五膜草属	wu'mo'cao'shu	0
五蕊寄生属	wu'rui'ji'sheng'shu	0
雾水葛属	wu'shui'ge'shu	0
乌苏里鼠李	wu'su'li'shu'li	0
乌苏里绣线菊	wu'su'li'xiu'xian'ju	0
五台枸骨球	wu'tai'gou'gu'qiu	0
乌檀属	wu'tan'shu	0
梧桐	wu'tong	0
梧桐科	wu'tong'ke	0
乌头属	wu'tou'shu	0
勿忘草属	wu'wang'cao'shu	0
无尾果属	wu'wei'guo'shu	0
五味子	wu'wei'zi	0
五星花属	wu'xing'hua'shu	0
无须藤属	wu'xu'teng'shu	0
五丫果科	wu'ya'guo'ke	0
五叶地锦	wu'ye'di'jin	0
无叶兰属	wu'ye'lan'shu	0
无叶莲科	wu'ye'lian'ke	0
无忧花属	wu'you'hua'shu	0
五月茶属	wu'yue'cha'shu	0
五针松	wu'zhen'song	0
无柱兰属	wu'zhu'lan'shu	0
吴茱萸	wu'zhu'yu	0
吴茱萸属	wu'zhu'yu'shu	0
西安桧	xi'an'gui	0
细柄草属	xi'bing'cao'shu	0
细柄茅属	xi'bing'mao'shu	0
膝柄木属	xi'bing'mu'shu	0
细柄芋属	xi'bing'yu'shu	0
西伯利亚小檗	xi'bo'li'ya'xiao'bo	0
喜冬草属	xi'dong'cao'shu	0
西番莲科	xi'fan'lian'ke	0
西番莲属	xi'fan'lian'shu	0
西府海棠	xi'fu'hai'tang	0
西瓜属	xi'gua'shu	0
喜光花属	xi'guang'hua'shu	0
细画眉草属	xi'hua'mei'cao'shu	0
锡兰莲属	xi'lan'lian'shu	0
细裂芹属	xi'lie'qin'shu	0
喜林芋属	xi'lin'yu'shu	0
锡生藤属	xi'sheng'teng'shu	0
喜树	xi'shu	0
喜树属	xi'shu'shu	0
溪桫属	xi'suo'shu	0
希藤科	xi'teng'ke	0
希藤科翅子藤科	xi'teng'ke'chi'zi'teng'ke	0
豨莶属	xi'xian'shu	0
细辛属	xi'xin'shu	0
喜盐草属	xi'yan'cao'shu	0
细叶胡枝子	xi'ye'hu'zhi'zi	0
细叶锦鸡儿	xi'ye'jin'ji'er	0
细叶芹属	xi'ye'qin'shu	0
细叶莎草	xi'ye'suo'cao	0
锡叶藤属	xi'ye'teng'shu	0
细叶小檗	xi'ye'xiao'bo	0
喜雨草属	xi'yu'cao'shu	0
细圆藤属	xi'yuan'teng'shu	0
细柱柳	xi'zhu'liu	0
细子龙属	xi'zi'long'shu	0
狭瓣木属	xia'ban'mu'shu	0
狭管紫草属	xia'guan'zi'cao'shu	0
虾海藻属	xia'hai'zao'shu	0
虾脊兰属	xia'ji'lan'shu	0
夏鹃	xia'juan	0
夏枯草属	xia'ku'cao'shu	0
夏蜡梅属	xia'la'mei'shu	0
虾钳菜属	xia'qian'cai'shu	0
狭腔芹属	xia'qiang'qin'shu	0
下田菊属	xia'tian'ju'shu	0
虾须草属	xia'xu'cao'shu	0
夏须草属	xia'xu'cao'shu	0
狭叶朴	xia'ye'pu	0
狭叶十大功劳	xia'ye'shi'da'gong'lao	0
虾衣花属	xia'yi'hua'shu	0
夏至草属	xia'zhi'cao'shu	0
虾子花属	xia'zi'hua'shu	0
鲜卑花属	xian'bei'hua'shu	0
腺萼木属	xian'e'mu'shu	0
腺梗菜属	xian'geng'cai'shu	0
纤冠藤属	xian'guan'teng'shu	0
线果芥属	xian'guo'jie'shu	0
腺果藤属	xian'guo'teng'shu	0
鲜黄连属	xian'huang'lian'shu	0
苋科	xian'ke	0
仙茅科	xian'mao'ke	0
仙茅属	xian'mao'shu	0
蚬木属	xian'mu'shu	0
仙女木属	xian'nv'mu'shu	0
仙人掌科	xian'ren'zhang'ke	0
仙人掌属	xian'ren'zhang'shu	0
仙人柱属	xian'ren'zhu'shu	0
苋属	xian'shu	0
线叶菊属	xian'ye'ju'shu	0
腺叶藤属	xian'ye'teng'shu	0
线柱苣苔属	xian'zhu'ju'tai'shu	0
线柱兰属	xian'zhu'lan'shu	0
显子草属	xian'zi'cao'shu	0
线嘴苣属	xian'zui'ju'shu	0
香柏	xiang'bai	0
香茶藨子	xiang'cha'biao'zi	0
香茶菜属	xiang'cha'cai'shu	0
香茶属	xiang'cha'shu	0
香椿	xiang'chun	0
香椿属	xiang'chun'shu	0
象耳豆属	xiang'er'dou'shu	0
香芙木属	xiang'fu'mu'shu	0
香根草属	xiang'gen'cao'shu	0
香根芹属	xiang'gen'qin'shu	0
香菇	xiang'gu	0
香果兰属	xiang'guo'lan'shu	0
香果树属	xiang'guo'shu'shu	0
香花槐	xiang'hua'huai	0
香花芥属	xiang'hua'jie'shu	0
香花藤属	xiang'hua'teng'shu	0
香槐属	xiang'huai'shu	0
香简草属	xiang'jian'cao'shu	0
橡胶树属	xiang'jiao'shu'shu	0
香芥属	xiang'jie'shu	0
香科科属	xiang'ke'ke'shu	0
香兰属	xiang'lan'shu	0
香茅属	xiang'mao'shu	0
香泡	xiang'pao	0
香蒲	xiang'pu	0
香蒲科	xiang'pu'ke	0
香蒲属	xiang'pu'shu	0
香茜科	xiang'qian'ke	0
香茜科四角果科	xiang'qian'ke'si'jiao'guo'ke	0
香茜属	xiang'qian'shu	0
香青属	xiang'qing'shu	0
向日葵属	xiang'ri'kui'shu	0
香肉果属	xiang'rou'guo'shu	0
香茹属	xiang'ru'shu	0
香薷属	xiang'ru'shu	0
相思子属	xiang'si'zi'shu	0
香桃木属	xiang'tao'mu'shu	0
象腿蕉属	xiang'tui'jiao'shu	0
香豌豆属	xiang'wan'dou'shu	0
香雪兰属	xiang'xue'lan'shu	0
香雪球属	xiang'xue'qiu'shu	0
象牙参属	xiang'ya'can'shu	0
香杨	xiang'yang	0
香叶木属	xiang'ye'mu'shu	0
香樟	xiang'zhang	0
香竹属	xiang'zhu'shu	0
小白菊属	xiao'bai'ju'shu	0
小苞爵床属	xiao'bao'jue'chuang'shu	0
小檗科	xiao'bo'ke	0
小檗属	xiao'bo'shu	0
小草属	xiao'cao'shu	0
小疮菊属	xiao'chuang'ju'shu	0
小二仙草科	xiao'er'xian'cao'ke	0
小二仙草属	xiao'er'xian'cao'shu	0
小甘菊属	xiao'gan'ju'shu	0
小勾儿茶属	xiao'gou'er'cha'shu	0
小冠花属	xiao'guan'hua'shu	0
小冠熏属	xiao'guan'xun'shu	0
小果滨藜属	xiao'guo'bin'li'shu	0
小红柳	xiao'hong'liu	0
小花苣苔属	xiao'hua'ju'tai'shu	0
小花溲疏	xiao'hua'sou'shu	0
小花藤属	xiao'hua'teng'shu	0
小黄管属	xiao'huang'guan'shu	0
小黄菊属	xiao'huang'ju'shu	0
小黄柳	xiao'huang'liu	0
小金梅草属	xiao'jin'mei'cao'shu	0
肖槿属	xiao'jin'shu	0
小堇棕属	xiao'jin'zong'shu	0
小楷槭	xiao'kai'qi	0
小葵子属	xiao'kui'zi'shu	0
肖榄属	xiao'lan'shu	0
小蓝雪花属	xiao'lan'xue'hua'shu	0
小丽草属	xiao'li'cao'shu	0
肖柃属	xiao'ling'shu	0
肖笼鸡属	xiao'long'ji'shu	0
小麦属	xiao'mai'shu	0
肖牧根草属	xiao'mu'gen'cao'shu	0
小盘木属	xiao'pan'mu'shu	0
小蓬属	xiao'peng'shu	0
肖蒲桃属	xiao'pu'tao'shu	0
小牵牛属	xiao'qian'niu'shu	0
小芹属	xiao'qin'shu	0
小青杨	xiao'qing'yang	0
肖乳香属	xiao'ru'xiang'shu	0
小舌菊属	xiao'she'ju'shu	0
小石积属	xiao'shi'ji'shu	0
小狮子草属	xiao'shi'zi'cao'shu	0
小蒜芥属	xiao'suan'jie'shu	0
小牙草属	xiao'ya'cao'shu	0
小叶扶芳藤	xiao'ye'fu'fang'teng	0
小叶黄杨	xiao'ye'huang'yang	0
小叶黄杨球	xiao'ye'huang'yang'qiu	0
小叶锦鸡儿	xiao'ye'jin'ji'er	0
小叶女贞球	xiao'ye'nv'zhen'qiu	0
小叶朴	xiao'ye'pu	0
小叶鼠李	xiao'ye'shu'li	0
小叶杨	xiao'ye'yang	0
小野芝麻属	xiao'ye'zhi'ma'shu	0
小叶栀子花	xiao'ye'zhi'zi'hua	0
肖鸢尾属	xiao'yuan'wei'shu	0
小芸木属	xiao'yun'mu'shu	0
小珍珠兰	xiao'zhen'zhu'lan	0
小柱芥属	xiao'zhu'jie'shu	0
筱竹属	xiao'zhu'shu	0
肖竹芋属	xiao'zhu'yu'shu	0
小紫珠	xiao'zi'zhu	0
缬草属	xie'cao'shu	0
斜萼草属	xie'e'cao'shu	0
斜果菊属	xie'guo'ju'shu	0
邪蒿属	xie'hao'shu	0
蟹甲草属	xie'jia'cao'shu	0
蝎尾菊属	xie'wei'ju'shu	0
斜翼科	xie'yi'ke	0
斜翼属	xie'yi'shu	0
楔颖草属	xie'ying'cao'shu	0
蟹爪兰属	xie'zhao'lan'shu	0
斜柱苣苔属	xie'zhu'ju'tai'shu	0
蝎子草属	xie'zi'cao'shu	0
新蝶豆属	xin'die'dou'shu	0
心萼薯属	xin'e'shu'shu	0
新耳草属	xin'er'cao'shu	0
新风轮属	xin'feng'lun'shu	0
辛果漆属	xin'guo'qi'shu	0
新疆藜属	xin'jiang'li'shu	0
新疆杨	xin'jiang'yang	0
新麦草属	xin'mai'cao'shu	0
新木姜子属	xin'mu'jiang'zi'shu	0
辛木属	xin'mu'shu	0
新塔花属	xin'ta'hua'shu	0
新乌檀属	xin'wu'tan'shu	0
新型兰属	xin'xing'lan'shu	0
心叶石蚕属	xin'ye'shi'can'shu	0
心翼果属	xin'yi'guo'shu	0
新樟属	xin'zhang'shu	0
兴安茶藨子	xing'an'cha'biao'zi	0
兴安胡枝子	xing'an'hu'zhi'zi	0
兴安落叶松	xing'an'luo'ye'song	0
杏鲍菇	xing'bao'gu	0
荇菜	xing'cai	0
莕菜科	xing'cai'ke	0
莕菜属	xing'cai'shu	0
星果草属	xing'guo'cao'shu	0
星果紫草属	xing'guo'zi'cao'shu	0
星花草属	xing'hua'cao'shu	0
星毛珍珠梅	xing'mao'zhen'zhu'mei	0
杏梅	xing'mei	0
杏树	xing'shu	0
星叶科	xing'ye'ke	0
星叶属	xing'ye'shu	0
星玉兰	xing'yu'lan	0
绣球防风属	xiu'qiu'fang'feng'shu	0
绣球科	xiu'qiu'ke	0
绣球茜属	xiu'qiu'qian'shu	0
绣球属	xiu'qiu'shu	0
绣球绣线菊	xiu'qiu'xiu'xian'ju	0
绣线菊	xiu'xian'ju	0
绣线菊属	xiu'xian'ju'shu	0
绣线梅	xiu'xian'mei	0
绣线梅属	xiu'xian'mei'shu	0
秀柱花属	xiu'zhu'hua'shu	0
须花藤属	xu'hua'teng'shu	0
絮菊属	xu'ju'shu	0
须芒草属	xu'mang'cao'shu	0
须药藤属	xu'yao'teng'shu	0
萱草	xuan'cao	0
萱草属	xuan'cao'shu	0
旋覆花属	xuan'fu'hua'shu	0
悬钩子	xuan'gou'zi	0
悬钩子属	xuan'gou'zi'shu	0
旋花豆属	xuan'hua'dou'shu	0
旋花科	xuan'hua'ke	0
旋花属	xuan'hua'shu	0
绚丽海棠	xuan'li'hai'tang	0
悬铃花属	xuan'ling'hua'shu	0
悬铃木	xuan'ling'mu	0
悬铃木科	xuan'ling'mu'ke	0
悬铃木属	xuan'ling'mu'shu	0
玄参科	xuan'shen'ke	0
旋蒴苣苔属	xuan'shuo'ju'tai'shu	0
悬竹属	xuan'zhu'shu	0
雪胆属	xue'dan'shu	0
穴果木属	xue'guo'mu'shu	0
雪花属	xue'hua'shu	0
雪柳	xue'liu	0
雪柳属	xue'liu'shu	0
穴盘木属	xue'pan'mu'shu	0
雪片莲属	xue'pian'lian'shu	0
血水草属	xue'shui'cao'shu	0
穴丝荠属	xue'si'ji'shu	0
雪松	xue'song	0
雪松属	xue'song'shu	0
血桐属	xue'tong'shu	0
血苋属	xue'xian'shu	0
雪香兰属	xue'xiang'lan'shu	0
血叶兰属	xue'ye'lan'shu	0
熏倒牛属	xun'dao'niu'shu	0
蕈树属	xun'shu'shu	0
薰衣草属	xun'yi'cao'shu	0
栒子木	xun'zi'mu	0
栒子属	xun'zi'shu	0
崖柏属	ya'bai'shu	0
鸦葱属	ya'cong'shu	0
亚当海棠	ya'dang'hai'tang	0
崖豆藤属	ya'dou'teng'shu	0
鸭儿芹属	ya'er'qin'shu	0
亚飞廉属	ya'fei'lian'shu	0
崖角藤属	ya'jiao'teng'shu	0
鸭咀花属	ya'ju'hua'shu	0
亚麻荠属	ya'ma'ji'shu	0
亚麻科	ya'ma'ke	0
亚麻属	ya'ma'shu	0
鸭茅属	ya'mao'shu	0
崖摩属	ya'mo'shu	0
崖爬藤属	ya'pa'teng'shu	0
丫蕊花属	ya'rui'hua'shu	0
鸭舌黄属	ya'she'huang'shu	0
崖藤属	ya'teng'shu	0
鸭跖草科	ya'zhi'cao'ke	0
鸭跖草属	ya'zhi'cao'shu	0
鸦跖花属	ya'zhi'hua'shu	0
鸭嘴草属	ya'zui'cao'shu	0
岩参属	yan'can'shu	0
岩菖蒲属	yan'chang'pu'shu	0
岩匙属	yan'chi'shu	0
盐豆木属	yan'dou'mu'shu	0
岩风属	yan'feng'shu	0
盐肤木	yan'fu'mu	0
岩高兰科	yan'gao'lan'ke	0
岩高兰属	yan'gao'lan'shu	0
沿沟草属	yan'gou'cao'shu	0
岩黄蓍属	yan'huang'shi'shu	0
岩黄树属	yan'huang'shu'shu	0
盐角草属	yan'jiao'cao'shu	0
沿阶草属	yan'jie'cao'shu	0
盐节木属	yan'jie'mu'shu	0
盐芥属	yan'jie'shu	0
岩菊属	yan'ju'shu	0
延龄草科	yan'ling'cao'ke	0
延龄草属	yan'ling'cao'shu	0
偃麦草属	yan'mai'cao'shu	0
燕麦草属	yan'mai'cao'shu	0
燕麦属	yan'mai'shu	0
岩梅科	yan'mei'ke	0
岩梅属	yan'mei'shu	0
盐蓬属	yan'peng'shu	0
盐千屈菜属	yan'qian'qu'cai'shu	0
燕茜属	yan'qian'shu	0
岩扇属	yan'shan'shu	0
岩上珠属	yan'shang'zhu'shu	0
盐生草属	yan'sheng'cao'shu	0
眼树莲属	yan'shu'lian'shu	0
盐穗木属	yan'sui'mu'shu	0
芫荽属	yan'sui'shu	0
烟筒花属	yan'tong'hua'shu	0
岩芋属	yan'yu'shu	0
盐爪爪属	yan'zhao'zhao'shu	0
眼子菜	yan'zi'cai	0
眼子菜科	yan'zi'cai'ke	0
眼子菜属	yan'zi'cai'shu	0
洋椿属	yang'chun'shu	0
羊肚菌	yang'du'jun	0
羊耳蒜属	yang'er'suan'shu	0
洋狗尾草属	yang'gou'wei'cao'shu	0
羊胡子草属	yang'hu'zi'cao'shu	0
羊角拗属	yang'jiao'niu'shu	0
羊角芹属	yang'jiao'qin'shu	0
杨柳科	yang'liu'ke	0
羊茅属	yang'mao'shu	0
杨梅	yang'mei	0
杨梅科	yang'mei'ke	0
杨梅球	yang'mei'qiu	0
杨梅属	yang'mei'shu	0
杨属	yang'shu	0
阳桃属	yang'tao'shu	0
羊蹄甲属	yang'ti'jia'shu	0
杨桐属	yang'tong'shu	0
腰骨藤属	yao'gu'teng'shu	0
腰果属	yao'guo'shu	0
耀花豆属	yao'hua'dou'shu	0
药囊花属	yao'nang'hua'shu	0
药水苏属	yao'shui'su'shu	0
野百合属	ye'bai'he'shu	0
野扁豆属	ye'bian'dou'shu	0
野长蒲属	ye'chang'pu'shu	0
叶底珠	ye'di'zhu	0
叶底珠属	ye'di'zhu'shu	0
野靛棵属	ye'dian'ke'shu	0
野丁香属	ye'ding'xiang'shu	0
野独活属	ye'du'huo'shu	0
野古草属	ye'gu'cao'shu	0
野菰属	ye'gu'shu	0
野海棠属	ye'hai'tang'shu	0
腋花芥属	ye'hua'jie'shu	0
叶花苣苔属	ye'hua'ju'tai'shu	0
夜花属	ye'hua'shu	0
夜花藤属	ye'hua'teng'shu	0
野茭白	ye'jiao'bai	0
叶苣苔属	ye'ju'tai'shu	0
野决明属	ye'jue'ming'shu	0
夜来香属	ye'lai'xiang'shu	0
野梨	ye'li	0
叶轮木属	ye'lun'mu'shu	0
野玫瑰	ye'mei'gui	0
野茉莉科	ye'mo'li'ke	0
野牡丹科	ye'mu'dan'ke	0
野牡丹属	ye'mu'dan'shu	0
野木瓜属	ye'mu'gua'shu	0
野牛草属	ye'niu'cao'shu	0
业平竹属	ye'ping'zhu'shu	0
野青茅属	ye'qing'mao'shu	0
野扇花属	ye'shan'hua'shu	0
野生金针菇	ye'sheng'jin'zhen'gu	0
野黍属	ye'shu'shu	0
野桐属	ye'tong'shu	0
叶下珠属	ye'xia'zhu'shu	0
野芝麻属	ye'zhi'ma'shu	0
野珠兰属	ye'zhu'lan'shu	0
叶子花属	ye'zi'hua'shu	0
椰子属	ye'zi'shu	0
一本芒属	yi'ben'mang'shu	0
虉草属	yi'cao'shu	0
异唇兰属	yi'chun'lan'shu	0
一担柴属	yi'dan'chai'shu	0
一点红属	yi'dian'hong'shu	0
异萼木属	yi'e'mu'shu	0
异果刺草属	yi'guo'ci'cao'shu	0
异果芥属	yi'guo'jie'shu	0
翼核木属	yi'he'mu'shu	0
异花草属	yi'hua'cao'shu	0
蚁花属	yi'hua'shu	0
仪花属	yi'hua'shu	0
异喙菊属	yi'hui'ju'shu	0
翼茎草属	yi'jing'cao'shu	0
依兰属	yi'lan'shu	0
伊乐藻	yi'le'zao	0
伊犁花属	yi'li'hua'shu	0
伊犁芹属	yi'li'qin'shu	0
翼蓼属	yi'liao'shu	0
异裂菊属	yi'lie'ju'shu	0
异芒菊属	yi'mang'ju'shu	0
益母草属	yi'mu'cao'shu	0
异木患属	yi'mu'huan'shu	0
翼朴属	yi'pu'shu	0
异蕊草属	yi'rui'cao'shu	0
异蕊芥属	yi'rui'jie'shu	0
翼首花属	yi'shou'hua'shu	0
异腺草属	yi'xian'cao'shu	0
异型菊属	yi'xing'ju'shu	0
异形木属	yi'xing'mu'shu	0
异燕麦属	yi'yan'mai'shu	0
意杨	yi'yang	0
异药花属	yi'yao'hua'shu	0
翼药花属	yi'yao'hua'shu	0
异药芥属	yi'yao'jie'shu	0
异叶苣苔属	yi'ye'ju'tai'shu	0
异野芝麻属	yi'ye'zhi'ma'shu	0
薏苡属	yi'yi'shu	0
栘衣属	yi'yi'shu	0
异颖草属	yi'ying'cao'shu	0
一枝黄花属	yi'zhi'huang'hua'shu	0
异钟花属	yi'zhong'hua'shu	0
异子蓬属	yi'zi'peng'shu	0
银白杨	yin'bai'yang	0
隐棒花属	yin'bang'hua'shu	0
银边黄杨球	yin'bian'huang'yang'qiu	0
银柴属	yin'chai'shu	0
银耳	yin'er	0
银钩花属	yin'gou'hua'shu	0
银桂	yin'gui	0
银合欢属	yin'he'huan'shu	0
隐花草属	yin'hua'cao'shu	0
银桦属	yin'hua'shu	0
银胶菊属	yin'jiao'ju'shu	0
隐棱芹属	yin'leng'qin'shu	0
银莲花属	yin'lian'hua'shu	0
银脉爵床属	yin'mai'jue'chuang'shu	0
隐盘芹属	yin'pan'qin'shu	0
银槭	yin'qi	0
阴山荠属	yin'shan'ji'shu	0
银杉属	yin'shan'shu	0
银穗草属	yin'sui'cao'shu	0
银杏	yin'xing	0
银杏科	yin'xing'ke	0
银杏属	yin'xing'shu	0
银须草属	yin'xu'cao'shu	0
淫羊藿属	yin'yang'huo'shu	0
隐翼科	yin'yi'ke	0
隐翼属	yin'yi'shu	0
茵芋属	yin'yu'shu	0
银中杨	yin'zhong'yang	0
隐柱兰属	yin'zhu'lan'shu	0
隐子草属	yin'zi'cao'shu	0
隐子芥属	yin'zi'jie'shu	0
硬草属	ying'cao'shu	0
迎春	ying'chun	0
硬骨草属	ying'gu'cao'shu	0
硬骨凌霄属	ying'gu'ling'xiao'shu	0
英国梧桐	ying'guo'wu'tong	0
硬核属	ying'he'shu	0
樱花	ying'hua	0
樱井草科	ying'jing'cao'ke	0
樱井草科无叶莲科	ying'jing'cao'ke'wu'ye'lian'ke	0
樱井草属	ying'jing'cao'shu	0
鹰咀豆属	ying'ju'dou'shu	0
硬皮豆属	ying'pi'dou'shu	0
迎山红	ying'shan'hong	0
罂粟科	ying'su'ke	0
罂粟莲花属	ying'su'lian'hua'shu	0
罂粟属	ying'su'shu	0
樱桃	ying'tao	0
樱桃属	ying'tao'shu	0
英桐	ying'tong	0
鹰爪豆属	ying'zhao'dou'shu	0
鹰爪花属	ying'zhao'hua'shu	0
蝇子草属	ying'zi'cao'shu	0
永瓣藤属	yong'ban'teng'shu	0
蛹虫草	yong'chong'cao	0
鼬瓣花属	you'ban'hua'shu	0
油丹属	you'dan'shu	0
油点草属	you'dian'cao'shu	0
疣冠麻属	you'guan'ma'shu	0
油果樟属	you'guo'zhang'shu	0
油麻藤	you'ma'teng	0
油芒属	you'mang'shu	0
柚木属	you'mu'shu	0
油楠属	you'nan'shu	0
油杉寄生属	you'shan'ji'sheng'shu	0
油杉属	you'shan'shu	0
莸属	you'shu	0
油松	you'song	0
油桐属	you'tong'shu	0
油渣果属	you'zha'guo'shu	0
莠竹属	you'zhu'shu	0
油棕属	you'zong'shu	0
鱼鳔槐	yu'biao'huai	0
鱼鳔槐属	yu'biao'huai'shu	0
羽唇兰属	yu'chun'lan'shu	0
玉带草	yu'dai'cao	0
羽萼木属	yu'e'mu'shu	0
玉凤花属	yu'feng'hua'shu	0
娱蚣草属	yu'gong'cao'shu	0
鱼骨木属	yu'gu'mu'shu	0
鱼黄草属	yu'huang'cao'shu	0
榆黄蘑	yu'huang'mo	0
郁金香属	yu'jin'xiang'shu	0
雨久花科	yu'jiu'hua'ke	0
雨久花属	yu'jiu'hua'shu	0
榆桔属	yu'ju'shu	0
榆科	yu'ke	0
芋兰属	yu'lan'shu	0
盂兰属	yu'lan'shu	0
郁李	yu'li	0
玉帘属	yu'lian'shu	0
羽裂荠属	yu'lie'ji'shu	0
鱼鳞云松	yu'lin'yun'song	0
玉铃花	yu'ling'hua	0
榆绿木属	yu'lv'mu'shu	0
羽芒菊属	yu'mang'ju'shu	0
羽毛枫	yu'mao'feng	0
玉蕊科	yu'rui'ke	0
玉蕊属	yu'rui'shu	0
羽扇豆属	yu'shan'dou'shu	0
玉山竹属	yu'shan'zhu'shu	0
芋属	yu'shu	0
榆属	yu'shu	0
雨树属	yu'shu'shu	0
玉蜀黍属	yu'shu'shu'shu	0
羽穗草属	yu'sui'cao'shu	0
鱼藤属	yu'teng'shu	0
鱼尾葵属	yu'wei'kui'shu	0
鱼眼草属	yu'yan'cao'shu	0
榆叶白鹃梅	yu'ye'bai'juan'mei	0
羽叶点地梅属	yu'ye'dian'di'mei'shu	0
玉叶金花属	yu'ye'jin'hua'shu	0
榆叶梅	yu'ye'mei	0
榆叶朴	yu'ye'pu	0
羽叶楸属	yu'ye'qiu'shu	0
羽叶五加属	yu'ye'wu'jia'shu	0
羽衣草属	yu'yi'cao'shu	0
玉簪	yu'zan	0
玉簪属	yu'zan'shu	0
圆柏	yuan'bai	0
圆柏属	yuan'bai'shu	0
元宝槭	yuan'bao'qi	0
圆唇苣苔属	yuan'chun'ju'tai'shu	0
鸢尾	yuan'wei	0
鸢尾科	yuan'wei'ke	0
鸢尾兰属	yuan'wei'lan'shu	0
鸢尾属	yuan'wei'shu	0
园叶泽苔	yuan'ye'ze'tai	0
远志科	yuan'zhi'ke	0
远志属	yuan'zhi'shu	0
圆籽荷属	yuan'zi'he'shu	0
月光花属	yue'guang'hua'shu	0
月桂属	yue'gui'shu	0
岳桦	yue'hua	0
月季	yue'ji	0
月见草属	yue'jian'cao'shu	0
越桔科	yue'ju'ke	0
云木香属	yun'mu'xiang'shu	0
云南黄馨	yun'nan'huang'xin	0
云杉	yun'shan	0
云杉属	yun'shan'shu	0
云实科	yun'shi'ke	0
云实属	yun'shi'shu	0
芸苔属	yun'tai'shu	0
芸香草属	yun'xiang'cao'shu	0
芸香科	yun'xiang'ke	0
芸香属	yun'xiang'shu	0
云叶兰属	yun'ye'lan'shu	0
云芝蘑	yun'zhi'mo	0
杂交鹃	za'jiao'juan	0
雜属	za'shu	0
杂种杨	za'zhong'yang	0
仔榄树属	zai'lan'shu'shu	0
再力花	zai'li'hua	0
藏香叶芹属	zang'xiang'ye'qin'shu	0
藏药木属	zang'yao'mu'shu	0
藻百年属	zao'bai'nian'shu	0
蚤草属	zao'cao'shu	0
早花忍冬	zao'hua'ren'dong	0
皂荚属	zao'jia'shu	0
早锦带花	zao'jin'dai'hua	0
皂帽花属	zao'mao'hua'shu	0
枣属	zao'shu	0
枣树	zao'shu	0
早熟禾草	zao'shu'he'cao	0
早熟禾属	zao'shu'he'shu	0
早熟禾系列草坪	zao'shu'he'xi'lie'cao'ping	0
燥原荠属	zao'yuan'ji'shu	0
早园竹	zao'yuan'zhu	0
蚤缀属	zao'zhui'shu	0
泽兰属	ze'lan'shu	0
泽芹属	ze'qin'shu	0
泽苔草属	ze'tai'cao'shu	0
泽泻	ze'xie	0
泽泻科	ze'xie'ke	0
泽泻属	ze'xie'shu	0
窄叶绣线菊	zhai'ye'xiu'xian'ju	0
粘木科	zhan'mu'ke	0
粘木属	zhan'mu'shu	0
旃檀属	zhan'tan'shu	0
獐耳细辛属	zhang'er'xi'xin'shu	0
胀果芹属	zhang'guo'qin'shu	0
长角豆属	zhang'jiao'dou'shu	0
樟科	zhang'ke	0
獐毛属	zhang'mao'shu	0
樟属	zhang'shu	0
樟味藜属	zhang'wei'li'shu	0
獐牙菜属	zhang'ya'cai'shu	0
掌叶木属	zhang'ye'mu'shu	0
掌叶石蚕属	zhang'ye'shi'can'shu	0
掌叶树属	zhang'ye'shu'shu	0
樟子松	zhang'zi'song	0
爪耳木属	zhao'er'mu'shu	0
沼菊属	zhao'ju'shu	0
沼兰属	zhao'lan'shu	0
照山白	zhao'shan'bai	0
沼生栎	zhao'sheng'li	0
爪哇木棉属	zhao'wa'mu'mian'shu	0
照夜白属	zhao'ye'bai'shu	0
沼原草属	zhao'yuan'cao'shu	0
折柄茶属	zhe'bing'cha'shu	0
鹧鸪草属	zhe'gu'cao'shu	0
鹧鸪花属	zhe'gu'hua'shu	0
蔗茅属	zhe'mao'shu	0
柘树	zhe'shu	0
针苞菊属	zhen'bao'ju'shu	0
针果芹属	zhen'guo'qin'shu	0
真姬菇	zhen'ji'gu	0
针茅属	zhen'mao'shu	0
榛木科	zhen'mu'ke	0
榛木属	zhen'mu'shu	0
真穗草属	zhen'sui'cao'shu	0
针叶苋属	zhen'ye'xian'shu	0
针枝属	zhen'zhi'shu	0
珍珠菜属	zhen'zhu'cai'shu	0
珍珠茅属	zhen'zhu'mao'shu	0
珍珠梅	zhen'zhu'mei	0
珍珠梅属	zhen'zhu'mei'shu	0
珍珠绣线菊	zhen'zhu'xiu'xian'ju	0
榛子	zhen'zi	0
针子草属	zhen'zi'cao'shu	0
直瓣苣苔属	zhi'ban'ju'tai'shu	0
直唇姜属	zhi'chun'jiang'shu	0
指甲花属	zhi'jia'hua'shu	0
指甲兰属	zhi'jia'lan'shu	0
枳椇属	zhi'ju'shu	0
芝麻菜属	zhi'ma'cai'shu	0
直芒草属	zhi'mang'cao'shu	0
知母属	zhi'mu'shu	0
治疝草属	zhi'shan'cao'shu	0
枝实属	zhi'shi'shu	0
枳属	zhi'shu	0
止泻木属	zhi'xie'mu'shu	0
栉叶蒿属	zhi'ye'hao'shu	0
蜘蛛抱蛋属	zhi'zhu'bao'dan'shu	0
蜘蛛花属	zhi'zhu'hua'shu	0
蜘蛛兰属	zhi'zhu'lan'shu	0
栀子花	zhi'zi'hua	0
栀子皮属	zhi'zi'pi'shu	0
栀子属	zhi'zi'shu	0
重瓣茶花	zhong'ban'cha'hua	0
重瓣榆叶梅	zhong'ban'yu'ye'mei	0
肿柄菊属	zhong'bing'ju'shu	0
中东杨	zhong'dong'yang	0
种阜草属	zhong'fu'cao'shu	0
中国块菌	zhong'guo'kuai'jun	0
中国种子植物科属词典	zhong'guo'zhong'zi'zhi'wu'ke'shu'ci'dian	0
钟花草属	zhong'hua'cao'shu	0
钟花属	zhong'hua'shu	0
肿荚豆属	zhong'jia'dou'shu	0
中美木棉属	zhong'mei'mu'mian'shu	0
钟木属	zhong'mu'shu	0
重羽菊属	zhong'yu'ju'shu	0
舟瓣芹属	zhou'ban'qin'shu	0
帚灯草科	zhou'deng'cao'ke	0
舟果荠属	zhou'guo'ji'shu	0
轴花属	zhou'hua'shu	0
帚菊属	zhou'ju'shu	0
轴藜属	zhou'li'shu	0
轴榈属	zhou'lv'shu	0
竹柏	zhu'bai	0
竹柏科罗	zhu'bai'ke'luo	0
猪菜藤属	zhu'cai'teng'shu	0
诸葛菜属	zhu'ge'cai'shu	0
竹根七属	zhu'gen'qi'shu	0
朱蕉属	zhu'jiao'shu	0
竹节蓼属	zhu'jie'liao'shu	0
竹节树属	zhu'jie'shu'shu	0
竹茎兰属	zhu'jing'lan'shu	0
朱兰属	zhu'lan'shu	0
猪苓	zhu'ling	0
猪笼草科	zhu'long'cao'ke	0
猪笼草属	zhu'long'cao'shu	0
苎麻属	zhu'ma'shu	0
猪毛菜属	zhu'mao'cai'shu	0
蛛网萼属	zhu'wang'e'shu	0
猪牙花属	zhu'ya'hua'shu	0
猪腰豆属	zhu'yao'dou'shu	0
竹叶吉祥草属	zhu'ye'ji'xiang'cao'shu	0
竹叶蕉属	zhu'ye'jiao'shu	0
竹叶兰属	zhu'ye'lan'shu	0
竹叶子属	zhu'ye'zi'shu	0
朱缨花属	zhu'ying'hua'shu	0
竹芋属	zhu'yu'shu	0
珠子木属	zhu'zi'mu'shu	0
砖子苗属	zhuan'zi'miao'shu	0
锥果芥属	zhui'guo'jie'shu	0
锥花属	zhui'hua'shu	0
锥栗属	zhui'li'shu	0
锥茅属	zhui'mao'shu	0
锥头麻属	zhui'tou'ma'shu	0
紫草科	zi'cao'ke	0
紫草属	zi'cao'shu	0
紫丹属	zi'dan'shu	0
紫丁香	zi'ding'xiang	0
紫椴	zi'duan	0
紫花锦鸡儿	zi'hua'jin'ji'er	0
紫堇科	zi'jin'ke	0
紫金龙属	zi'jin'long'shu	0
紫金牛科	zi'jin'niu'ke	0
紫金牛属	zi'jin'niu'shu	0
紫堇属	zi'jin'shu	0
紫荆	zi'jing	0
紫茎兰属	zi'jing'lan'shu	0
紫荆木属	zi'jing'mu'shu	0
紫荆属	zi'jing'shu	0
子楝树属	zi'lian'shu'shu	0
紫罗兰属	zi'luo'lan'shu	0
紫麻属	zi'ma'shu	0
紫铆属	zi'mao'shu	0
紫茉莉科	zi'mo'li'ke	0
紫茉莉属	zi'mo'li'shu	0
紫萍属	zi'ping'shu	0
孜然芹属	zi'ran'qin'shu	0
紫伞芹属	zi'san'qin'shu	0
紫杉	zi'shan	0
紫杉科	zi'shan'ke	0
梓属	zi'shu	0
梓树	zi'shu	0
紫树属	zi'shu'shu	0
紫苏属	zi'su'shu	0
紫穗槐	zi'sui'huai	0
紫穗槐属	zi'sui'huai'shu	0
紫檀属	zi'tan'shu	0
紫藤	zi'teng	0
紫藤属	zi'teng'shu	0
紫菀木属	zi'wan'mu'shu	0
紫万年青属	zi'wan'nian'qing'shu	0
紫菀属	zi'wan'shu	0
紫薇	zi'wei	0
紫葳科	zi'wei'ke	0
紫葳属	zi'wei'shu	0
紫薇属	zi'wei'shu	0
紫霞藤属	zi'xia'teng'shu	0
紫叶矮樱	zi'ye'ai'ying	0
紫叶稠李	zi'ye'chou'li	0
紫叶风箱果	zi'ye'feng'xiang'guo	0
紫叶李	zi'ye'li	0
紫叶属	zi'ye'shu	0
紫叶小檗	zi'ye'xiao'bo	0
紫叶酢桨草	zi'ye'zuo'jiang'cao	0
紫叶酢浆草	zi'ye'zuo'jiang'cao	0
紫玉兰	zi'yu'lan	0
紫玉盘属	zi'yu'pan'shu	0
紫玉簪	zi'yu'zan	0
紫云英属	zi'yun'ying'shu	0
紫竹	zi'zhu	0
紫珠属	zi'zhu'shu	0
总苞草属	zong'bao'cao'shu	0
棕榈	zong'lv	0
棕榈科	zong'lv'ke	0
棕榈属	zong'lv'shu	0
鬃尾草属	zong'wei'cao'shu	0
粽叶芦属	zong'ye'lu'shu	0
棕竹属	zong'zhu'shu	0
菹草	zu'cao	0
足杜兰属	zu'du'lan'shu	0
钻地风属	zuan'di'feng'shu	0
钻喙兰属	zuan'hui'lan'shu	0
钻石海棠	zuan'shi'hai'tang	0
钻天柳属	zuan'tian'liu'shu	0
钻天杨	zuan'tian'yang	0
钻柱兰属	zuan'zhu'lan'shu	0
醉魂藤属	zui'hun'teng'shu	0
醉鱼草属	zui'yu'cao'shu	0
酢浆草科	zuo'jiang'cao'ke	0
酢浆草属	zuo'jiang'cao'shu	0
柞木属	zuo'mu'shu	0
