八勘验笔录	ba'kan'yan'bi'lu	0
八中止或者终结执行	ba'zhong'zhi'huo'zhe'zhong'jie'zhi'xing	0
不能正确表达意思的人不能作证	bu'neng'zheng'que'biao'da'yi'si'de'ren'bu'neng'zuo'zheng	0
采取前款措施由院长签发搜查令	cai'qu'qian'kuan'cuo'shi'you'yuan'zhang'qian'fa'sou'cha'ling	0
第八章调解	di'ba'zhang'tiao'jie	0
第二编审判程序	di'er'bian'shen'pan'cheng'xu	0
第二节地域管辖	di'er'jie'di'yu'guan'xia	0
第二节审理前的准备	di'er'jie'shen'li'qian'de'zhun'bei	0
第二节送达	di'er'jie'song'da	0
第二节诉讼代理人	di'er'jie'su'song'dai'li'ren	0
第二节选民资格案件	di'er'jie'xuan'min'zi'ge'an'jian	0
第二十二章执行中止和终结	di'er'shi'er'zhang'zhi'xing'zhong'zhi'he'zhong'jie	0
第二十六章仲裁	di'er'shi'liu'zhang'zhong'cai	0
第二十七章司法协助	di'er'shi'qi'zhang'si'fa'xie'zhu	0
第二十三章一般原则	di'er'shi'san'zhang'yi'ban'yuan'ze	0
第二十四章管辖	di'er'shi'si'zhang'guan'xia	0
第二十五章送达期间	di'er'shi'wu'zhang'song'da'qi'jian	0
第二十一章执行措施	di'er'shi'yi'zhang'zhi'xing'cuo'shi	0
第二十章执行的申请和移送	di'er'shi'zhang'zhi'xing'de'shen'qing'he'yi'song	0
第二章管辖	di'er'zhang'guan'xia	0
第九章保全和先予执行	di'jiu'zhang'bao'quan'he'xian'yu'zhi'xing	0
第六节确认调解协议案件	di'liu'jie'que'ren'tiao'jie'xie'yi'an'jian	0
第六十三条证据包括	di'liu'shi'san'tiao'zheng'ju'bao'kuo	0
第六章证据	di'liu'zhang'zheng'ju	0
第七节实现担保物权案件	di'qi'jie'shi'xian'dan'bao'wu'quan'an'jian	0
第七章期间送达	di'qi'zhang'qi'jian'song'da	0
第三编执行程序	di'san'bian'zhi'xing'cheng'xu	0
第三节开庭审理	di'san'jie'kai'ting'shen'li	0
第三节宣告失踪宣告死亡案件	di'san'jie'xuan'gao'shi'zong'xuan'gao'si'wang'an'jian	0
第三节移送管辖和指定管辖	di'san'jie'yi'song'guan'xia'he'zhi'ding'guan'xia	0
第三章审判组织	di'san'zhang'shen'pan'zu'zhi	0
第十八章公示催告程序	di'shi'ba'zhang'gong'shi'cui'gao'cheng'xu	0
第十二章第一审普通程序	di'shi'er'zhang'di'yi'shen'pu'tong'cheng'xu	0
第十九章一般规定	di'shi'jiu'zhang'yi'ban'gui'ding	0
第十六章审判监督程序	di'shi'liu'zhang'shen'pan'jian'du'cheng'xu	0
第十七章督促程序	di'shi'qi'zhang'du'cu'cheng'xu	0
第十三章简易程序	di'shi'san'zhang'jian'yi'cheng'xu	0
第十四章第二审程序	di'shi'si'zhang'di'er'shen'cheng'xu	0
第十五章特别程序	di'shi'wu'zhang'te'bie'cheng'xu	0
第十一章诉讼费用	di'shi'yi'zhang'su'song'fei'yong	0
第四节诉讼中止和终结	di'si'jie'su'song'zhong'zhi'he'zhong'jie	0
第四章回避	di'si'zhang'hui'bi	0
第五节判决和裁定	di'wu'jie'pan'jue'he'cai'ding	0
第五节认定财产无主案件	di'wu'jie'ren'ding'cai'chan'wu'zhu'an'jian	0
第五章诉讼参加人	di'wu'zhang'su'song'can'jia'ren	0
第一编总则	di'yi'bian'zong'ze	0
第一节当事人	di'yi'jie'dang'shi'ren	0
第一节级别管辖	di'yi'jie'ji'bie'guan'xia	0
第一节期间	di'yi'jie'qi'jian	0
第一节起诉和受理	di'yi'jie'qi'su'he'shou'li	0
第一节一般规定	di'yi'jie'yi'ban'gui'ding	0
第一章任务适用范围和基本原则	di'yi'zhang'ren'wu'shi'yong'fan'wei'he'ji'ben'yuan'ze	0
二被告及其诉讼代理人答辩	er'bei'gao'ji'qi'su'song'dai'li'ren'da'bian	0
二被申请人有履行能力	er'bei'shen'qing'ren'you'lv'xing'neng'li	0
二当事人的近亲属或者工作人员	er'dang'shi'ren'de'jin'qin'shu'huo'zhe'gong'zuo'ren'yuan	0
二当事人临时提出回避申请的	er'dang'shi'ren'lin'shi'ti'chu'hui'bi'shen'qing'de	0
二对管辖权有异议的	er'dui'guan'xia'quan'you'yi'yi'de	0
二据以执行的法律文书被撤销的	er'ju'yi'zhi'xing'de'fa'lv'wen'shu'bei'che'xiao'de	0
二认为应当由本院审理的案件	er'ren'wei'ying'dang'you'ben'yuan'shen'li'de'an'jian	0
二书证	er'shu'zheng	0
二调解维持收养关系的案件	er'tiao'jie'wei'chi'shou'yang'guan'xi'de'an'jian	0
二通过外交途径送达	er'tong'guo'wai'jiao'tu'jing'song'da	0
二有明确的被告	er'you'ming'que'de'bei'gao	0
二与本案有利害关系的	er'yu'ben'an'you'li'hai'guan'xi'de	0
二在本辖区有重大影响的案件	er'zai'ben'xia'qu'you'zhong'da'ying'xiang'de'an'jian	0
二支付令能够送达债务人的	er'zhi'fu'ling'neng'gou'song'da'zhai'wu'ren'de	0
二追索劳动报酬的	er'zhui'suo'lao'dong'bao'chou'de	0
九撤销或者不予执行仲裁裁决	jiu'che'xiao'huo'zhe'bu'yu'zhi'xing'zhong'cai'cai'jue	0
拘传应当发拘传票	ju'chuan'ying'dang'fa'ju'chuan'piao	0
拘留的期限为十五日以下	ju'liu'de'qi'xian'wei'shi'wu'ri'yi'xia	0
六其他应当中止诉讼的情形	liu'qi'ta'ying'dang'zhong'zhi'su'song'de'qing'xing	0
六证人证言	liu'zheng'ren'zheng'yan	0
六中止或者终结诉讼	liu'zhong'zhi'huo'zhe'zhong'jie'su'song	0
七补正判决书中的笔误	qi'bu'zheng'pan'jue'shu'zhong'de'bi'wu	0
七鉴定意见	qi'jian'ding'yi'jian	0
三驳回起诉	san'bo'hui'qi'su	0
三离婚案件一方当事人死亡的	san'li'hun'an'jian'yi'fang'dang'shi'ren'si'wang'de	0
三能够即时履行的案件	san'neng'gou'ji'shi'lv'xing'de'an'jian	0
三判决结果和诉讼费用的负担	san'pan'jue'jie'guo'he'su'song'fei'yong'de'fu'dan	0
三物证	san'wu'zheng	0
三因情况紧急需要先予执行的	san'yin'qing'kuang'jin'ji'xu'yao'xian'yu'zhi'xing'de	0
三有具体的诉讼请求和事实理由	san'you'ju'ti'de'su'song'qing'qiu'he'shi'shi'li'you	0
三再审判决裁定有明显错误的	san'zai'shen'pan'jue'cai'ding'you'ming'xian'cuo'wu'de	0
十未经传票传唤缺席判决的	shi'wei'jing'chuan'piao'chuan'huan'que'xi'pan'jue'de	0
十一其他需要裁定解决的事项	shi'yi'qi'ta'xu'yao'cai'ding'jie'jue'de'shi'xiang	0
收取诉讼费用的办法另行制定	shou'qu'su'song'fei'yong'de'ban'fa'ling'xing'zhi'ding	0
四保全和先予执行	si'bao'quan'he'xian'yu'zhi'xing	0
四裁决所根据的证据是伪造的	si'cai'jue'suo'gen'ju'de'zheng'ju'shi'wei'zao'de	0
四对被监禁的人提起的诉讼	si'dui'bei'jian'jin'de'ren'ti'qi'de'su'song	0
四互相辩论	si'hu'xiang'bian'lun	0
四其他不需要制作调解书的案件	si'qi'ta'bu'xu'yao'zhi'zuo'tiao'jie'shu'de'an'jian	0
四其他拒绝协助执行的	si'qi'ta'ju'jue'xie'zhu'zhi'xing'de	0
四其他应当延期的情形	si'qi'ta'ying'dang'yan'qi'de'qing'xing	0
四其他有正当理由不能出庭的	si'qi'ta'you'zheng'dang'li'you'bu'neng'chu'ting'de	0
四上诉期间和上诉的法院	si'shang'su'qi'jian'he'shang'su'de'fa'yuan	0
四视听资料	si'shi'ting'zi'liao	0
四宣读鉴定意见	si'xuan'du'jian'ding'yi'jian	0
提交外文书证必须附有中文译本	ti'jiao'wai'wen'shu'zheng'bi'xu'fu'you'zhong'wen'yi'ben	0
五电子数据	wu'dian'zi'shu'ju	0
五宣读勘验笔录	wu'xuan'du'kan'yan'bi'lu	0
五准许或者不准许撤诉	wu'zhun'xu'huo'zhe'bu'zhun'xu'che'su	0
一不予受理	yi'bu'yu'shou'li	0
一当事人陈述	yi'dang'shi'ren'chen'shu	0
一当事人的陈述	yi'dang'shi'ren'de'chen'shu	0
一律师基层法律服务工作者	yi'lv'shi'ji'ceng'fa'lv'fu'wu'gong'zuo'zhe	0
一人民法院驳回再审申请的	yi'ren'min'fa'yuan'bo'hui'zai'shen'shen'qing'de	0
一申请人表示可以延期执行的	yi'shen'qing'ren'biao'shi'ke'yi'yan'qi'zhi'xing'de	0
一申请人撤销申请的	yi'shen'qing'ren'che'xiao'shen'qing'de	0
一调解和好的离婚案件	yi'tiao'jie'he'hao'de'li'hun'an'jian	0
一因健康原因不能出庭的	yi'yin'jian'kang'yuan'yin'bu'neng'chu'ting'de	0
一原告及其诉讼代理人发言	yi'yuan'gao'ji'qi'su'song'dai'li'ren'fa'yan	0
一在全国有重大影响的案件	yi'zai'quan'guo'you'zhong'da'ying'xiang'de'an'jian	0
一重大涉外案件	yi'zhong'da'she'wai'an'jian	0
中华人民共和国民事诉讼法	zhong'hua'ren'min'gong'he'guo'min'shi'su'song'fa	0
中止的情形消失后恢复执行	zhong'zhi'de'qing'xing'xiao'shi'hou'hui'fu'zhi'xing	0
中止诉讼的原因消除后恢复诉讼	zhong'zhi'su'song'de'yuan'yin'xiao'chu'hou'hui'fu'su'song	0
