昂热	ang're	0
奥丁	ao'ding	0
奥丁之渊	ao'ding'zhi'yuan	0
白王	bai'wang	0
邦达列夫	bang'da'lie'fu	0
陈墨瞳	chen'mo'tong	0
楚子航	chu'zi'hang	0
纯血龙族	chun'xue'long'zu	0
村雨	cun'yu	0
大地与山之王	da'di'yu'shan'zhi'wang	0
狄克推多	di'ke'tui'duo	0
芬格尔	fen'ge'er	0
芬里厄	fen'li'e	0
风间琉璃	feng'jian'liu'li	0
风魔小太郎	feng'mo'xiao'tai'lang	0
高天原	gao'tian'yuan	0
宫本志雄	gong'ben'zhi'xiong	0
海洋与水之王	hai'yang'yu'shui'zhi'wang	0
赫尔佐格	he'er'zuo'ge	0
黑王	hei'wang	0
黑月之潮	hei'yue'zhi'chao	0
黄金瞳	huang'jin'tong	0
混血种	hun'xue'zhong	0
火之晨曦	huo'zhi'chen'xi	0
加图索	jia'tu'suo	0
江南	jiang'nan	0
酒德麻衣	jiu'de'ma'yi	0
酒德亚纪	jiu'de'ya'ji	0
橘政宗	ju'zheng'zong	0
凯撒	kai'sa	0
凯撒加图索	kai'sa'jia'tu'suo	0
康斯坦丁	kang'si'tan'ding	0
雷娜塔	lei'na'ta	0
列宁号	lie'ning'hao	0
龙蛋	long'dan	0
龙马弦一郎	long'ma'xian'yi'lang	0
龙族	long'zu	0
路明非	lu'ming'fei	0
路鸣泽	lu'ming'ze	0
猛鬼众	meng'gui'zhong	0
秘党	mi'dang	0
魔鬼路鸣泽	mo'gui'lu'ming'ze	0
南叔	nan'shu	0
尼德霍格	ni'de'huo'ge	0
诺顿	nuo'dun	0
诺诺	nuo'nuo	0
青铜与火之王	qing'tong'yu'huo'zhi'wang	0
犬山贺	quan'shan'he	0
三无妞	san'wu'niu	0
上杉绘梨衣	shang'shan'hui'li'yi	0
上杉越	shang'shan'yue	0
蛇岐八家	she'qi'ba'jia	0
神葬所	shen'zang'suo	0
四大君主	si'da'jun'zhu	0
死侍	si'shi	0
苏恩曦	su'en'xi	0
苏茜	su'qian	0
天空与风之王	tian'kong'yu'feng'zhi'wang	0
天照命	tian'zhao'ming	0
夏弥	xia'mi	0
须佐之男命	xu'zuo'zhi'nan'ming	0
血之衰	xue'zhi'shuai	0
言灵	yan'ling	0
言灵不要死	yan'ling'bu'yao'si	0
言灵风王之瞳	yan'ling'feng'wang'zhi'tong	0
言灵君焰	yan'ling'jun'yan	0
言灵镰鼬	yan'ling'lian'you	0
言灵审判	yan'ling'shen'pan	0
言灵时间零	yan'ling'shi'jian'ling	0
言灵湿婆业舞	yan'ling'shi'po'ye'wu	0
言灵王权	yan'ling'wang'quan	0
言灵吸血镰	yan'ling'xi'xue'lian	0
耶梦加得	ye'meng'jia'de	0
叶胜	ye'sheng	0
樱井七海	ying'jing'qi'hai	0
攸亡者之瞳	you'wang'zhe'zhi'tong	0
御神刀村雨	yu'shen'dao'cun'yu	0
源稚女	yuan'zhi'nv	0
源稚生	yuan'zhi'sheng	0
月读命	yue'du'ming	0
