安徽尊龙环保节能建材有限公司	an'hui'zun'long'huan'bao'jie'neng'jian'cai'you'xian'gong'si	0
北京东方雨虹技术股份有限公司	bei'jing'dong'fang'yu'hong'ji'shu'gu'fen'you'xian'gong'si	0
北京固金山防水材料有限公司	bei'jing'gu'jin'shan'fang'shui'cai'liao'you'xian'gong'si	0
北京鸿禹乔建材有限公司	bei'jing'hong'yu'qiao'jian'cai'you'xian'gong'si	0
北京佳佳美涂料厂	bei'jing'jia'jia'mei'tu'liao'chang	0
北京建海中建防水材料有限公司	bei'jing'jian'hai'zhong'jian'fang'shui'cai'liao'you'xian'gong'si	0
北京鲁奥达建筑材料有限公司	bei'jing'lu'ao'da'jian'zhu'cai'liao'you'xian'gong'si	0
北京中建瑞特防水建材有限公司	bei'jing'zhong'jian'rui'te'fang'shui'jian'cai'you'xian'gong'si	0
沧海陶瓷有限公司	cang'hai'tao'ci'you'xian'gong'si	0
晨颖陶瓷有限公司	chen'ying'tao'ci'you'xian'gong'si	0
茌平宏源新型建材有限公司	chi'ping'hong'yuan'xin'xing'jian'cai'you'xian'gong'si	0
茌平县金鼎新型材料有限公司	chi'ping'xian'jin'ding'xin'xing'cai'liao'you'xian'gong'si	0
大红陶瓷厂	da'hong'tao'ci'chang	0
德普威涂料有限公司	de'pu'wei'tu'liao'you'xian'gong'si	0
德兴陶瓷厂	de'xing'tao'ci'chang	0
迪美斯陶瓷有限公司	di'mei'si'tao'ci'you'xian'gong'si	0
东昌陶瓷有限公司	dong'chang'tao'ci'you'xian'gong'si	0
东阿东昌新型建材有限公司	dong'e'dong'chang'xin'xing'jian'cai'you'xian'gong'si	0
东莞大宝化工制品有限公司	dong'guan'da'bao'hua'gong'zhi'pin'you'xian'gong'si	0
东诺陶瓷有限公司	dong'nuo'tao'ci'you'xian'gong'si	0
东鹏陶瓷集团有限公司	dong'peng'tao'ci'ji'tuan'you'xian'gong'si	0
东营市金江防水涂料有限公司	dong'ying'shi'jin'jiang'fang'shui'tu'liao'you'xian'gong'si	0
凡第诺陶瓷有限公司	fan'di'nuo'tao'ci'you'xian'gong'si	0
佛山华兴利陶瓷有限公司	fo'shan'hua'xing'li'tao'ci'you'xian'gong'si	0
佛山汇德邦陶瓷有限公司	fo'shan'hui'de'bang'tao'ci'you'xian'gong'si	0
佛山南海蝴蝶陶瓷有限公司	fo'shan'nan'hai'hu'die'tao'ci'you'xian'gong'si	0
佛山市格尔陶瓷有限公司	fo'shan'shi'ge'er'tao'ci'you'xian'gong'si	0
佛山市恒源陶瓷有限公司	fo'shan'shi'heng'yuan'tao'ci'you'xian'gong'si	0
佛山市宏博陶瓷有限公司	fo'shan'shi'hong'bo'tao'ci'you'xian'gong'si	0
佛山市江南建筑陶瓷厂	fo'shan'shi'jiang'nan'jian'zhu'tao'ci'chang	0
佛山市金山陶瓷有限公司	fo'shan'shi'jin'shan'tao'ci'you'xian'gong'si	0
佛山市力君陶瓷有限公司	fo'shan'shi'li'jun'tao'ci'you'xian'gong'si	0
佛山市锐龙陶瓷有限公司	fo'shan'shi'rui'long'tao'ci'you'xian'gong'si	0
佛山市三水祥顺陶瓷有限公司	fo'shan'shi'san'shui'xiang'shun'tao'ci'you'xian'gong'si	0
佛山市盛丰陶瓷有限公司	fo'shan'shi'sheng'feng'tao'ci'you'xian'gong'si	0
佛山市石湾金龙陶瓷厂	fo'shan'shi'shi'wan'jin'long'tao'ci'chang	0
佛山阳光陶瓷有限公司	fo'shan'yang'guang'tao'ci'you'xian'gong'si	0
富思特新材料科技发展有限公司	fu'si'te'xin'cai'liao'ke'ji'fa'zhan'you'xian'gong'si	0
高格陶瓷有限公司	gao'ge'tao'ci'you'xian'gong'si	0
高明区金刚玉陶瓷有限公司	gao'ming'qu'jin'gang'yu'tao'ci'you'xian'gong'si	0
观唐陶瓷有限公司	guan'tang'tao'ci'you'xian'gong'si	0
冠星陶瓷有限公司	guan'xing'tao'ci'you'xian'gong'si	0
官窑辉鹏陶瓷厂	guan'yao'hui'peng'tao'ci'chang	0
广东华润涂料有限公司	guang'dong'hua'run'tu'liao'you'xian'gong'si	0
广东金牌陶瓷有限公司	guang'dong'jin'pai'tao'ci'you'xian'gong'si	0
广州市固班建筑材料有限公司	guang'zhou'shi'gu'ban'jian'zhu'cai'liao'you'xian'gong'si	0
海虹老人涂料烟台有限公司	hai'hong'lao'ren'tu'liao'yan'tai'you'xian'gong'si	0
海鸥陶瓷有限公司	hai'ou'tao'ci'you'xian'gong'si	0
杭州蓝田涂料有限公司	hang'zhou'lan'tian'tu'liao'you'xian'gong'si	0
河北金诺防水材料有限公司	he'bei'jin'nuo'fang'shui'cai'liao'you'xian'gong'si	0
河南七彩涂料有限公司	he'nan'qi'cai'tu'liao'you'xian'gong'si	0
和顺陶瓷厂	he'shun'tao'ci'chang	0
恒发厂	heng'fa'chang	0
恒发陶瓷公司	heng'fa'tao'ci'gong'si	0
恒丰高级墙地砖厂	heng'feng'gao'ji'qiang'di'zhuan'chang	0
恒丰画砖厂	heng'feng'hua'zhuan'chang	0
恒华卫生洁具厂	heng'hua'wei'sheng'jie'ju'chang	0
恒盛釉画砖厂	heng'sheng'you'hua'zhuan'chang	0
宏丰陶瓷集团	hong'feng'tao'ci'ji'tuan	0
鸿威陶瓷厂	hong'wei'tao'ci'chang	0
宏翔陶瓷有限公司	hong'xiang'tao'ci'you'xian'gong'si	0
鸿业工贸集团公司	hong'ye'gong'mao'ji'tuan'gong'si	0
宏宇陶瓷有限公司	hong'yu'tao'ci'you'xian'gong'si	0
宏源陶瓷企业有限公司	hong'yuan'tao'ci'qi'ye'you'xian'gong'si	0
华利陶瓷厂	hua'li'tao'ci'chang	0
华纳陶瓷有限公司	hua'na'tao'ci'you'xian'gong'si	0
华平陶瓷厂	hua'ping'tao'ci'chang	0
华威陶瓷厂	hua'wei'tao'ci'chang	0
环球陶瓷有限公司	huan'qiu'tao'ci'you'xian'gong'si	0
汇德隆陶瓷有限公司	hui'de'long'tao'ci'you'xian'gong'si	0
辉鸿鸣陶陶瓷有限公司	hui'hong'ming'tao'tao'ci'you'xian'gong'si	0
汇智陶瓷有限公司	hui'zhi'tao'ci'you'xian'gong'si	0
济钢集团闽源钢铁有限公司	ji'gang'ji'tuan'min'yuan'gang'tie'you'xian'gong'si	0
济南澳润建材有限公司	ji'nan'ao'run'jian'cai'you'xian'gong'si	0
济南百通混凝土有限公司	ji'nan'bai'tong'hun'ning'tu'you'xian'gong'si	0
济南长基科贸有限公司	ji'nan'chang'ji'ke'mao'you'xian'gong'si	0
济南长能商砼有限公司	ji'nan'chang'neng'shang'tong'you'xian'gong'si	0
济南长清新盛制砖厂	ji'nan'chang'qing'xin'sheng'zhi'zhuan'chang	0
济南长兴建设商混凝土有限公司	ji'nan'chang'xing'jian'she'shang'hun'ning'tu'you'xian'gong'si	0
济南城隆建材有限公司	ji'nan'cheng'long'jian'cai'you'xian'gong'si	0
济南创新水泥有限公司	ji'nan'chuang'xin'shui'ni'you'xian'gong'si	0
济南方圣混凝土有限公司	ji'nan'fang'sheng'hun'ning'tu'you'xian'gong'si	0
济南凤栖混凝土有限公司	ji'nan'feng'xi'hun'ning'tu'you'xian'gong'si	0
济南钢铁股份有限公司	ji'nan'gang'tie'gu'fen'you'xian'gong'si	0
济南高盛新型建材有限公司	ji'nan'gao'sheng'xin'xing'jian'cai'you'xian'gong'si	0
济南高新开发区鑫隆新型建材厂	ji'nan'gao'xin'kai'fa'qu'xin'long'xin'xing'jian'cai'chang	0
济南哥玛涂料有限公司	ji'nan'ge'ma'tu'liao'you'xian'gong'si	0
济南庚强建材科技有限公司	ji'nan'geng'qiang'jian'cai'ke'ji'you'xian'gong'si	0
济南广隆新型材料有限公司	ji'nan'guang'long'xin'xing'cai'liao'you'xian'gong'si	0
济南国和路桥工程有限公司	ji'nan'guo'he'lu'qiao'gong'cheng'you'xian'gong'si	0
济南国林新型建材有限公司	ji'nan'guo'lin'xin'xing'jian'cai'you'xian'gong'si	0
济南恒博新型建材开发有限公司	ji'nan'heng'bo'xin'xing'jian'cai'kai'fa'you'xian'gong'si	0
济南恒源混凝土有限公司	ji'nan'heng'yuan'hun'ning'tu'you'xian'gong'si	0
济南鸿旺混凝土有限公司	ji'nan'hong'wang'hun'ning'tu'you'xian'gong'si	0
济南宏筑新型建材有限公司	ji'nan'hong'zhu'xin'xing'jian'cai'you'xian'gong'si	0
济南华厦建筑工程有限公司	ji'nan'hua'sha'jian'zhu'gong'cheng'you'xian'gong'si	0
济南华巽混凝土有限公司	ji'nan'hua'xun'hun'ning'tu'you'xian'gong'si	0
济南汇盛新型建材有限公司	ji'nan'hui'sheng'xin'xing'jian'cai'you'xian'gong'si	0
济南建工总承包集团有限公司	ji'nan'jian'gong'zong'cheng'bao'ji'tuan'you'xian'gong'si	0
济南金鼎混凝土有限公司	ji'nan'jin'ding'hun'ning'tu'you'xian'gong'si	0
济南金泰德混凝土有限公司	ji'nan'jin'tai'de'hun'ning'tu'you'xian'gong'si	0
济南开元新型建筑材料有限公司	ji'nan'kai'yuan'xin'xing'jian'zhu'cai'liao'you'xian'gong'si	0
济南康泰混凝土有限公司	ji'nan'kang'tai'hun'ning'tu'you'xian'gong'si	0
济南科信橡塑制品有限公司	ji'nan'ke'xin'xiang'su'zhi'pin'you'xian'gong'si	0
济南劳武涂料有限公司	ji'nan'lao'wu'tu'liao'you'xian'gong'si	0
济南力天建材有限公司	ji'nan'li'tian'jian'cai'you'xian'gong'si	0
济南鲁冠混凝土有限公司临港	ji'nan'lu'guan'hun'ning'tu'you'xian'gong'si'lin'gang	0
济南鲁冠混凝土有限公司展村	ji'nan'lu'guan'hun'ning'tu'you'xian'gong'si'zhan'cun	0
济南鲁冠混凝土有限公司章丘	ji'nan'lu'guan'hun'ning'tu'you'xian'gong'si'zhang'qiu	0
济南鲁润混凝土有限公司济南站	ji'nan'lu'run'hun'ning'tu'you'xian'gong'si'ji'nan'zhan	0
济南鲁润混凝土有限公司章丘站	ji'nan'lu'run'hun'ning'tu'you'xian'gong'si'zhang'qiu'zhan	0
济南玛博伦环保涂料有限公司	ji'nan'ma'bo'lun'huan'bao'tu'liao'you'xian'gong'si	0
济南玫澳新型建材有限公司	ji'nan'mei'ao'xin'xing'jian'cai'you'xian'gong'si	0
济南暖鑫工贸有限公司	ji'nan'nuan'xin'gong'mao'you'xian'gong'si	0
济南平发新型建材有限公司	ji'nan'ping'fa'xin'xing'jian'cai'you'xian'gong'si	0
济南瑞宝涂料有限公司	ji'nan'rui'bao'tu'liao'you'xian'gong'si	0
济南瑞丰建材集团有限公司东站	ji'nan'rui'feng'jian'cai'ji'tuan'you'xian'gong'si'dong'zhan	0
济南瑞丰建材集团有限公司南站	ji'nan'rui'feng'jian'cai'ji'tuan'you'xian'gong'si'nan'zhan	0
济南润迪新型建材有限公司	ji'nan'run'di'xin'xing'jian'cai'you'xian'gong'si	0
济南润营化工有限公司	ji'nan'run'ying'hua'gong'you'xian'gong'si	0
济南三合建园建筑材料有限公司	ji'nan'san'he'jian'yuan'jian'zhu'cai'liao'you'xian'gong'si	0
济南三虎建材有限责任公司	ji'nan'san'hu'jian'cai'you'xian'ze'ren'gong'si	0
济南三友新型建材有限公司	ji'nan'san'you'xin'xing'jian'cai'you'xian'gong'si	0
济南圣华混凝土有限公司	ji'nan'sheng'hua'hun'ning'tu'you'xian'gong'si	0
济南圣源混凝土有限公司	ji'nan'sheng'yuan'hun'ning'tu'you'xian'gong'si	0
济南市长清区大展涂料厂	ji'nan'shi'chang'qing'qu'da'zhan'tu'liao'chang	0
济南市长清区金星新型建材	ji'nan'shi'chang'qing'qu'jin'xing'xin'xing'jian'cai	0
济南市长清区平安华金建材厂	ji'nan'shi'chang'qing'qu'ping'an'hua'jin'jian'cai'chang	0
济南市长清区平安黄河淤泥砖厂	ji'nan'shi'chang'qing'qu'ping'an'huang'he'yu'ni'zhuan'chang	0
济南市槐荫区吴家堡砖瓦厂	ji'nan'shi'huai'yin'qu'wu'jia'bao'zhuan'wa'chang	0
济南世纪富海工贸有限公司	ji'nan'shi'ji'fu'hai'gong'mao'you'xian'gong'si	0
济南市历城区陈孟新型建材厂	ji'nan'shi'li'cheng'qu'chen'meng'xin'xing'jian'cai'chang	0
济南市历城区贵坤新型建材厂	ji'nan'shi'li'cheng'qu'gui'kun'xin'xing'jian'cai'chang	0
济南市历城区贵申新型建材厂	ji'nan'shi'li'cheng'qu'gui'shen'xin'xing'jian'cai'chang	0
济南市历城区焕成新型建材厂	ji'nan'shi'li'cheng'qu'huan'cheng'xin'xing'jian'cai'chang	0
济南市历城区金源祥建材厂	ji'nan'shi'li'cheng'qu'jin'yuan'xiang'jian'cai'chang	0
济南市历城区强固新型建材厂	ji'nan'shi'li'cheng'qu'qiang'gu'xin'xing'jian'cai'chang	0
济南市历城区全节新型建材厂	ji'nan'shi'li'cheng'qu'quan'jie'xin'xing'jian'cai'chang	0
济南市舜鑫涂料厂	ji'nan'shi'shun'xin'tu'liao'chang	0
济南市鑫源黄河泥沙砖厂	ji'nan'shi'xin'yuan'huang'he'ni'sha'zhuan'chang	0
济南市中舜鑫涂料厂	ji'nan'shi'zhong'shun'xin'tu'liao'chang	0
济南四建混凝土搅拌中心东站	ji'nan'si'jian'hun'ning'tu'jiao'ban'zhong'xin'dong'zhan	0
济南四建混凝土搅拌中心南站	ji'nan'si'jian'hun'ning'tu'jiao'ban'zhong'xin'nan'zhan	0
济南天聪防水材料有限公司	ji'nan'tian'cong'fang'shui'cai'liao'you'xian'gong'si	0
济南天冠新型建筑材料有限公司	ji'nan'tian'guan'xin'xing'jian'zhu'cai'liao'you'xian'gong'si	0
济南天荣祥混凝土有限公司	ji'nan'tian'rong'xiang'hun'ning'tu'you'xian'gong'si	0
济南拓达建材有限公司	ji'nan'tuo'da'jian'cai'you'xian'gong'si	0
济南万丰新型建材有限公司	ji'nan'wan'feng'xin'xing'jian'cai'you'xian'gong'si	0
济南维高建才技术有限公司	ji'nan'wei'gao'jian'cai'ji'shu'you'xian'gong'si	0
济南维高建材技术有限公司	ji'nan'wei'gao'jian'cai'ji'shu'you'xian'gong'si	0
济南维高建材科技有限公司	ji'nan'wei'gao'jian'cai'ke'ji'you'xian'gong'si	0
济南新汉邦建材有限公司	ji'nan'xin'han'bang'jian'cai'you'xian'gong'si	0
济南鑫星涂料厂	ji'nan'xin'xing'tu'liao'chang	0
济南兴隆涂料有限公司	ji'nan'xing'long'tu'liao'you'xian'gong'si	0
济南旭源涂料有限公司	ji'nan'xu'yuan'tu'liao'you'xian'gong'si	0
济南亚福瑞装饰材料有限公司	ji'nan'ya'fu'rui'zhuang'shi'cai'liao'you'xian'gong'si	0
济南永泽建材有限公司	ji'nan'yong'ze'jian'cai'you'xian'gong'si	0
济南禹顺新型材料有限公司	ji'nan'yu'shun'xin'xing'cai'liao'you'xian'gong'si	0
济南禹顺新型建材有限公司	ji'nan'yu'shun'xin'xing'jian'cai'you'xian'gong'si	0
济南裕源建材有限公司	ji'nan'yu'yuan'jian'cai'you'xian'gong'si	0
济南岳信建材有限公司	ji'nan'yue'xin'jian'cai'you'xian'gong'si	0
济南鋆晟建材有限公司	ji'nan'yun'sheng'jian'cai'you'xian'gong'si	0
济宁百帝涂料有限公司	ji'ning'bai'di'tu'liao'you'xian'gong'si	0
济宁赛德丽新材料有限公司	ji'ning'sai'de'li'xin'cai'liao'you'xian'gong'si	0
济宁祥昊建材有限公司	ji'ning'xiang'hao'jian'cai'you'xian'gong'si	0
嘉宝莉化工集团有限公司	jia'bao'li'hua'gong'ji'tuan'you'xian'gong'si	0
嘉泰陶瓷有限公司	jia'tai'tao'ci'you'xian'gong'si	0
建丰陶瓷厂	jian'feng'tao'ci'chang	0
江苏久诺建材科技有限责任公司	jiang'su'jiu'nuo'jian'cai'ke'ji'you'xian'ze'ren'gong'si	0
金典陶瓷有限公司	jin'dian'tao'ci'you'xian'gong'si	0
金舵陶瓷有限公司	jin'duo'tao'ci'you'xian'gong'si	0
金龙陶瓷厂	jin'long'tao'ci'chang	0
聚氨酯防水涂料	ju'an'zhi'fang'shui'tu'liao	0
聚合物水泥防水涂料	ju'he'wu'shui'ni'fang'shui'tu'liao	0
居之美陶瓷有限公司	ju'zhi'mei'tao'ci'you'xian'gong'si	0
骏高陶瓷有限公司	jun'gao'tao'ci'you'xian'gong'si	0
骏美特种陶瓷有限公司	jun'mei'te'zhong'tao'ci'you'xian'gong'si	0
科骏陶瓷厂	ke'jun'tao'ci'chang	0
科顺防水材料股份有限公司	ke'shun'fang'shui'cai'liao'gu'fen'you'xian'gong'si	0
科顺防水技术科技有限公司	ke'shun'fang'shui'ji'shu'ke'ji'you'xian'gong'si	0
科顺防水科技股份有限公司	ke'shun'fang'shui'ke'ji'gu'fen'you'xian'gong'si	0
昆山海蓝色彩科技有限公司	kun'shan'hai'lan'se'cai'ke'ji'you'xian'gong'si	0
莱芜钢铁股份有限公司	lai'wu'gang'tie'gu'fen'you'xian'gong'si	0
灡石化工陶瓷厂	lan'shi'hua'gong'tao'ci'chang	0
廊坊立邦涂料有限公司	lang'fang'li'bang'tu'liao'you'xian'gong'si	0
乐华陶瓷洁具有限公司	le'hua'tao'ci'jie'ju'you'xian'gong'si	0
乐华陶瓷有限公司	le'hua'tao'ci'you'xian'gong'si	0
乐平建筑陶瓷厂	le'ping'jian'zhu'tao'ci'chang	0
立邦科技股份有限公司	li'bang'ke'ji'gu'fen'you'xian'gong'si	0
立邦中国有限公司	li'bang'zhong'guo'you'xian'gong'si	0
历城区焕成新型建材厂	li'cheng'qu'huan'cheng'xin'xing'jian'cai'chang	0
聊城亚升新型建材有限公司	liao'cheng'ya'sheng'xin'xing'jian'cai'you'xian'gong'si	0
铃鹿复合建材上海有限公司	ling'lu'fu'he'jian'cai'shang'hai'you'xian'gong'si	0
岭南陶瓷有限公司	ling'nan'tao'ci'you'xian'gong'si	0
龙津陶瓷厂	long'jin'tao'ci'chang	0
龙珠陶瓷有限公司	long'zhu'tao'ci'you'xian'gong'si	0
罗南建陶厂	luo'nan'jian'tao'chang	0
美国宣伟公司	mei'guo'xuan'wei'gong'si	0
美术陶瓷厂有限公司	mei'shu'tao'ci'chang'you'xian'gong'si	0
美陶陶瓷有限公司	mei'tao'tao'ci'you'xian'gong'si	0
美宜居陶瓷有限公司	mei'yi'ju'tao'ci'you'xian'gong'si	0
明华陶瓷厂	ming'hua'tao'ci'chang	0
南边陶瓷厂	nan'bian'tao'ci'chang	0
南海冠星王陶瓷有限公司	nan'hai'guan'xing'wang'tao'ci'you'xian'gong'si	0
南海环球陶瓷厂	nan'hai'huan'qiu'tao'ci'chang	0
南海景业陶瓷有限公司	nan'hai'jing'ye'tao'ci'you'xian'gong'si	0
南海区彩鸿陶瓷有限公司	nan'hai'qu'cai'hong'tao'ci'you'xian'gong'si	0
南海区东伟有限公司陶瓷	nan'hai'qu'dong'wei'you'xian'gong'si'tao'ci	0
南海区海天陶瓷有限公司	nan'hai'qu'hai'tian'tao'ci'you'xian'gong'si	0
南海区宏陶陶瓷有限公司	nan'hai'qu'hong'tao'tao'ci'you'xian'gong'si	0
南海区美顺陶瓷有限公司	nan'hai'qu'mei'shun'tao'ci'you'xian'gong'si	0
南海赛德陶瓷有限公司	nan'hai'sai'de'tao'ci'you'xian'gong'si	0
南海市彩蝶陶瓷有限公司	nan'hai'shi'cai'die'tao'ci'you'xian'gong'si	0
南海市富民陶瓷厂	nan'hai'shi'fu'min'tao'ci'chang	0
南海市星威陶瓷有限公司	nan'hai'shi'xing'wei'tao'ci'you'xian'gong'si	0
南海市兆鹏陶瓷有限公司	nan'hai'shi'zhao'peng'tao'ci'you'xian'gong'si	0
南海陶昌陶瓷有限公司	nan'hai'tao'chang'tao'ci'you'xian'gong'si	0
南通陶瓷厂	nan'tong'tao'ci'chang	0
欧神莱陶瓷有限公司	ou'shen'lai'tao'ci'you'xian'gong'si	0
盘锦禹王防水建材集团有限公司	pan'jin'yu'wang'fang'shui'jian'cai'ji'tuan'you'xian'gong'si	0
盘锦禹王防水建材有限公司	pan'jin'yu'wang'fang'shui'jian'cai'you'xian'gong'si	0
庞贝捷涂料有限公司	pang'bei'jie'tu'liao'you'xian'gong'si	0
平胜陶瓷厂	ping'sheng'tao'ci'chang	0
平阴广厦新型建材有限公司	ping'yin'guang'sha'xin'xing'jian'cai'you'xian'gong'si	0
平阴洁士涂料厂	ping'yin'jie'shi'tu'liao'chang	0
平阴县柳河新型砖厂	ping'yin'xian'liu'he'xin'xing'zhuan'chang	0
平阴县鑫达涂料厂	ping'yin'xian'xin'da'tu'liao'chang	0
平阴鑫达涂料厂	ping'yin'xin'da'tu'liao'chang	0
平阴鑫源商品混凝土有限公司	ping'yin'xin'yuan'shang'pin'hun'ning'tu'you'xian'gong'si	0
齐河锦华新型建材有限公司	qi'he'jin'hua'xin'xing'jian'cai'you'xian'gong'si	0
齐河县红炬新型建材有限公司	qi'he'xian'hong'ju'xin'xing'jian'cai'you'xian'gong'si	0
齐河县祝阿镇瑞鑫砖厂	qi'he'xian'zhu'a'zhen'rui'xin'zhuan'chang	0
樵山陶瓷厂	qiao'shan'tao'ci'chang	0
青岛钰也钢铁有限公司	qing'dao'yu'ye'gang'tie'you'xian'gong'si	0
日照钢铁有限公司	ri'zhao'gang'tie'you'xian'gong'si	0
三彩陶瓷有限公司	san'cai'tao'ci'you'xian'gong'si	0
三棵树涂料股份有限公司	san'ke'shu'tu'liao'gu'fen'you'xian'gong'si	0
三棵树涂料有限公司	san'ke'shu'tu'liao'you'xian'gong'si	0
三联陶瓷有限公司	san'lian'tao'ci'you'xian'gong'si	0
三水市乐平维纳尔陶瓷有限公司	san'shui'shi'le'ping'wei'na'er'tao'ci'you'xian'gong'si	0
三水市蜻蜓陶瓷有限公司	san'shui'shi'qing'ting'tao'ci'you'xian'gong'si	0
三英陶瓷有限公司	san'ying'tao'ci'you'xian'gong'si	0
三洲利艺陶瓷厂	san'zhou'li'yi'tao'ci'chang	0
山东宝通建材有限公司	shan'dong'bao'tong'jian'cai'you'xian'gong'si	0
山东丹威建材有限公司	shan'dong'dan'wei'jian'cai'you'xian'gong'si	0
山东多多丽保温工程有限公司	shan'dong'duo'duo'li'bao'wen'gong'cheng'you'xian'gong'si	0
山东港基建设集团商砼有限公司	shan'dong'gang'ji'jian'she'ji'tuan'shang'tong'you'xian'gong'si	0
山东钢铁集团张店钢铁总厂	shan'dong'gang'tie'ji'tuan'zhang'dian'gang'tie'zong'chang	0
山东高阳建材有限公司	shan'dong'gao'yang'jian'cai'you'xian'gong'si	0
山东宏恒达防水材料有限公	shan'dong'hong'heng'da'fang'shui'cai'liao'you'xian'gong	0
山东宏恒达防水材料有限公司	shan'dong'hong'heng'da'fang'shui'cai'liao'you'xian'gong'si	0
山东宏基混凝土有限公司	shan'dong'hong'ji'hun'ning'tu'you'xian'gong'si	0
山东华明建材有限公司	shan'dong'hua'ming'jian'cai'you'xian'gong'si	0
山东华森混凝土有限公司北站	shan'dong'hua'sen'hun'ning'tu'you'xian'gong'si'bei'zhan	0
山东华森混凝土有限公司西站	shan'dong'hua'sen'hun'ning'tu'you'xian'gong'si'xi'zhan	0
山东华森混凝土有限公司章丘	shan'dong'hua'sen'hun'ning'tu'you'xian'gong'si'zhang'qiu	0
山东华森混凝土有限公司总站	shan'dong'hua'sen'hun'ning'tu'you'xian'gong'si'zong'zhan	0
山东华志混凝土有限公司	shan'dong'hua'zhi'hun'ning'tu'you'xian'gong'si	0
山东建工预拌混凝土有限公司	shan'dong'jian'gong'yu'ban'hun'ning'tu'you'xian'gong'si	0
山东建科特种建筑工程技术中心	shan'dong'jian'ke'te'zhong'jian'zhu'gong'cheng'ji'shu'zhong'xin	0
山东建泽混凝土有限公司	shan'dong'jian'ze'hun'ning'tu'you'xian'gong'si	0
山东锦煌建材有限公司	shan'dong'jin'huang'jian'cai'you'xian'gong'si	0
山东金銮混凝土有限公司蜡山	shan'dong'jin'luan'hun'ning'tu'you'xian'gong'si'la'shan	0
山东金銮混凝土有限公司西站	shan'dong'jin'luan'hun'ning'tu'you'xian'gong'si'xi'zhan	0
山东金禹王防水材料有限公司	shan'dong'jin'yu'wang'fang'shui'cai'liao'you'xian'gong'si	0
山东聚华工贸有限公司	shan'dong'ju'hua'gong'mao'you'xian'gong'si	0
山东君峰商砼有限公司	shan'dong'jun'feng'shang'tong'you'xian'gong'si	0
山东凯正建筑工程有限公司	shan'dong'kai'zheng'jian'zhu'gong'cheng'you'xian'gong'si	0
山东莱钢永锋钢铁有限公司	shan'dong'lai'gang'yong'feng'gang'tie'you'xian'gong'si	0
山东立泰混凝土有限公司	shan'dong'li'tai'hun'ning'tu'you'xian'gong'si	0
山东鲁发混凝土有限公司	shan'dong'lu'fa'hun'ning'tu'you'xian'gong'si	0
山东鲁广建材有限公司	shan'dong'lu'guang'jian'cai'you'xian'gong'si	0
山东鲁桥建材有限公司东站	shan'dong'lu'qiao'jian'cai'you'xian'gong'si'dong'zhan	0
山东鲁桥建材有限公司西站	shan'dong'lu'qiao'jian'cai'you'xian'gong'si'xi'zhan	0
山东鲁通防水材料工程有限公司	shan'dong'lu'tong'fang'shui'cai'liao'gong'cheng'you'xian'gong'si	0
山东玛博伦新材料有限公司	shan'dong'ma'bo'lun'xin'cai'liao'you'xian'gong'si	0
山东齐聚建材有限公司	shan'dong'qi'ju'jian'cai'you'xian'gong'si	0
山东山水水泥集团有限公司	shan'dong'shan'shui'shui'ni'ji'tuan'you'xian'gong'si	0
山东尚雅涂料有限公司	shan'dong'shang'ya'tu'liao'you'xian'gong'si	0
山东盛泽新型建材有限公司	shan'dong'sheng'ze'xin'xing'jian'cai'you'xian'gong'si	0
山东世安化工有限公司	shan'dong'shi'an'hua'gong'you'xian'gong'si	0
山东石横特钢集团有限公司	shan'dong'shi'heng'te'gang'ji'tuan'you'xian'gong'si	0
山东泰安华军义诚建材有限公司	shan'dong'tai'an'hua'jun'yi'cheng'jian'cai'you'xian'gong'si	0
山东天汇防水材料有限公司	shan'dong'tian'hui'fang'shui'cai'liao'you'xian'gong'si	0
山东天齐混凝土有限责任公司	shan'dong'tian'qi'hun'ning'tu'you'xian'ze'ren'gong'si	0
山东新大地实业有限公司	shan'dong'xin'da'di'shi'ye'you'xian'gong'si	0
山东新佳涂料有限公司	shan'dong'xin'jia'tu'liao'you'xian'gong'si	0
山东益丰生化环保股份有限公司	shan'dong'yi'feng'sheng'hua'huan'bao'gu'fen'you'xian'gong'si	0
山东筑金新型建材有限公司	shan'dong'zhu'jin'xin'xing'jian'cai'you'xian'gong'si	0
上海巴德士化工材料有限公司	shang'hai'ba'de'shi'hua'gong'cai'liao'you'xian'gong'si	0
上海巴德士化工新材料有限公司	shang'hai'ba'de'shi'hua'gong'xin'cai'liao'you'xian'gong'si	0
上海邦迈化工有限公司	shang'hai'bang'mai'hua'gong'you'xian'gong'si	0
上海博威防水涂料有限公司	shang'hai'bo'wei'fang'shui'tu'liao'you'xian'gong'si	0
上海大雨防水材料有限公司	shang'hai'da'yu'fang'shui'cai'liao'you'xian'gong'si	0
上海嘉宝莉涂料有限公司	shang'hai'jia'bao'li'tu'liao'you'xian'gong'si	0
上海铃鹿复合建材有限公司	shang'hai'ling'lu'fu'he'jian'cai'you'xian'gong'si	0
上海申得欧有限公司	shang'hai'shen'de'ou'you'xian'gong'si	0
商河县华泰混凝土有限公司	shang'he'xian'hua'tai'hun'ning'tu'you'xian'gong'si	0
商河县明达建筑材料有限公司	shang'he'xian'ming'da'jian'zhu'cai'liao'you'xian'gong'si	0
上华陶瓷厂	shang'hua'tao'ci'chang	0
上元顺联陶瓷有限公司	shang'yuan'shun'lian'tao'ci'you'xian'gong'si	0
升华她陶瓷有限公司	sheng'hua'ta'tao'ci'you'xian'gong'si	0
胜业陶瓷有限公司	sheng'ye'tao'ci'you'xian'gong'si	0
士丹利陶瓷有限公司	shi'dan'li'tao'ci'you'xian'gong'si	0
石山建筑陶瓷厂	shi'shan'jian'zhu'tao'ci'chang	0
市陶厂	shi'tao'chang	0
寿光市杰盛防水材料有限公司	shou'guang'shi'jie'sheng'fang'shui'cai'liao'you'xian'gong'si	0
寿光市金帝防水材料有限公司	shou'guang'shi'jin'di'fang'shui'cai'liao'you'xian'gong'si	0
寿光市金正防水材料有限公司	shou'guang'shi'jin'zheng'fang'shui'cai'liao'you'xian'gong'si	0
寿光市鸣昊防水材料有限公司	shou'guang'shi'ming'hao'fang'shui'cai'liao'you'xian'gong'si	0
寿光市统一防水材料有限公司	shou'guang'shi'tong'yi'fang'shui'cai'liao'you'xian'gong'si	0
水乳型沥青防水涂料	shui'ru'xing'li'qing'fang'shui'tu'liao	0
水性多彩建筑涂料	shui'xing'duo'cai'jian'zhu'tu'liao	0
顺德区荣高陶瓷有限公司	shun'de'qu'rong'gao'tao'ci'you'xian'gong'si	0
顺德区陶星陶瓷有限公司	shun'de'qu'tao'xing'tao'ci'you'xian'gong'si	0
顺德容奇电子陶瓷厂	shun'de'rong'qi'dian'zi'tao'ci'chang	0
顺德市上华和强陶瓷厂	shun'de'shi'shang'hua'he'qiang'tao'ci'chang	0
四国化研廊坊有限公司	si'guo'hua'yan'lang'fang'you'xian'gong'si	0
四会市中正陶瓷有限公司	si'hui'shi'zhong'zheng'tao'ci'you'xian'gong'si	0
苏州居宝防水材料有限公司	su'zhou'ju'bao'fang'shui'cai'liao'you'xian'gong'si	0
苏州居宝防水涂料有限公司	su'zhou'ju'bao'fang'shui'tu'liao'you'xian'gong'si	0
泰丰陶瓷有限公司	tai'feng'tao'ci'you'xian'gong'si	0
泰维陶瓷有限公司	tai'wei'tao'ci'you'xian'gong'si	0
弹性建筑涂料外墙面涂	tan'xing'jian'zhu'tu'liao'wai'qiang'mian'tu	0
陶瓷厂	tao'ci'chang	0
陶晖陶瓷厂	tao'hui'tao'ci'chang	0
特高特陶瓷有限公司	te'gao'te'tao'ci'you'xian'gong'si	0
天朗陶瓷有限公司	tian'lang'tao'ci'you'xian'gong'si	0
天宇陶瓷颜料有限公司	tian'yu'tao'ci'yan'liao'you'xian'gong'si	0
挺盛陶瓷有限公司	ting'sheng'tao'ci'you'xian'gong'si	0
威臣陶瓷有限公司	wei'chen'tao'ci'you'xian'gong'si	0
潍坊京九防水工程集团有限公司	wei'fang'jing'jiu'fang'shui'gong'cheng'ji'tuan'you'xian'gong'si	0
潍坊市宝源防水材料有限公司	wei'fang'shi'bao'yuan'fang'shui'cai'liao'you'xian'gong'si	0
潍坊市宏源防水材料有限公司	wei'fang'shi'hong'yuan'fang'shui'cai'liao'you'xian'gong'si	0
潍坊市杰凯防水材料有限公司	wei'fang'shi'jie'kai'fang'shui'cai'liao'you'xian'gong'si	0
潍坊市科源防水材料有限公司	wei'fang'shi'ke'yuan'fang'shui'cai'liao'you'xian'gong'si	0
潍坊市兴源防水材料有限公司	wei'fang'shi'xing'yuan'fang'shui'cai'liao'you'xian'gong'si	0
潍坊市宇虹防水材料有限公司	wei'fang'shi'yu'hong'fang'shui'cai'liao'you'xian'gong'si	0
潍坊正大防水材料有限公司	wei'fang'zheng'da'fang'shui'cai'liao'you'xian'gong'si	0
维纳尔陶瓷有限公司	wei'na'er'tao'ci'you'xian'gong'si	0
威士伯广东有限公司	wei'shi'bo'guang'dong'you'xian'gong'si	0
威士伯涂料广东有限公司	wei'shi'bo'tu'liao'guang'dong'you'xian'gong'si	0
祥兴装饰瓷砖厂	xiang'xing'zhuang'shi'ci'zhuan'chang	0
新华陶瓷业有限公司	xin'hua'tao'ci'ye'you'xian'gong'si	0
新华雄陶瓷有限公司	xin'hua'xiong'tao'ci'you'xian'gong'si	0
辛集市三盛防水材料有限公司	xin'ji'shi'san'sheng'fang'shui'cai'liao'you'xian'gong'si	0
新建乐陶瓷有限公司	xin'jian'le'tao'ci'you'xian'gong'si	0
新联发陶瓷有限公司	xin'lian'fa'tao'ci'you'xian'gong'si	0
新明珠陶瓷有限公司	xin'ming'zhu'tao'ci'you'xian'gong'si	0
新石兴陶瓷厂	xin'shi'xing'tao'ci'chang	0
新泰市中亮涂料有限公司	xin'tai'shi'zhong'liang'tu'liao'you'xian'gong'si	0
新永诚陶瓷有限公司	xin'yong'cheng'tao'ci'you'xian'gong'si	0
新粤丰陶瓷厂	xin'yue'feng'tao'ci'chang	0
新中源集团	xin'zhong'yuan'ji'tuan	0
兴达高级建筑有限公司	xing'da'gao'ji'jian'zhu'you'xian'gong'si	0
星旺陶瓷有限公司	xing'wang'tao'ci'you'xian'gong'si	0
雄发装饰瓷砖厂	xiong'fa'zhuang'shi'ci'zhuan'chang	0
雅居陶瓷有限公司	ya'ju'tao'ci'you'xian'gong'si	0
雅骏陶瓷有限公司	ya'jun'tao'ci'you'xian'gong'si	0
雅士利涂料苏州有限公司	ya'shi'li'tu'liao'su'zhou'you'xian'gong'si	0
亚士漆上海有限公	ya'shi'qi'shang'hai'you'xian'gong	0
亚士漆上海有限公司	ya'shi'qi'shang'hai'you'xian'gong'si	0
兖州市梦多丽尔涂料有限公司	yan'zhou'shi'meng'duo'li'er'tu'liao'you'xian'gong'si	0
阳光陶瓷有限公司	yang'guang'tao'ci'you'xian'gong'si	0
意东陶瓷厂	yi'dong'tao'ci'chang	0
盈达陶瓷有限公司	ying'da'tao'ci'you'xian'gong'si	0
鹰牌陶瓷集团有限公司	ying'pai'tao'ci'ji'tuan'you'xian'gong'si	0
永和陶瓷厂	yong'he'tao'ci'chang	0
永恒特种陶瓷厂	yong'heng'te'zhong'tao'ci'chang	0
永利陶瓷厂	yong'li'tao'ci'chang	0
永兴陶瓷厂	yong'xing'tao'ci'chang	0
悦星陶瓷原料有限公司	yue'xing'tao'ci'yuan'liao'you'xian'gong'si	0
肇庆华江高新材料科技有限公司	zhao'qing'hua'jiang'gao'xin'cai'liao'ke'ji'you'xian'gong'si	0
浙江传化涂料有限公司	zhe'jiang'chuan'hua'tu'liao'you'xian'gong'si	0
浙江传华涂料有限公司	zhe'jiang'chuan'hua'tu'liao'you'xian'gong'si	0
振兴陶瓷厂	zhen'xing'tao'ci'chang	0
中国广东南海东伟陶瓷有限公司	zhong'guo'guang'dong'nan'hai'dong'wei'tao'ci'you'xian'gong'si	0
诸暨市伟丽水性涂料厂	zhu'ji'shi'wei'li'shui'xing'tu'liao'chang	0
钻石陶瓷股份有限公司	zuan'shi'tao'ci'gu'fen'you'xian'gong'si	0
