按钮	an'niu	0
抱箍	bao'gu	0
保护断路器	bao'hu'duan'lu'qi	0
保护特性	bao'hu'te'xing	0
避雷器	bi'lei'qi	0
变比	bian'bi	0
变电站	bian'dian'zhan	0
变压器	bian'ya'qi	0
标准的机组数据显示	biao'zhun'de'ji'zu'shu'ju'xian'shi	0
并联电容器	bing'lian'dian'rong'qi	0
并列的	bing'lie'de	0
波纹板	bo'wen'ban	0
波形	bo'xing	0
补偿度	bu'chang'du	0
不锈钢	bu'xiu'gang	0
采样频率	cai'yang'pin'lv	0
采样周期	cai'yang'zhou'qi	0
参考值	can'kao'zhi	0
参数值	can'shu'zhi	0
测量信号	ce'liang'xin'hao	0
插座	cha'zuo	0
超高压输电线	chao'gao'ya'shu'dian'xian	0
超速故障停机	chao'su'gu'zhang'ting'ji	0
初探	chu'tan	0
传递函数	chuan'di'han'shu	0
垂直距离	chui'zhi'ju'li	0
大容量发电机组	da'rong'liang'fa'dian'ji'zu	0
单机无穷大系统	dan'ji'wu'qiong'da'xi'tong	0
单相电度表	dan'xiang'dian'du'biao	0
单相电压	dan'xiang'dian'ya	0
档位	dang'wei	0
刀开关	dao'kai'guan	0
导纳	dao'na	0
刀闸隔离开关	dao'zha'ge'li'kai'guan	0
等效于	deng'xiao'yu	0
等值波阻抗	deng'zhi'bo'zu'kang	0
低压	di'ya	0
低油压故障停机	di'you'ya'gu'zhang'ting'ji	0
电厂	dian'chang	0
电导	dian'dao	0
电动机	dian'dong'ji	0
电动机保护器	dian'dong'ji'bao'hu'qi	0
电度表	dian'du'biao	0
电感	dian'gan	0
电杆	dian'gan	0
电抗	dian'kang	0
电抗器	dian'kang'qi	0
电老虎	dian'lao'hu	0
电力系统	dian'li'xi'tong	0
电力系统自动化	dian'li'xi'tong'zi'dong'hua	0
电铃	dian'ling	0
电流	dian'liu	0
电流表	dian'liu'biao	0
电纳	dian'na	0
电能量	dian'neng'liang	0
电能质量	dian'neng'zhi'liang	0
电瓶电压表	dian'ping'dian'ya'biao	0
电容	dian'rong	0
电容器	dian'rong'qi	0
电刷	dian'shua	0
电网	dian'wang	0
电位	dian'wei	0
电压	dian'ya	0
电压表	dian'ya'biao	0
电压等级	dian'ya'deng'ji	0
电压互感器	dian'ya'hu'gan'qi	0
电压稳定	dian'ya'wen'ding	0
电压源	dian'ya'yuan	0
电阻	dian'zu	0
电阻器	dian'zu'qi	0
跌落式熔断器	die'luo'shi'rong'duan'qi	0
定子	ding'zi	0
动力工程系	dong'li'gong'cheng'xi	0
动态	dong'tai	0
动作速度	dong'zuo'su'du	0
端盖	duan'gai	0
端盖式轴承	duan'gai'shi'zhou'cheng	0
短路故障	duan'lu'gu'zhang	0
断路器	duan'lu'qi	0
对讲门铃	dui'jiang'men'ling	0
额定	e'ding	0
发电厂	fa'dian'chang	0
发电机	fa'dian'ji	0
发电机端	fa'dian'ji'duan	0
反传算法	fan'chuan'suan'fa	0
仿真	fang'zhen	0
仿真分析	fang'zhen'fen'xi	0
仿真数据	fang'zhen'shu'ju	0
非线性系统	fei'xian'xing'xi'tong	0
分接头	fen'jie'tou	0
负荷状态	fu'he'zhuang'tai	0
附加网络	fu'jia'wang'luo	0
附加系统	fu'jia'xi'tong	0
副教授	fu'jiao'shou	0
负序阻抗	fu'xu'zu'kang	0
负载电流百分比显示	fu'zai'dian'liu'bai'fen'bi'xian'shi	0
辅助触点	fu'zhu'chu'dian	0
高顶值	gao'ding'zhi	0
高精度	gao'jing'du	0
高抗	gao'kang	0
高水温故障停机	gao'shui'wen'gu'zhang'ting'ji	0
高压	gao'ya	0
高压侧	gao'ya'ce	0
隔离开关	ge'li'kai'guan	0
隔离器	ge'li'qi	0
给定的	gei'ding'de	0
功角	gong'jiao	0
功角稳定	gong'jiao'wen'ding	0
功率	gong'lv	0
功率因数	gong'lv'yin'shu	0
工频	gong'pin	0
固定串联电容补偿	gu'ding'chuan'lian'dian'rong'bu'chang	0
故障	gu'zhang	0
故障点	gu'zhang'dian	0
故障切除时间	gu'zhang'qie'chu'shi'jian	0
过渡夹	guo'du'jia	0
哈夫抱箍	ha'fu'bao'gu	0
行波	hang'bo	0
行波保护	hang'bo'bao'hu	0
行波继电器	hang'bo'ji'dian'qi	0
行波信号	hang'bo'xin'hao	0
互感器	hu'gan'qi	0
弧焊机	hu'han'ji	0
护环	hu'huan	0
继电保护	ji'dian'bao'hu	0
继电器	ji'dian'qi	0
机端	ji'duan	0
机端电压控制	ji'duan'dian'ya'kong'zhi	0
极限切除时间	ji'xian'qie'chu'shi'jian	0
机油油压表	ji'you'you'ya'biao	0
机组	ji'zu	0
机组运行小时表	ji'zu'yun'xing'xiao'shi'biao	0
机组运行正常	ji'zu'yun'xing'zheng'chang	0
减法运算	jian'fa'yun'suan	0
交流	jiao'liu	0
交流励磁机	jiao'liu'li'ci'ji	0
接触器	jie'chu'qi	0
接线端子	jie'xian'duan'zi	0
接线端子板	jie'xian'duan'zi'ban	0
静态	jing'tai	0
开关站	kai'guan'zhan	0
抗干扰能力	kang'gan'rao'neng'li	0
可靠动作	ke'kao'dong'zuo	0
可倾瓦	ke'qing'wa	0
空侧	kong'ce	0
空导	kong'dao	0
空冷	kong'leng	0
空心导线	kong'xin'dao'xian	0
空载电流	kong'zai'dian'liu	0
空载损耗	kong'zai'sun'hao	0
控制按钮	kong'zhi'an'niu	0
库容量	ku'rong'liang	0
框图	kuang'tu	0
拉线	la'xian	0
浪涌保护器	lang'yong'bao'hu'qi	0
冷却水温度表	leng'que'shui'wen'du'biao	0
励磁	li'ci	0
励磁电流转子电流	li'ci'dian'liu'zhuan'zi'dian'liu	0
励磁机	li'ci'ji	0
励磁机端	li'ci'ji'duan	0
励磁器	li'ci'qi	0
励端	li'duan	0
隶属函数	li'shu'han'shu	0
灵敏性	ling'min'xing	0
零序阻抗	ling'xu'zu'kang	0
漏电断路器	lou'dian'duan'lu'qi	0
落点	luo'dian	0
铝排	lv'pai	0
每相电流	mei'xiang'dian'liu	0
门槛值	men'kan'zhi	0
模糊规则	mo'hu'gui'ze	0
模糊控制	mo'hu'kong'zhi	0
模糊神经网络	mo'hu'shen'jing'wang'luo	0
模糊推理	mo'hu'tui'li	0
模糊推理矩阵	mo'hu'tui'li'ju'zhen	0
母线	mu'xian	0
耐张	nai'zhang	0
耐张段	nai'zhang'duan	0
能量输送	neng'liang'shu'song	0
配电系统	pei'dian'xi'tong	0
配电箱	pei'dian'xiang	0
偏移量	pian'yi'liang	0
频率	pin'lv	0
频率变阻器	pin'lv'bian'zu'qi	0
频率表	pin'lv'biao	0
启动器	qi'dong'qi	0
起动失败停机	qi'dong'shi'bai'ting'ji	0
汽端	qi'duan	0
其它故障显示及输入	qi'ta'gu'zhang'xian'shi'ji'shu'ru	0
千阀	qian'fa	0
千伏安	qian'fu'an	0
千瓦	qian'wa	0
强行励磁	qiang'xing'li'ci	0
切机	qie'ji	0
氢侧	qing'ce	0
求和器	qiu'he'qi	0
区内故障	qu'nei'gu'zhang	0
全面地	quan'mian'di	0
热电偶	re'dian'ou	0
热继电器	re'ji'dian'qi	0
热控	re'kong	0
熔断器	rong'duan'qi	0
容量	rong'liang	0
三角形隶属度函数	san'jiao'xing'li'shu'du'han'shu	0
三菱	san'ling	0
三绕组变压器	san'rao'zu'bian'ya'qi	0
三相电度表	san'xiang'dian'du'biao	0
三相电压	san'xiang'dian'ya	0
三相故障	san'xiang'gu'zhang	0
上限	shang'xian	0
神经网络	shen'jing'wang'luo	0
神经元	shen'jing'yuan	0
声控开关	sheng'kong'kai'guan	0
升压变压器	sheng'ya'bian'ya'qi	0
时间继电器	shi'jian'ji'dian'qi	0
时控开关	shi'kong'kai'guan	0
失去同步	shi'qu'tong'bu	0
失真	shi'zhen	0
受端	shou'duan	0
输电距离	shu'dian'ju'li	0
输电系统	shu'dian'xi'tong	0
输电线	shu'dian'xian	0
输电线路故障	shu'dian'xian'lu'gu'zhang	0
双电源	shuang'dian'yuan	0
双回同杆并架	shuang'hui'tong'gan'bing'jia	0
双绕组变压器	shuang'rao'zu'bian'ya'qi	0
双水内冷	shuang'shui'nei'leng	0
水冷	shui'leng	0
水氢氢	shui'qing'qing	0
四分线损	si'fen'xian'sun	0
算法	suan'fa	0
调节	tiao'jie	0
调节仪	tiao'jie'yi	0
铁损	tie'sun	0
铁芯	tie'xin	0
铁心	tie'xin	0
同步	tong'bu	0
铜电偶	tong'dian'ou	0
铜排	tong'pai	0
铜损	tong'sun	0
投运	tou'yun	0
微动开关	wei'dong'kai'guan	0
稳定	wen'ding	0
温控仪	wen'kong'yi	0
误动作	wu'dong'zuo	0
无功	wu'gong	0
无功补偿	wu'gong'bu'chang	0
无功电流	wu'gong'dian'liu	0
无功负载	wu'gong'fu'zai	0
无功功率	wu'gong'gong'lv	0
无功损耗	wu'gong'sun'hao	0
无刷励磁机	wu'shua'li'ci'ji	0
西门子	xi'men'zi	0
西屋	xi'wu	0
下降率	xia'jiang'lv	0
下降特性	xia'jiang'te'xing	0
下限	xia'xian	0
线夹	xian'jia	0
线路补偿器	xian'lu'bu'chang'qi	0
相减运算	xiang'jian'yun'suan	0
箱式变压器	xiang'shi'bian'ya'qi	0
小波变换	xiao'bo'bian'huan	0
小水电	xiao'shui'dian	0
小型断路器	xiao'xing'duan'lu'qi	0
谐波电流	xie'bo'dian'liu	0
斜率	xie'lv	0
信号灯	xin'hao'deng	0
行程开关	xing'cheng'kai'guan	0
修改的	xiu'gai'de	0
学报	xue'bao	0
延迟变换	yan'chi'bian'huan	0
延迟时间	yan'chi'shi'jian	0
研究方向	yan'jiu'fang'xiang	0
样本集合	yang'ben'ji'he	0
样本空间	yang'ben'kong'jian	0
摇摆	yao'bai	0
遥测	yao'ce	0
遥信	yao'xin	0
荧光灯	ying'guang'deng	0
应急灯	ying'ji'deng	0
用电需求管理	yong'dian'xu'qiu'guan'li	0
有功	you'gong	0
有功负载	you'gong'fu'zai	0
有功功率	you'gong'gong'lv	0
有功损耗	you'gong'sun'hao	0
裕度	yu'du	0
预付费电度表	yu'fu'fei'dian'du'biao	0
运行	yun'xing	0
运行转速	yun'xing'zhuan'su	0
暂态分量	zan'tai'fen'liang	0
暂态行波	zan'tai'hang'bo	0
暂态稳定	zan'tai'wen'ding	0
兆瓦	zhao'wa	0
正序阻抗	zheng'xu'zu'kang	0
直流电抗器	zhi'liu'dian'kang'qi	0
中国电力	zhong'guo'dian'li	0
中间继电器	zhong'jian'ji'dian'qi	0
中线电流	zhong'xian'dian'liu	0
中心环	zhong'xin'huan	0
中压	zhong'ya	0
轴承	zhou'cheng	0
轴瓦	zhou'wa	0
主令开关	zhu'ling'kai'guan	0
柱上变压器	zhu'shang'bian'ya'qi	0
柱上开关	zhu'shang'kai'guan	0
转换开关	zhuan'huan'kai'guan	0
转子	zhuan'zi	0
转子电枢	zhuan'zi'dian'shu	0
装机容量	zhuang'ji'rong'liang	0
自动开关	zi'dong'kai'guan	0
自适应控制方法	zi'shi'ying'kong'zhi'fang'fa	0
自适应系统	zi'shi'ying'xi'tong	0
子系统	zi'xi'tong	0
自学习功能	zi'xue'xi'gong'neng	0
组合开关	zu'he'kai'guan	0
阻抗	zu'kang	0
阻尼	zu'ni	0
最低电流	zui'di'dian'liu	0
最低电压	zui'di'dian'ya	0
最高电流	zui'gao'dian'liu	0
最高电压	zui'gao'dian'ya	0
