艾和真空	ai'he'zhen'kong	0
程序控制系统	cheng'xu'kong'zhi'xi'tong	0
储气罐	chu'qi'guan	0
复合式分子泵组合真空机组	fu'he'shi'fen'zi'beng'zu'he'zhen'kong'ji'zu	0
干式真空泵	gan'shi'zhen'kong'beng	0
境外过滤总成	jing'wai'guo'lv'zong'cheng	0
立式无油往复泵机组	li'shi'wu'you'wang'fu'beng'ji'zu	0
罗茨泵	luo'ci'beng	0
罗茨真空泵	luo'ci'zhen'kong'beng	0
水环真空机组	shui'huan'zhen'kong'ji'zu	0
往复式真空泵	wang'fu'shi'zhen'kong'beng	0
旋风分离器	xuan'feng'fen'li'qi	0
旋片式真空泵机组	xuan'pian'shi'zhen'kong'beng'ji'zu	0
旋转式真空泵	xuan'zhuan'shi'zhen'kong'beng	0
液环真空泵	ye'huan'zhen'kong'beng	0
油封式机械泵	you'feng'shi'ji'xie'beng	0
油扩散旋片泵真空机组	you'kuo'san'xuan'pian'beng'zhen'kong'ji'zu	0
真空泵	zhen'kong'beng	0
真空度	zhen'kong'du	0
真空阀门	zhen'kong'fa'men	0
真空管道	zhen'kong'guan'dao	0
真空气料泵机组	zhen'kong'qi'liao'beng'ji'zu	0
