氨气分析仪	an'qi'fen'xi'yi	0
表面测温电热板	biao'mian'ce'wen'dian're'ban	0
标准口中量有机制备仪	biao'zhun'kou'zhong'liang'you'ji'zhi'bei'yi	0
冰衬保存箱	bing'chen'bao'cun'xiang	0
补充氧气氮气端口	bu'chong'yang'qi'dan'qi'duan'kou	0
不锈钢电热板	bu'xiu'gang'dian're'ban	0
不锈钢电热蒸馏水器	bu'xiu'gang'dian're'zheng'liu'shui'qi	0
不锈钢升降台	bu'xiu'gang'sheng'jiang'tai	0
测汞仪	ce'gong'yi	0
超低温保存箱	chao'di'wen'bao'cun'xiang	0
超低温储存箱	chao'di'wen'chu'cun'xiang	0
超级恒温水浴	chao'ji'heng'wen'shui'yu	0
超级恒温油浴	chao'ji'heng'wen'you'yu	0
程控光照培养箱	cheng'kong'guang'zhao'pei'yang'xiang	0
程控人工气候箱	cheng'kong'ren'gong'qi'hou'xiang	0
储存型双通道温湿度计	chu'cun'xing'shuang'tong'dao'wen'shi'du'ji	0
垂直多用振荡器	chui'zhi'duo'yong'zhen'dang'qi	0
磁力恒温搅拌器	ci'li'heng'wen'jiao'ban'qi	0
磁力加热搅拌器	ci'li'jia're'jiao'ban'qi	0
磁力加热搅拌器双头	ci'li'jia're'jiao'ban'qi'shuang'tou	0
磁力搅拌器	ci'li'jiao'ban'qi	0
大功率磁力搅拌器	da'gong'lv'ci'li'jiao'ban'qi	0
大功率电动搅拌器	da'gong'lv'dian'dong'jiao'ban'qi	0
大功率恒温搅拌器	da'gong'lv'heng'wen'jiao'ban'qi	0
大功率搅拌器	da'gong'lv'jiao'ban'qi	0
大容量振荡器	da'rong'liang'zhen'dang'qi	0
大型调速振荡器	da'xing'tiao'su'zhen'dang'qi	0
打印机	da'yin'ji	0
单孔水浴锅	dan'kong'shui'yu'guo	0
单列六孔水浴锅	dan'lie'liu'kong'shui'yu'guo	0
单列四孔水浴锅	dan'lie'si'kong'shui'yu'guo	0
单人单面垂直净化工作台	dan'ren'dan'mian'chui'zhi'jing'hua'gong'zuo'tai	0
低温保存箱	di'wen'bao'cun'xiang	0
低温储存箱	di'wen'chu'cun'xiang	0
低温恒温恒湿箱	di'wen'heng'wen'heng'shi'xiang	0
低温恒温水槽	di'wen'heng'wen'shui'cao	0
低温冷藏箱	di'wen'leng'cang'xiang	0
低温冷冻储存箱电控系列	di'wen'leng'dong'chu'cun'xiang'dian'kong'xi'lie	0
低温冷却液循环泵	di'wen'leng'que'ye'xun'huan'beng	0
低温强光照培养箱	di'wen'qiang'guang'zhao'pei'yang'xiang	0
低温生化培养箱	di'wen'sheng'hua'pei'yang'xiang	0
电动搅拌玻璃恒温水浴	dian'dong'jiao'ban'bo'li'heng'wen'shui'yu	0
电动离心机	dian'dong'li'xin'ji	0
电动深水采样器	dian'dong'shen'shui'cai'yang'qi	0
电动匀浆机	dian'dong'yun'jiang'ji	0
电热鼓风干燥箱	dian're'gu'feng'gan'zao'xiang	0
电热恒温培养箱	dian're'heng'wen'pei'yang'xiang	0
电热恒温水槽	dian're'heng'wen'shui'cao	0
电热恒温水浴锅	dian're'heng'wen'shui'yu'guo	0
电热套	dian're'tao	0
电子肺活量计	dian'zi'fei'huo'liang'ji	0
电子调温电热套	dian'zi'tiao'wen'dian're'tao	0
冻干机	dong'gan'ji	0
独立限温控制报警系统	du'li'xian'wen'kong'zhi'bao'jing'xi'tong	0
多功能磁力搅拌器	duo'gong'neng'ci'li'jiao'ban'qi	0
多功能搅拌器	duo'gong'neng'jiao'ban'qi	0
多功能射线仪	duo'gong'neng'she'xian'yi	0
多功能数字核辐射仪	duo'gong'neng'shu'zi'he'fu'she'yi	0
多功能双气路大气采样器	duo'gong'neng'shuang'qi'lu'da'qi'cai'yang'qi	0
多功能调速振荡器	duo'gong'neng'tiao'su'zhen'dang'qi	0
多功能振荡器	duo'gong'neng'zhen'dang'qi	0
多头磁力加热搅拌器	duo'tou'ci'li'jia're'jiao'ban'qi	0
多头磁力搅拌器	duo'tou'ci'li'jiao'ban'qi	0
多头恒温磁力加热搅拌器	duo'tou'heng'wen'ci'li'jia're'jiao'ban'qi	0
多头控温磁力搅拌器	duo'tou'kong'wen'ci'li'jiao'ban'qi	0
多用调速振荡器	duo'yong'tiao'su'zhen'dang'qi	0
多用振荡器	duo'yong'zhen'dang'qi	0
二氧化碳分析仪	er'yang'hua'tan'fen'xi'yi	0
二氧化碳细胞培养箱	er'yang'hua'tan'xi'bao'pei'yang'xiang	0
防爆大气采样器	fang'bao'da'qi'cai'yang'qi	0
防爆个体粉尘采样器	fang'bao'ge'ti'fen'chen'cai'yang'qi	0
粉尘采样器	fen'chen'cai'yang'qi	0
封闭电炉	feng'bi'dian'lu	0
风速仪	feng'su'yi	0
干燥箱电热管	gan'zao'xiang'dian're'guan	0
干燥箱控制板	gan'zao'xiang'kong'zhi'ban	0
高精度超级恒温水浴	gao'jing'du'chao'ji'heng'wen'shui'yu	0
高频近区电场测量仪	gao'pin'jin'qu'dian'chang'ce'liang'yi	0
高速台式电动离心机	gao'su'tai'shi'dian'dong'li'xin'ji	0
高温由于振荡器	gao'wen'you'yu'zhen'dang'qi	0
个人计量仪	ge'ren'ji'liang'yi	0
隔水式电热恒温培养箱	ge'shui'shi'dian're'heng'wen'pei'yang'xiang	0
个体粉尘采样器	ge'ti'fen'chen'cai'yang'qi	0
固体样品粉碎机	gu'ti'yang'pin'fen'sui'ji	0
光照全温振荡器	guang'zhao'quan'wen'zhen'dang'qi	0
硅控可调万用电炉	gui'kong'ke'tiao'wan'yong'dian'lu	0
恒流粉尘采样器	heng'liu'fen'chen'cai'yang'qi	0
恒速强力电动搅拌器	heng'su'qiang'li'dian'dong'jiao'ban'qi	0
恒温磁力搅拌器	heng'wen'ci'li'jiao'ban'qi	0
恒温电热套	heng'wen'dian're'tao	0
恒温恒湿器	heng'wen'heng'shi'qi	0
恒温恒湿箱	heng'wen'heng'shi'xiang	0
红外二氧化碳测定仪	hong'wai'er'yang'hua'tan'ce'ding'yi	0
红外线温度计	hong'wai'xian'wen'du'ji	0
红外一氧化碳测定仪	hong'wai'yi'yang'hua'tan'ce'ding'yi	0
呼吸性粉尘采样器	hu'xi'xing'fen'chen'cai'yang'qi	0
回旋振荡器	hui'xuan'zhen'dang'qi	0
积分统计声级计	ji'fen'tong'ji'sheng'ji'ji	0
集热式磁力搅拌器	ji're'shi'ci'li'jiao'ban'qi	0
记忆是照度计	ji'yi'shi'zhao'du'ji	0
甲醛分析仪	jia'quan'fen'xi'yi	0
甲烷气体分析仪	jia'wan'qi'ti'fen'xi'yi	0
加温中心	jia'wen'zhong'xin	0
进口多功能粉碎机	jin'kou'duo'gong'neng'fen'sui'ji	0
净化工作台电机	jing'hua'gong'zuo'tai'dian'ji	0
净化工作台过滤器	jing'hua'gong'zuo'tai'guo'lv'qi	0
精密电动搅拌器	jing'mi'dian'dong'jiao'ban'qi	0
精密増力电动搅拌器	jing'mi'zeng'li'dian'dong'jiao'ban'qi	0
康氏振荡器	kang'shi'zhen'dang'qi	0
可调高速分散器	ke'tiao'gao'su'fen'san'qi	0
可调高速匀浆机	ke'tiao'gao'su'yun'jiang'ji	0
空气微生物采样器	kong'qi'wei'sheng'wu'cai'yang'qi	0
控温不锈钢电热板	kong'wen'bu'xiu'gang'dian're'ban	0
控温磁力搅拌器	kong'wen'ci'li'jiao'ban'qi	0
控温电动搅拌器	kong'wen'dian'dong'jiao'ban'qi	0
快速混匀器	kuai'su'hun'yun'qi	0
矿用粉尘采样器	kuang'yong'fen'chen'cai'yang'qi	0
垃圾填埋场气体检测仪	la'ji'tian'mai'chang'qi'ti'jian'ce'yi	0
立式双数显微电脑恒温气浴振荡箱	li'shi'shuang'shu'xian'wei'dian'nao'heng'wen'qi'yu'zhen'dang'xiang	0
立式压力蒸汽灭菌器	li'shi'ya'li'zheng'qi'mie'jun'qi	0
连续测氡仪	lian'xu'ce'dong'yi	0
硫化氢分析仪	liu'hua'qing'fen'xi'yi	0
六联电动搅拌器	liu'lian'dian'dong'jiao'ban'qi	0
六连电动搅拌器	liu'lian'dian'dong'jiao'ban'qi	0
六联同步电动搅拌器	liu'lian'tong'bu'dian'dong'jiao'ban'qi	0
六联自动升降电动搅拌器	liu'lian'zi'dong'sheng'jiang'dian'dong'jiao'ban'qi	0
露点湿球温湿度计	lu'dian'shi'qiu'wen'shi'du'ji	0
落地式电动离心机	luo'di'shi'dian'dong'li'xin'ji	0
霉菌培养箱	mei'jun'pei'yang'xiang	0
频谱噪音仪	pin'pu'zao'yin'yi	0
瓶式深水采样器	ping'shi'shen'shui'cai'yang'qi	0
气浴恒温振荡器	qi'yu'heng'wen'zhen'dang'qi	0
强力电动搅拌器	qiang'li'dian'dong'jiao'ban'qi	0
亲霉素振荡器	qin'mei'su'zhen'dang'qi	0
青霉素振荡器	qing'mei'su'zhen'dang'qi	0
全气候箱	quan'qi'hou'xiang	0
全温震荡培养箱	quan'wen'zhen'dang'pei'yang'xiang	0
全温振荡器	quan'wen'zhen'dang'qi	0
全自动水质采样器	quan'zi'dong'shui'zhi'cai'yang'qi	0
热空气消毒箱	re'kong'qi'xiao'du'xiang	0
溶浆机	rong'jiang'ji	0
溶氧仪	rong'yang'yi	0
乳脂离心机	ru'zhi'li'xin'ji	0
三用恒温水箱	san'yong'heng'wen'shui'xiang	0
生化培养箱	sheng'hua'pei'yang'xiang	0
生化培养箱电机	sheng'hua'pei'yang'xiang'dian'ji	0
升降台	sheng'jiang'tai	0
生物安全柜	sheng'wu'an'quan'gui	0
食品理化快检箱	shi'pin'li'hua'kuai'jian'xiang	0
石英亚沸高纯水蒸馏器	shi'ying'ya'fei'gao'chun'shui'zheng'liu'qi	0
石英自动双重纯水蒸馏器	shi'ying'zi'dong'shuang'chong'chun'shui'zheng'liu'qi	0
石英自动亚沸高纯水蒸馏器	shi'ying'zi'dong'ya'fei'gao'chun'shui'zheng'liu'qi	0
手持机光粒子计数器	shou'chi'ji'guang'li'zi'ji'shu'qi	0
手持式苯蒸气检测仪	shou'chi'shi'ben'zheng'qi'jian'ce'yi	0
手持式垃圾燃烧气体检测仪	shou'chi'shi'la'ji'ran'shao'qi'ti'jian'ce'yi	0
手提式灭菌器电热管	shou'ti'shi'mie'jun'qi'dian're'guan	0
手提式灭菌器密封圈	shou'ti'shi'mie'jun'qi'mi'feng'quan	0
手提式压力霉菌器	shou'ti'shi'ya'li'mei'jun'qi	0
手掌式二氧化碳测定仪	shou'zhang'shi'er'yang'hua'tan'ce'ding'yi	0
数据采集卡	shu'ju'cai'ji'ka	0
数据储存型温度计	shu'ju'chu'cun'xing'wen'du'ji	0
数据储存性温湿度计	shu'ju'chu'cun'xing'wen'shi'du'ji	0
数显玻璃恒温水浴	shu'xian'bo'li'heng'wen'shui'yu	0
数显玻璃恒温水浴槽	shu'xian'bo'li'heng'wen'shui'yu'cao	0
数显测试高速离心机	shu'xian'ce'shi'gao'su'li'xin'ji	0
数显测速六联电动搅拌器	shu'xian'ce'su'liu'lian'dian'dong'jiao'ban'qi	0
数显超级恒温油浴	shu'xian'chao'ji'heng'wen'you'yu	0
数显垂直多用振荡器	shu'xian'chui'zhi'duo'yong'zhen'dang'qi	0
数显电动离心机	shu'xian'dian'dong'li'xin'ji	0
数显高温箱式电阻炉	shu'xian'gao'wen'xiang'shi'dian'zu'lu	0
数显光照培养箱	shu'xian'guang'zhao'pei'yang'xiang	0
数显恒温板	shu'xian'heng'wen'ban	0
数显恒温搅拌循环水箱	shu'xian'heng'wen'jiao'ban'xun'huan'shui'xiang	0
数显恒温水浴锅	shu'xian'heng'wen'shui'yu'guo	0
数显恒温循环水浴锅	shu'xian'heng'wen'xun'huan'shui'yu'guo	0
数显恒温油浴	shu'xian'heng'wen'you'yu	0
数显控温电动搅拌器	shu'xian'kong'wen'dian'dong'jiao'ban'qi	0
数显全温振荡器	shu'xian'quan'wen'zhen'dang'qi	0
数显三用恒温水箱	shu'xian'san'yong'heng'wen'shui'xiang	0
数显生化培养箱	shu'xian'sheng'hua'pei'yang'xiang	0
数显双向恒温磁力搅拌器	shu'xian'shuang'xiang'heng'wen'ci'li'jiao'ban'qi	0
数显水与恒温振荡器	shu'xian'shui'yu'heng'wen'zhen'dang'qi	0
数显调速用调速振荡器	shu'xian'tiao'su'yong'tiao'su'zhen'dang'qi	0
数显往复式调速多用振荡器	shu'xian'wang'fu'shi'tiao'su'duo'yong'zhen'dang'qi	0
数显震荡培养箱	shu'xian'zhen'dang'pei'yang'xiang	0
数显直流恒速搅拌器	shu'xian'zhi'liu'heng'su'jiao'ban'qi	0
数字大气压力表	shu'zi'da'qi'ya'li'biao	0
数字电导仪	shu'zi'dian'dao'yi	0
数字肺活量计	shu'zi'fei'huo'liang'ji	0
数字粉尘仪	shu'zi'fen'chen'yi	0
数字恒温消解仪	shu'zi'heng'wen'xiao'jie'yi	0
数字激光粉尘仪	shu'zi'ji'guang'fen'chen'yi	0
数字式超级恒温水浴槽	shu'zi'shi'chao'ji'heng'wen'shui'yu'cao	0
数字酸度计	shu'zi'suan'du'ji	0
数字温度计	shu'zi'wen'du'ji	0
数字温湿度计	shu'zi'wen'shi'du'ji	0
数字噪音仪	shu'zi'zao'yin'yi	0
数字照度计	shu'zi'zhao'du'ji	0
双层调速多用振荡器	shuang'ceng'tiao'su'duo'yong'zhen'dang'qi	0
双层摇瓶机	shuang'ceng'yao'ping'ji	0
双列八孔水浴锅	shuang'lie'ba'kong'shui'yu'guo	0
双列六孔水浴锅	shuang'lie'liu'kong'shui'yu'guo	0
双列四孔水浴锅	shuang'lie'si'kong'shui'yu'guo	0
双路粉尘采样器	shuang'lu'fen'chen'cai'yang'qi	0
双人单面垂直净化工作台	shuang'ren'dan'mian'chui'zhi'jing'hua'gong'zuo'tai	0
双数显恒温搅拌器	shuang'shu'xian'heng'wen'jiao'ban'qi	0
双头恒温磁力搅拌器	shuang'tou'heng'wen'ci'li'jiao'ban'qi	0
双向磁力加热搅拌器	shuang'xiang'ci'li'jia're'jiao'ban'qi	0
水浴恒温振荡器	shui'yu'heng'wen'zhen'dang'qi	0
水质理化快检箱	shui'zhi'li'hua'kuai'jian'xiang	0
水质细菌快检箱	shui'zhi'xi'jun'kuai'jian'xiang	0
水质自动采样器	shui'zhi'zi'dong'cai'yang'qi	0
四合一空气质量分析仪	si'he'yi'kong'qi'zhi'liang'fen'xi'yi	0
台式低速大容量离心机	tai'shi'di'su'da'rong'liang'li'xin'ji	0
台式电动离心机	tai'shi'dian'dong'li'xin'ji	0
台式高速离心机	tai'shi'gao'su'li'xin'ji	0
台式水平净化工作台	tai'shi'shui'ping'jing'hua'gong'zuo'tai	0
台式浊度计	tai'shi'zhuo'du'ji	0
调速多用振荡器	tiao'su'duo'yong'zhen'dang'qi	0
调温电热套	tiao'wen'dian're'tao	0
脱色摇床	tuo'se'yao'chuang	0
微波漏能仪	wei'bo'lou'neng'yi	0
微电脑双层测速气浴恒温振荡器	wei'dian'nao'shuang'ceng'ce'su'qi'yu'heng'wen'zhen'dang'qi	0
微量振荡器	wei'liang'zhen'dang'qi	0
温度计	wen'du'ji	0
温湿度计	wen'shi'du'ji	0
污泥采样器	wu'ni'cai'yang'qi	0
新风量二氧化碳检测仪	xin'feng'liang'er'yang'hua'tan'jian'ce'yi	0
袖珍大气采样器	xiu'zhen'da'qi'cai'yang'qi	0
旋片是真空泵	xuan'pian'shi'zhen'kong'beng	0
漩涡混合器	xuan'wo'hun'he'qi	0
血液保存箱	xue'ye'bao'cun'xiang	0
血液低温操作台	xue'ye'di'wen'cao'zuo'tai	0
血液冷藏箱	xue'ye'leng'cang'xiang	0
血液滤白柜	xue'ye'lv'bai'gui	0
血液速冻箱	xue'ye'su'dong'xiang	0
氧气检测仪	yang'qi'jian'ce'yi	0
药品保存箱	yao'pin'bao'cun'xiang	0
药品强光稳定性试验箱	yao'pin'qiang'guang'wen'ding'xing'shi'yan'xiang	0
药品稳定性试验箱	yao'pin'wen'ding'xing'shi'yan'xiang	0
一氧化碳分析仪	yi'yang'hua'tan'fen'xi'yi	0
医用冷藏箱	yi'yong'leng'cang'xiang	0
游泳池水质快检箱	you'yong'chi'shui'zhi'kuai'jian'xiang	0
増力电动搅拌器	zeng'li'dian'dong'jiao'ban'qi	0
震荡培养箱	zhen'dang'pei'yang'xiang	0
真空干燥箱	zhen'kong'gan'zao'xiang	0
蒸馏水器电热管	zheng'liu'shui'qi'dian're'guan	0
蒸馏水器密封圈	zheng'liu'shui'qi'mi'feng'quan	0
智能测汞仪	zhi'neng'ce'gong'yi	0
智能露点湿球温湿度计	zhi'neng'lu'dian'shi'qiu'wen'shi'du'ji	0
自动电位滴定仪	zi'dong'dian'wei'di'ding'yi	0
自动平衡离心机	zi'dong'ping'heng'li'xin'ji	0
紫外照度计	zi'wai'zhao'du'ji	0
组织捣碎匀浆机	zu'zhi'dao'sui'yun'jiang'ji	0
