阿多纳尔福伊尔	a'duo'na'er'fu'yi'er	0
阿尔斯通	a'er'si'tong	0
阿莱克斯雅克特	a'lai'ke'si'ya'ke'te	0
阿兰安德森	a'lan'an'de'sen	0
阿兰享德森	a'lan'xiang'de'sen	0
阿朗佐莫宁	a'lang'zuo'mo'ning	0
阿劳约	a'lao'yue	0
阿里纳斯	a'li'na'si	0
阿里扎	a'li'zha	0
阿龙麦基	a'long'mai'ji	0
阿龙威廉姆斯	a'long'wei'lian'mu'si	0
阿伦	a'lun	0
阿伦艾佛森	a'lun'ai'fo'sen	0
阿伦艾弗森	a'lun'ai'fu'sen	0
阿罗约	a'luo'yue	0
阿马雷斯塔德迈尔	a'ma'lei'si'ta'de'mai'er	0
阿米尔约翰逊	a'mi'er'yue'han'xun	0
阿姆斯特朗	a'mu'si'te'lang	0
阿泰斯特	a'tai'si'te	0
阿特金斯	a'te'jin'si	0
阿维斯特瑞	a'wei'si'te'rui	0
艾达里安格里芬	ai'da'li'an'ge'li'fen	0
爱德华兹	ai'de'hua'zi	0
艾迪巴斯顿	ai'di'ba'si'dun	0
埃迪格里芬	ai'di'ge'li'fen	0
埃迪豪斯	ai'di'hao'si	0
埃迪库里	ai'di'ku'li	0
埃迪琼斯	ai'di'qiong'si	0
埃杜阿多纳胡拉	ai'du'a'duo'na'hu'la	0
埃尔顿布兰德	ai'er'dun'bu'lan'de	0
艾尔哈灵顿	ai'er'ha'ling'dun	0
艾尔杰弗逊	ai'er'jie'fu'xun	0
埃尔森	ai'er'sen	0
艾尔沃特森	ai'er'wo'te'sen	0
艾弗森	ai'fu'sen	0
艾拉纽贝	ai'la'niu'bei	0
埃里	ai'li	0
埃里克丹皮尔	ai'li'ke'dan'pi'er	0
埃里克皮亚考斯基	ai'li'ke'pi'ya'kao'si'ji	0
埃里克斯诺	ai'li'ke'si'nuo	0
埃里克威廉姆斯	ai'li'ke'wei'lian'mu'si	0
埃米卡奥卡福	ai'mi'ka'ao'ka'fu	0
艾文斯	ai'wen'si	0
埃文斯	ai'wen'si	0
安德里斯比德林斯	an'de'li'si'bi'de'lin'si	0
安德里尤斯克维基斯	an'de'li'you'si'ke'wei'ji'si	0
安德烈基里连科	an'de'lie'ji'li'lian'ke	0
安德烈米勒	an'de'lie'mi'le	0
安德烈伊格达拉	an'de'lie'yi'ge'da'la	0
安德鲁拜纳姆	an'de'lu'bai'na'mu	0
安德鲁博格特	an'de'lu'bo'ge'te	0
安德鲁博拉奇	an'de'lu'bo'la'qi	0
安德鲁欧文斯	an'de'lu'ou'wen'si	0
安德森	an'de'sen	0
安德森瓦莱乔	an'de'sen'wa'lai'qiao	0
安迪斯诺西奥尼	an'di'si'nuo'xi'ao'ni	0
安东尼	an'dong'ni	0
安东尼奥丹尼尔斯	an'dong'ni'ao'dan'ni'er'si	0
安东尼奥麦克戴斯	an'dong'ni'ao'mai'ke'dai'si	0
安东尼卡特	an'dong'ni'ka'te	0
安东尼沃克	an'dong'ni'wo'ke	0
安东尼约翰逊	an'dong'ni'yue'han'xun	0
安托艾涅怀特	an'tuo'ai'nie'huai'te	0
安托万贾米森	an'tuo'wan'jia'mi'sen	0
昂戈麦斯	ang'ge'mai'si	0
奥博托	ao'bo'tuo	0
奥多姆	ao'duo'mu	0
奥卡福	ao'ka'fu	0
奥库	ao'ku	0
奥利	ao'li	0
奥里恩格林	ao'li'en'ge'lin	0
奥洛沃坎迪	ao'luo'wo'kan'di	0
奥塞拉哈灵顿	ao'sai'la'ha'ling'dun	0
奥斯汀克罗希尔	ao'si'ting'ke'luo'xi'er	0
奥特劳	ao'te'lao	0
奥特罗	ao'te'luo	0
巴博萨	ba'bo'sa	0
巴蒂	ba'di	0
巴蒂尔	ba'di'er	0
巴蒂斯塔	ba'di'si'ta	0
巴克利	ba'ke'li	0
巴克纳	ba'ke'na	0
巴里	ba'li	0
巴龙	ba'long	0
巴斯	ba'si	0
巴斯顿	ba'si'dun	0
巴特勒	ba'te'le	0
拜伦戴维斯	bai'lun'dai'wei'si	0
拜姆	bai'mu	0
拜纳姆	bai'na'mu	0
班克斯	ban'ke'si	0
邦奇威尔斯	bang'qi'wei'er'si	0
鲍比杰克逊	bao'bi'jie'ke'xun	0
鲍比西蒙斯	bao'bi'xi'meng'si	0
保罗	bao'luo	0
保罗加索尔	bao'luo'jia'suo'er	0
保罗皮尔斯	bao'luo'pi'er'si	0
鲍威尔	bao'wei'er	0
鲍文	bao'wen	0
贝尔	bei'er	0
贝克	bei'ke	0
本高登	ben'gao'deng	0
本华莱士	ben'hua'lai'shi	0
毕比	bi'bi	0
比德林斯	bi'de'lin'si	0
比利托马斯	bi'li'tuo'ma'si	0
比卢普斯	bi'lu'pu'si	0
比诺尤德里	bi'nuo'you'de'li	0
博奥特罗	bo'ao'te'luo	0
博甘斯	bo'gan'si	0
博格特	bo'ge'te	0
伯克	bo'ke	0
波拉德	bo'la'de	0
博拉奇	bo'la'qi	0
博列森	bo'lie'sen	0
伯纳德罗宾逊	bo'na'de'luo'bin'xun	0
博纳尔	bo'na'er	0
博尼费斯涅顿	bo'ni'fei'si'nie'dun	0
波什	bo'shen	0
波斯简诺克巴	bo'si'jian'nuo'ke'ba	0
波塔潘科	bo'ta'pan'ke	0
波特洛	bo'te'luo	0
勃文	bo'wen	0
波西	bo'xi	0
博伊金斯	bo'yi'jin'si	0
博伊斯迪奥	bo'yi'si'di'ao	0
布拉德米勒	bu'la'de'mi'le	0
布莱恩格兰特	bu'lai'en'ge'lan'te	0
布莱恩卡迪纳尔	bu'lai'en'ka'di'na'er	0
布莱恩库克	bu'lai'en'ku'ke	0
布莱恩斯金纳	bu'lai'en'si'jin'na	0
布莱恩斯卡拉布赖恩	bu'lai'en'si'ka'la'bu'lai'en	0
布莱恩特	bu'lai'en'te	0
布莱文奈特	bu'lai'wen'nai'te	0
布兰德	bu'lan'de	0
布兰登巴斯	bu'lan'deng'ba'si	0
布朗	bu'lang	0
布朗特	bu'lang'te	0
布雷克	bu'lei'ke	0
布雷泽克	bu'lei'ze'ke	0
布里斯怀特	bu'li'si'huai'te	0
布鲁斯鲍文	bu'lu'si'bao'wen	0
布伦丹海伍德	bu'lun'dan'hai'wu'de	0
布伦森	bu'lun'sen	0
布伦特巴里	bu'lun'te'ba'li	0
布斯	bu'si	0
布泽尔	bu'ze'er	0
查尔里维拉纽瓦	cha'er'li'wei'la'niu'wa	0
查基阿特金斯	cha'ji'a'te'jin'si	0
查卡利迪斯	cha'ka'li'di'si	0
查克海耶斯	cha'ke'hai'ye'si	0
查理贝尔	cha'li'bei'er	0
柴德里斯	chai'de'li'si	0
昌西比卢普斯	chang'xi'bi'lu'pu'si	0
达迪琼斯	da'di'qiong'si	0
达科米里西奇	da'ke'mi'li'xi'qi	0
达雷尔阿姆斯特朗	da'lei'er'a'mu'si'te'lang	0
达里克马丁	da'li'ke'ma'ding	0
达蒙琼斯	da'meng'qiong'si	0
达蒙斯塔德迈尔	da'meng'si'ta'de'mai'er	0
达瑞尔斯迈尔斯	da'rui'er'si'mai'er'si	0
达瑞斯桑贾拉	da'rui'si'sang'jia'la	0
大卫哈里森	da'wei'ha'li'sen	0
大卫李	da'wei'li	0
大卫韦斯利	da'wei'wei'si'li	0
大卫韦斯特	da'wei'wei'si'te	0
戴德尔艾鲁加姆鹏加	dai'de'er'ai'lu'jia'mu'peng'jia	0
戴尔戴维斯	dai'er'dai'wei'si	0
戴勒姆波特	dai'le'mu'bo'te	0
戴米恩威尔金斯	dai'mi'en'wei'er'jin'si	0
戴维斯	dai'wei'si	0
丹迪考	dan'di'kao	0
丹加祖里奇	dan'jia'zu'li'qi	0
丹尼尔斯	dan'ni'er'si	0
丹尼尔伊文	dan'ni'er'yi'wen	0
丹尼福特森	dan'ni'fu'te'sen	0
丹尼格兰格	dan'ni'ge'lan'ge	0
丹皮尔	dan'pi'er	0
德尔菲诺	de'er'fei'nuo	0
德尔克	de'er'ke	0
德怀恩琼斯	de'huai'en'qiong'si	0
德怀恩韦德	de'huai'en'wei'de	0
德怀特霍华德	de'huai'te'huo'hua'de	0
德克诺维茨基	de'ke'nuo'wei'ci'ji	0
德朗特韦斯特	de'lang'te'wei'si'te	0
德里克费舍尔	de'li'ke'fei'she'er	0
德鲁古登	de'lu'gu'deng	0
德玛尔约翰逊	de'ma'er'yue'han'xun	0
德萨盖纳迪奥普	de'sa'gai'na'di'ao'pu	0
德斯蒙德梅森	de'si'meng'de'mei'sen	0
德文哈里斯	de'wen'ha'li'si	0
邓肯	deng'ken	0
邓利维	deng'li'wei	0
迪安纳	di'an'na	0
迪奥	di'ao	0
迪奥古	di'ao'gu	0
迪奥普	di'ao'pu	0
迪考	di'kao	0
迪克逊	di'ke'xun	0
迪肯贝穆托姆博	di'ken'bei'mu'tuo'mu'bo	0
狄龙威廉姆斯	di'long'wei'lian'mu'si	0
蒂姆邓肯	di'mu'deng'ken	0
蒂姆托马斯	di'mu'tuo'ma'si	0
迪文布朗	di'wen'bu'lang	0
迪文格林	di'wen'ge'lin	0
迪文乔治	di'wen'qiao'zhi	0
迪肖恩史蒂文森	di'xiao'en'shi'di'wen'sen	0
杜洪	du'hong	0
杜林	du'lin	0
杜诺泰勒	du'nuo'tai'le	0
杜普里	du'pu'li	0
多雷尔赖特	duo'lei'er'lai'te	0
多列亚克	duo'lie'ya'ke	0
厄尔巴龙	e'er'ba'long	0
厄尔博伊金斯	e'er'bo'yi'jin'si	0
法布瑞斯尔奥博托	fa'bu'rui'si'er'ao'bo'tuo	0
法尔顿	fa'er'dun	0
法利克斯	fa'li'ke'si	0
范埃克塞尔	fan'ai'ke'sai'er	0
范霍恩	fan'huo'en	0
费舍尔	fei'she'er	0
费泽尔	fei'ze'er	0
芬利	fen'li	0
弗拉基米尔拉德马诺维奇	fu'la'ji'mi'er'la'de'ma'nuo'wei'qi	0
弗拉姆	fu'la'mu	0
弗莱	fu'lai	0
弗朗西斯	fu'lang'xi'si	0
弗朗西斯科埃尔森	fu'lang'xi'si'ke'ai'er'sen	0
弗朗西斯科贾奇	fu'lang'xi'si'ke'jia'qi	0
弗雷德琼斯	fu'lei'de'qiong'si	0
福斯特	fu'si'te	0
福特	fu'te	0
福特森	fu'te'sen	0
福伊尔	fu'yi'er	0
高登	gao'deng	0
戈登吉里塞克	ge'deng'ji'li'sai'ke	0
格拉汉姆	ge'la'han'mu	0
格兰尔德格林	ge'lan'er'de'ge'lin	0
格兰格	ge'lan'ge	0
格兰特	ge'lan'te	0
格兰特希尔	ge'lan'te'xi'er	0
格雷格奥登	ge'lei'ge'ao'deng	0
格雷格巴克纳	ge'lei'ge'ba'ke'na	0
格里芬	ge'li'fen	0
格林	ge'lin	0
戈麦斯	ge'mai'si	0
古登	gu'deng	0
哈德森	ha'de'sen	0
哈弗里斯	ha'fu'li'si	0
哈基姆奥拉朱旺	ha'ji'mu'ao'la'zhu'wang	0
哈基姆瓦里克	ha'ji'mu'wa'li'ke	0
哈里森	ha'li'sen	0
哈里斯	ha'li'si	0
哈灵顿	ha'ling'dun	0
哈普灵	ha'pu'ling	0
哈塞尔	ha'sai'er	0
哈斯勒姆	ha'si'le'mu	0
哈特	ha'te	0
海德	hai'de	0
海伍德	hai'wu'de	0
海耶斯	hai'ye'si	0
汉密尔顿	han'mi'er'dun	0
豪斯	hao'si	0
亨特	heng'te	0
华莱士	hua'lai'shi	0
怀特	huai'te	0
霍华德	huo'hua'de	0
霍吉	huo'ji	0
霍里	huo'li	0
基德	ji'de	0
吉尔伯特阿里纳斯	ji'er'bo'te'a'li'na'si	0
基利科沃尔	ji'li'ke'wo'er	0
基里连科	ji'li'lian'ke	0
吉里塞克	ji'li'sai'ke	0
吉姆杰克逊	ji'mu'jie'ke'xun	0
吉诺比利	ji'nuo'bi'li	0
基斯博甘斯	ji'si'bo'gan'si	0
基斯范霍恩	ji'si'fan'huo'en	0
基翁杜林	ji'weng'du'lin	0
加里蒂	jia'li'di	0
加里佩顿	jia'li'pei'dun	0
贾里奇	jia'li'qi	0
贾伦科林斯	jia'lun'ke'lin'si	0
贾马尔克劳福德	jia'ma'er'ke'lao'fu'de	0
贾马尔马格洛伊尔	jia'ma'er'ma'ge'luo'yi'er	0
贾马尔桑普森	jia'ma'er'sang'pu'sen	0
贾马尔汀斯利	jia'ma'er'ting'si'li	0
贾米森	jia'mi'sen	0
加内特	jia'nei'te	0
贾奇	jia'qi	0
贾瑞德杰弗里斯	jia'rui'de'jie'fu'li'si	0
贾森哈特	jia'sen'ha'te	0
贾森基德	jia'sen'ji'de	0
贾森卡波诺	jia'sen'ka'bo'nuo	0
贾森科林斯	jia'sen'ke'lin'si	0
贾森理查德森	jia'sen'li'cha'de'sen	0
贾森马克希尔	jia'sen'ma'ke'xi'er	0
贾森特里	jia'sen'te'li	0
贾森威廉姆斯	jia'sen'wei'lian'mu'si	0
贾斯科维休斯	jia'si'ke'wei'xiu'si	0
贾斯汀里德	jia'si'ting'li'de	0
加索尔	jia'suo'er	0
贾维斯海耶斯	jia'wei'si'hai'ye'si	0
加祖里奇	jia'zu'li'qi	0
简尼诺帕科	jian'ni'nuo'pa'ke	0
杰弗福斯特	jie'fu'fu'si'te	0
杰弗里斯	jie'fu'li'si	0
杰夫麦金尼斯	jie'fu'mai'jin'ni'si	0
杰弗森	jie'fu'sen	0
杰弗逊	jie'fu'xun	0
杰克	jie'ke	0
杰克巴特勒	jie'ke'ba'te'le	0
杰克查卡利迪斯	jie'ke'cha'ka'li'di'si	0
杰克沃斯库尔	jie'ke'wo'si'ku'er	0
杰克逊	jie'ke'xun	0
杰拉尔德华莱士	jie'la'er'de'hua'lai'shi	0
杰里斯塔克豪斯	jie'li'si'ta'ke'hao'si	0
杰伦罗斯	jie'lun'luo'si	0
杰罗姆詹姆斯	jie'luo'mu'zhan'mu'si	0
杰梅因奥尼尔	jie'mei'yin'ao'ni'er	0
杰米尔尼尔森	jie'mi'er'ni'er'sen	0
杰瑞特杰克	jie'rui'te'jie'ke	0
卡巴卡帕	ka'ba'ka'pa	0
卡波诺	ka'bo'nuo	0
卡迪纳尔	ka'di'na'er	0
卡蒂诺莫布里	ka'di'nuo'mo'bu'li	0
卡尔伯特切尼	ka'er'bo'te'qie'ni	0
卡尔迪伦	ka'er'di'lun	0
卡尔马龙	ka'er'ma'long	0
卡尔文布斯	ka'er'wen'bu'si	0
卡尔文迈尔斯	ka'er'wen'mai'er'si	0
卡龙巴特勒	ka'long'ba'te'le	0
卡洛	ka'luo	0
卡洛斯阿罗约	ka'luo'si'a'luo'yue	0
卡洛斯布泽尔	ka'luo'si'bu'ze'er	0
卡洛斯德尔菲诺	ka'luo'si'de'er'fei'nuo	0
卡曼	ka'man	0
卡梅隆安东尼	ka'mei'long'an'dong'ni	0
卡塞尔	ka'sai'er	0
卡托	ka'tuo	0
卡亚帕	ka'ya'pa	0
凯斯迈克里奥德	kai'si'mai'ke'li'ao'de	0
凯文奥利	kai'wen'ao'li	0
凯文博列森	kai'wen'bo'lie'sen	0
凯文杜兰特	kai'wen'du'lan'te	0
凯文加内特	kai'wen'jia'nei'te	0
凯文卡托	kai'wen'ka'tuo	0
凯文马丁	kai'wen'ma'ding	0
坎比	kan'bi	0
科比布莱恩特	ke'bi'bu'lai'en'te	0
科尔克斯耐德	ke'er'ke'si'nai'de	0
克尔斯蒂奇	ke'er'si'di'qi	0
柯克辛里奇	ke'ke'xin'li'qi	0
克拉克斯顿	ke'la'ke'si'dun	0
克劳福德	ke'lao'fu'de	0
科雷萨	ke'lei'sa	0
克利福罗宾逊	ke'li'fu'luo'bin'xun	0
科里马盖蒂	ke'li'ma'gai'di	0
科里森	ke'li'sen	0
克里斯保罗	ke'li'si'bao'luo	0
克里斯波什	ke'li'si'bo'shen	0
克里斯杜洪	ke'li'si'du'hong	0
克里斯哈弗里斯	ke'li'si'ha'fu'li'si	0
克里斯卡曼	ke'li'si'ka'man	0
克里斯米姆	ke'li'si'mi'mu	0
克里斯塔夫特	ke'li'si'ta'fu'te	0
克里斯韦伯	ke'li'si'wei'bo	0
克里斯韦尔考克斯	ke'li'si'wei'er'kao'ke'si	0
科利斯威廉姆森	ke'li'si'wei'lian'mu'sen	0
科林斯	ke'lin'si	0
科罗勒夫	ke'luo'le'fu	0
克罗希尔	ke'luo'xi'er	0
柯特托马斯	ke'te'tuo'ma'si	0
科沃尔	ke'wo'er	0
肯德里克帕金斯	ken'de'li'ke'pa'jin'si	0
肯尼托马斯	ken'ni'tuo'ma'si	0
肯扬马丁	ken'yang'ma'ding	0
库克	ku'ke	0
库里	ku'li	0
夸梅布朗	kua'mei'bu'lang	0
奎恩特伍兹	kui'en'te'wu'zi	0
昆廷理查德森	kun'ting'li'cha'de'sen	0
昆廷罗斯	kun'ting'luo'si	0
拉德马诺维奇	la'de'ma'nuo'wei'qi	0
拉多斯拉夫内斯特洛维奇	la'duo'si'la'fu'nei'si'te'luo'wei'qi	0
拉菲尔阿劳约	la'fei'er'a'lao'yue	0
拉夫阿尔斯通	la'fu'a'er'si'tong	0
拉弗伦茨	la'fu'lun'ci	0
拉加贝尔	la'jia'bei'er	0
拉里休斯	la'li'xiu'si	0
拉伦斯罗伯特斯	la'lun'si'luo'bo'te'si	0
拉马尔奥多姆	la'ma'er'ao'duo'mu	0
拉蒙德穆雷	la'meng'de'mu'lei	0
拉沙德刘易斯	la'sha'de'liu'yi'si	0
拉特利夫	la'te'li'fu	0
拉希德华莱士	la'xi'de'hua'lai'shi	0
拉希德麦肯茨	la'xi'de'mai'ken'ci	0
拉希姆	la'xi'mu	0
拉休巴特勒	la'xiu'ba'te'le	0
莱纳德	lai'na'de	0
赖特	lai'te	0
兰多夫	lan'duo'fu	0
兰佩	lan'pei	0
勒布朗詹姆斯	le'bu'lang'zhan'mu'si	0
雷阿伦	lei'a'lun	0
雷布拉卡	lei'bu'la'ka	0
雷吉埃文斯	lei'ji'ai'wen'si	0
雷蒙德法尔顿	lei'meng'de'fa'er'dun	0
雷纳德克尔斯蒂奇	lei'na'de'ke'er'si'di'qi	0
里查德弗拉姆	li'cha'de'fu'la'mu	0
理查德汉密尔顿	li'cha'de'han'mi'er'dun	0
理查德杰弗森	li'cha'de'jie'fu'sen	0
理查德森	li'cha'de'sen	0
里德	li'de	0
里德诺	li'de'nuo	0
里夫拉弗伦茨	li'fu'la'fu'lun'ci	0
里基戴维斯	li'ji'dai'wei'si	0
里克布伦森	li'ke'bu'lun'sen	0
李纳斯科雷萨	li'na'si'ke'lei'sa	0
利文斯顿	li'wen'si'dun	0
林德罗巴博萨	lin'de'luo'ba'bo'sa	0
林顿约翰逊三世	lin'dun'yue'han'xun'san'shi	0
林赛亨特	lin'sai'heng'te	0
刘易斯	liu'yi'si	0
鲁本帕特森	lu'ben'pa'te'sen	0
鲁芬	lu'fen	0
卢卡斯三世	lu'ka'si'san'shi	0
卢克杰克逊	lu'ke'jie'ke'xun	0
鲁克里德诺	lu'ke'li'de'nuo	0
卢克沃顿	lu'ke'wo'dun	0
卢瑟海德	lu'se'hai'de	0
路易斯威廉姆斯	lu'yi'si'wei'lian'mu'si	0
罗宾逊	luo'bin'xun	0
罗伯特霍里	luo'bo'te'huo'li	0
罗伯特斯	luo'bo'te'si	0
罗伯特斯威福特	luo'bo'te'si'wei'fu'te	0
罗恩阿泰斯特	luo'en'a'tai'si'te	0
罗尔邓	luo'er'deng	0
洛伦岑赖特	luo'lun'cen'lai'te	0
洛伦伍兹	luo'lun'wu'zi	0
罗纳德杜普里	luo'na'de'du'pu'li	0
罗纳德穆雷	luo'na'de'mu'lei	0
罗尼普莱斯	luo'ni'pu'lai'si	0
罗尼图里亚夫	luo'ni'tu'li'ya'fu	0
罗斯	luo'si	0
罗伊尔伊沃伊	luo'yi'er'yi'wo'yi	0
马布里	ma'bu'li	0
马丁	ma'ding	0
马盖蒂	ma'gai'di	0
马格洛伊尔	ma'ge'luo'yi'er	0
马克布朗特	ma'ke'bu'lang'te	0
马科贾里奇	ma'ke'jia'li'qi	0
马克杰克逊	ma'ke'jie'ke'xun	0
马克麦德森	ma'ke'mai'de'sen	0
马克斯	ma'ke'si	0
马克希尔	ma'ke'xi'er	0
马库斯班克斯	ma'ku'si'ban'ke'si	0
马库斯费泽尔	ma'ku'si'fei'ze'er	0
马库斯坎比	ma'ku'si'kan'bi	0
马奎斯丹尼尔斯	ma'kui'si'dan'ni'er'si	0
马里昂	ma'li'ang	0
马里克阿伦	ma'li'ke'a'lun	0
马里克罗斯	ma'li'ke'luo'si	0
马努吉诺比利	ma'nu'ji'nuo'bi'li	0
马绍尔	ma'shao'er	0
马特博纳尔	ma'te'bo'na'er	0
马特尔韦伯斯特	ma'te'er'wei'bo'si'te	0
马特哈普灵	ma'te'ha'pu'ling	0
马特卡洛	ma'te'ka'luo	0
马特纳斯安德里尤斯克维基斯	ma'te'na'si'an'de'li'you'si'ke'wei'ji'si	0
马文威廉姆斯	ma'wen'wei'lian'mu'si	0
马西耶兰佩	ma'xi'ye'lan'pei	0
麦德森	mai'de'sen	0
迈尔斯	mai'er'si	0
麦基	mai'ji	0
麦金尼斯	mai'jin'ni'si	0
迈卡蒂	mai'ka'di	0
麦克毕比	mai'ke'bi'bi	0
麦克戴斯	mai'ke'dai'si	0
麦克邓利维	mai'ke'deng'li'wei	0
迈克尔奥洛沃坎迪	mai'ke'er'ao'luo'wo'kan'di	0
迈克尔多列亚克	mai'ke'er'duo'lie'ya'ke	0
迈克尔芬利	mai'ke'er'fen'li	0
迈克尔里德	mai'ke'er'li'de	0
迈克尔皮特鲁斯	mai'ke'er'pi'te'lu'si	0
迈克尔乔丹	mai'ke'er'qiao'dan	0
迈克尔斯维特尼	mai'ke'er'si'wei'te'ni	0
迈克里奥德	mai'ke'li'ao'de	0
迈克鲁芬	mai'ke'lu'fen	0
麦克米勒	mai'ke'mi'le	0
麦克维尔克斯	mai'ke'wei'er'ke'si	0
麦克詹姆斯	mai'ke'zhan'mu'si	0
麦肯茨	mai'ken'ci	0
梅尔文埃里	mei'er'wen'ai'li	0
梅米特奥库	mei'mi'te'ao'ku	0
梅森	mei'sen	0
孟塔伊利斯	meng'ta'yi'li'si	0
米尔特帕勒西奥	mi'er'te'pa'le'xi'ao	0
米基莫尔	mi'ji'mo'er	0
米勒	mi'le	0
米里西奇	mi'li'xi'qi	0
米姆	mi'mu	0
莫布里	mo'bu'li	0
莫尔	mo'er	0
墨菲	mo'fei	0
莫罕默德	mo'han'mo'de	0
莫里斯艾文斯	mo'li'si'ai'wen'si	0
莫里斯皮特森	mo'li'si'pi'te'sen	0
莫里斯泰勒	mo'li'si'tai'le	0
莫里斯威廉姆斯	mo'li'si'wei'lian'mu'si	0
莫宁	mo'ning	0
魔术师约翰逊	mo'shu'shi'yue'han'xun	0
穆雷	mu'lei	0
姆鹏加	mu'peng'jia	0
穆托姆博	mu'tuo'mu'bo	0
纳胡拉	na'hu'la	0
纳什	na'shi	0
纳兹尔莫罕默德	na'zi'er'mo'han'mo'de	0
奈奈	nai'nai	0
奈特	nai'te	0
内斯特洛维奇	nei'si'te'luo'wei'qi	0
内特罗宾逊	nei'te'luo'bin'xun	0
尼尔森	ni'er'sen	0
尼克范埃克塞尔	ni'ke'fan'ai'ke'sai'er	0
尼克科里森	ni'ke'ke'li'sen	0
涅顿	nie'dun	0
纽贝	niu'bei	0
诺尔法利克斯	nuo'er'fa'li'ke'si	0
诺克巴	nuo'ke'ba	0
诺维茨基	nuo'wei'ci'ji	0
诺西奥尼	nuo'xi'ao'ni	0
欧文斯	ou'wen'si	0
帕楚利亚	pa'chu'li'ya	0
帕夫洛维奇	pa'fu'luo'wei'qi	0
帕金斯	pa'jin'si	0
帕克	pa'ke	0
帕科	pa'ke	0
帕勒西奥	pa'le'xi'ao	0
帕特伯克	pa'te'bo'ke	0
帕特加里蒂	pa'te'jia'li'di	0
帕特森	pa'te'sen	0
佩顿	pei'dun	0
佩贾斯托贾科维奇	pei'jia'si'tuo'jia'ke'wei'qi	0
佩普索乌	pei'pu'suo'wu	0
皮尔斯	pi'er'si	0
皮蓬	pi'peng	0
皮特鲁斯	pi'te'lu'si	0
皮特森	pi'te'sen	0
皮亚考斯基	pi'ya'kao'si'ji	0
普莱斯	pu'lai'si	0
普里茨比拉	pu'li'ci'bi'la	0
普里莫兹布雷泽克	pu'li'mo'zi'bu'lei'ze'ke	0
普林斯	pu'lin'si	0
钱德勒	qian'de'le	0
钱宁弗莱	qian'ning'fu'lai	0
乔丹	qiao'dan	0
乔尔普里茨比拉	qiao'er'pu'li'ci'bi'la	0
乔什柴德里斯	qiao'shen'chai'de'li'si	0
乔什霍华德	qiao'shen'huo'hua'de	0
乔什史密斯	qiao'shen'shi'mi'si	0
乔史密斯	qiao'shi'mi'si	0
乔伊格拉汉姆	qiao'yi'ge'la'han'mu	0
乔约翰逊	qiao'yue'han'xun	0
乔治	qiao'zhi	0
切尼	qie'ni	0
琼斯	qiong'si	0
瑞安勃文	rui'an'bo'wen	0
瑞乐马绍尔	rui'le'ma'shao'er	0
萨缪尔戴勒姆波特	sa'miu'er'dai'le'mu'bo'te	0
萨姆卡塞尔	sa'mu'ka'sai'er	0
萨沙乌贾基茨	sa'sha'wu'jia'ji'ci	0
塞巴斯蒂安特尔费尔	sai'ba'si'di'an'te'er'fei'er	0
桑贾拉	sang'jia'la	0
桑普森	sang'pu'sen	0
沙恩巴蒂尔	sha'en'ba'di'er	0
沙福里克兰多夫	sha'fu'li'ke'lan'duo'fu	0
沙奎尔奥尼尔	sha'kui'er'ao'ni'er	0
沙里姆斯塔德迈尔	sha'li'mu'si'ta'de'mai'er	0
沙伦纳斯贾斯科维休斯	sha'lun'na'si'jia'si'ke'wei'xiu'si	0
山顿安德森	shan'dun'an'de'sen	0
史蒂芬布雷克	shi'di'fen'bu'lei'ke	0
史蒂夫弗朗西斯	shi'di'fu'fu'lang'xi'si	0
史蒂夫纳什	shi'di'fu'na'shi	0
史蒂文亨特	shi'di'wen'heng'te	0
史蒂文森	shi'di'wen'sen	0
史密斯	shi'mi'si	0
斯蒂芬格拉汉姆	si'di'fen'ge'la'han'mu	0
斯蒂芬杰克逊	si'di'fen'jie'ke'xun	0
斯蒂芬马布里	si'di'fen'ma'bu'li	0
斯金纳	si'jin'na	0
斯卡拉布赖恩	si'ka'la'bu'lai'en	0
斯科特波拉德	si'ke'te'bo'la'de	0
斯马什帕克	si'ma'shen'pa'ke	0
斯弥恩	si'mi'en	0
斯耐德	si'nai'de	0
斯诺	si'nuo	0
斯皮蒂克拉克斯顿	si'pi'di'ke'la'ke'si'dun	0
斯塔德迈尔	si'ta'de'mai'er	0
斯塔克豪斯	si'ta'ke'hao'si	0
斯特罗迈尔斯威夫特	si'te'luo'mai'er'si'wei'fu'te	0
斯特瑞	si'te'rui	0
斯托贾科维奇	si'tuo'jia'ke'wei'qi	0
斯托克顿	si'tuo'ke'dun	0
斯威夫特	si'wei'fu'te	0
斯威福特	si'wei'fu'te	0
斯维特尼	si'wei'te'ni	0
斯泽比亚克	si'ze'bi'ya'ke	0
孙悦	sun'yue	0
索蒙斯	suo'meng'si	0
索乌	suo'wu	0
塔夫特	ta'fu'te	0
泰勒	tai'le	0
泰龙鲁	tai'long'lu	0
泰森钱德勒	tai'sen'qian'de'le	0
泰夏安普林斯	tai'xia'an'pu'lin'si	0
唐尼尔马绍尔	tang'ni'er'ma'shao'er	0
特尔费尔	te'er'fei'er	0
特科格鲁	te'ke'ge'lu	0
特拉维斯奥特劳	te'la'wei'si'ao'te'lao	0
特拉维斯迪安纳	te'la'wei'si'di'an'na	0
特兰顿哈塞尔	te'lan'dun'ha'sai'er	0
特雷沃阿里扎	te'lei'wo'a'li'zha	0
特雷西麦克格雷迪	te'lei'xi'mai'ke'ge'lei'di	0
特里	te'li	0
特罗伊哈德森	te'luo'yi'ha'de'sen	0
特罗伊墨菲	te'luo'yi'mo'fei	0
汀斯利	ting'si'li	0
图里亚夫	tu'li'ya'fu	0
托马斯	tuo'ma'si	0
托尼阿伦	tuo'ni'a'lun	0
托尼巴蒂	tuo'ni'ba'di	0
托尼德尔克	tuo'ni'de'er'ke	0
托尼帕克	tuo'ni'pa'ke	0
瓦夫	wa'fu	0
瓦弗尔	wa'fu'er	0
瓦莱乔	wa'lai'qiao	0
瓦里克	wa'li'ke	0
韦伯	wei'bo	0
韦伯斯特	wei'bo'si'te	0
韦德	wei'de	0
维尔拜姆	wei'er'bai'mu	0
威尔金斯	wei'er'jin'si	0
韦尔考克斯	wei'er'kao'ke'si	0
维尔克斯	wei'er'ke'si	0
威尔斯	wei'er'si	0
韦弗	wei'fu	0
维克顿瓦夫	wei'ke'dun'wa'fu	0
维克多卡亚帕	wei'ke'duo'ka'ya'pa	0
维拉纽瓦	wei'la'niu'wa	0
威利格林	wei'li'ge'lin	0
威廉姆森	wei'lian'mu'sen	0
威廉姆斯	wei'lian'mu'si	0
维尼斯弥恩	wei'ni'si'mi'en	0
韦斯利	wei'si'li	0
韦斯特	wei'si'te	0
维塔利波塔潘科	wei'ta'li'bo'ta'pan'ke	0
文贝克	wen'bei'ke	0
文斯卡特	wen'si'ka'te	0
沃顿	wo'dun	0
沃恩	wo'en	0
沃尔特迈卡蒂	wo'er'te'mai'ka'di	0
沃克	wo'ke	0
沃利斯泽比亚克	wo'li'si'ze'bi'ya'ke	0
沃什莱纳德	wo'shen'lai'na'de	0
沃斯库尔	wo'si'ku'er	0
沃特森	wo'te'sen	0
乌杜尼斯哈斯勒姆	wu'du'ni'si'ha'si'le'mu	0
乌贾基茨	wu'jia'ji'ci	0
伍兹	wu'zi	0
西奥拉特利夫	xi'ao'la'te'li'fu	0
希达耶特特科格鲁	xi'da'ye'te'te'ke'ge'lu	0
西恩马克斯	xi'en'ma'ke'si	0
希尔	xi'er	0
西蒙斯	xi'meng'si	0
享德森	xiang'de'sen	0
肖恩利文斯顿	xiao'en'li'wen'si'dun	0
肖恩马里昂	xiao'en'ma'li'ang	0
肖恩梅	xiao'en'mei	0
谢里夫阿卜杜拉希姆	xie'li'fu'a'bu'du'la'xi'mu	0
辛历顿	xin'li'dun	0
辛里奇	xin'li'qi	0
休斯	xiu'si	0
雅克特	ya'ke'te	0
雅克沃恩	ya'ke'wo'en	0
亚历山大帕夫洛维奇	ya'li'shan'da'pa'fu'luo'wei'qi	0
雅罗斯拉夫科罗勒夫	ya'luo'si'la'fu'ke'luo'le'fu	0
姚明	yao'ming	0
伊尔格斯卡斯	yi'er'ge'si'ka'si	0
伊格达拉	yi'ge'da'la	0
易建联	yi'jian'lian	0
伊克迪奥古	yi'ke'di'ao'gu	0
伊利斯	yi'li'si	0
伊斯特班巴蒂斯塔	yi'si'te'ban'ba'di'si'ta	0
伊坦托马斯	yi'tan'tuo'ma'si	0
伊文	yi'wen	0
伊沃伊	yi'wo'yi	0
尤德里	you'de'li	0
约翰爱德华兹	yue'han'ai'de'hua'zi	0
约翰卢卡斯三世	yue'han'lu'ka'si'san'shi	0
约翰索蒙斯	yue'han'suo'meng'si	0
约翰托马斯	yue'han'tuo'ma'si	0
约翰逊	yue'han'xun	0
约翰逊三世	yue'han'xun'san'shi	0
约什鲍威尔	yue'shen'bao'wei'er	0
约什卡尔迪伦	yue'shen'ka'er'di'lun	0
泽亚克雷布拉卡	ze'ya'ke'lei'bu'la'ka	0
扎克卡巴卡帕	zha'ke'ka'ba'ka'pa	0
扎克兰多夫	zha'ke'lan'duo'fu	0
扎伊德鲁纳斯伊尔格斯卡斯	zha'yi'de'lu'na'si'yi'er'ge'si'ka'si	0
扎扎帕楚利亚	zha'zha'pa'chu'li'ya	0
詹姆斯波西	zhan'mu'si'bo'xi	0
詹姆斯琼斯	zhan'mu'si'qiong'si	0
詹姆斯辛历顿	zhan'mu'si'xin'li'dun	0
朱安迪克逊	zhu'an'di'ke'xun	0
朱汉波特洛	zhu'han'bo'te'luo	0
朱利叶斯霍吉	zhu'li'ye'si'huo'ji	0
朱梅因琼斯	zhu'mei'yin'qiong'si	0
朱万霍华德	zhu'wan'huo'hua'de	0
