阿巴丹	a'ba'dan	0
阿巴斯港	a'ba'si'gang	0
阿比让	a'bi'rang	0
阿伯丁郡	a'bo'ding'jun	0
阿布扎比	a'bu'za'bi	0
阿尔汉格尔斯克	a'er'han'ge'er'si'ke	0
阿尔赫西拉斯	a'er'he'xi'la'si	0
阿尔及尔	a'er'ji'er	0
阿芬默斯	a'fen'mo'si	0
阿加迪尔	a'jia'di'er	0
阿加尼亚	a'jia'ni'ya	0
阿卡胡特拉	a'ka'hu'te'la	0
阿卡普尔科	a'ka'pu'er'ke	0
阿克拉	a'ke'la	0
阿里卡	a'li'ka	0
阿姆斯特丹	a'mu'si'te'dan	0
阿帕帕	a'pa'pa	0
阿皮亚	a'pi'ya	0
阿萨布	a'sa'bu	0
阿什杜德	a'shen'du'de	0
安科纳	an'ke'na	0
安纳巴	an'na'ba	0
安全工程	an'quan'gong'cheng	0
安特卫普	an'te'wei'pu	0
安托法加斯塔	an'tuo'fa'jia'si'ta	0
奥尔堡	ao'er'bao	0
奥尔胡斯	ao'er'hu'si	0
奥克兰	ao'ke'lan	0
奥勒松	ao'le'song	0
巴尔	ba'er	0
巴尔博亚	ba'er'bo'ya	0
巴尔的摩	ba'er'de'mo	0
巴兰基利亚	ba'lan'ji'li'ya	0
巴林	ba'lin	0
巴纳纳	ba'na'na	0
巴士拉	ba'shi'la	0
巴塔	ba'ta	0
巴特沃斯	ba'te'wo'si	0
班加西	ban'jia'xi	0
班轮公会	ban'lun'gong'hui	0
班珠尔	ban'zhu'er	0
保函	bao'han	0
包运租船	bao'yun'zu'chuan	0
保证金	bao'zheng'jin	0
贝尔法斯特	bei'er'fa'si'te	0
卑尔根	bei'er'gen	0
贝尔莫潘	bei'er'mo'pan	0
贝拉	bei'la	0
贝鲁特	bei'lu'te	0
贝伦	bei'lun	0
被拖方	bei'tuo'fang	0
被拖物体	bei'tuo'wu'ti	0
本人	ben'ren	0
毕尔巴鄂	bi'er'ba'e	0
比塞大	bi'sai'da	0
比绍	bi'shao	0
伯贝拉	bo'bei'la	0
驳船	bo'chuan	0
波尔的姆格式	bo'er'de'mu'ge'shi	0
波尔多	bo'er'duo	0
伯尔尼	bo'er'ni	0
伯肯黑德	bo'ken'hei'de	0
伯利兹	bo'li'zi	0
波罗的海国际海事协会	bo'luo'di'hai'guo'ji'hai'shi'xie'hui	0
博马	bo'ma	0
伯尼	bo'ni	0
勃生	bo'sheng	0
波士顿	bo'shi'dun	0
布埃纳文图拉	bu'ai'na'wen'tu'la	0
布尔加斯	bu'er'jia'si	0
不记名提单	bu'ji'ming'ti'dan	0
不可抗力	bu'ke'kang'li	0
不莱梅	bu'lai'mei	0
不来梅哈芬	bu'lai'mei'ha'fen	0
布兰卡港	bu'lan'ka'gang	0
布雷斯特	bu'lei'si'te	0
布里奇顿	bu'li'qi'dun	0
布里斯班	bu'li'si'ban	0
布里斯托尔	bu'li'si'tuo'er	0
布林迪西	bu'lin'di'xi	0
不清洁提单	bu'qing'jie'ti'dan	0
布什尔	bu'shi'er	0
布宜诺斯艾利斯	bu'yi'nuo'si'ai'li'si	0
财务管理	cai'wu'guan'li	0
舱单	cang'dan	0
舱底货	cang'di'huo	0
舱图	cang'tu	0
测控技术与仪器	ce'kong'ji'shu'yu'yi'qi	0
铲车	chan'che	0
铲车臂	chan'che'bi	0
偿付能力	chang'fu'neng'li	0
常数	chang'shu	0
长途中继线	chang'tu'zhong'ji'xian	0
场站收据	chang'zhan'shou'ju	0
承包型拖航合同	cheng'bao'xing'tuo'hang'he'tong	0
承拖方	cheng'tuo'fang	0
承运人	cheng'yun'ren	0
程租	cheng'zu	0
重迭螺桨	chong'die'luo'jiang	0
除外期间	chu'wai'qi'jian	0
船舶抵押贷款	chuan'bo'di'ya'dai'kuan	0
船舶电子电气	chuan'bo'dian'zi'dian'qi	0
船舶工程技术	chuan'bo'gong'cheng'ji'shu	0
船舶与海洋工程	chuan'bo'yu'hai'yang'gong'cheng	0
船舶总长度	chuan'bo'zong'chang'du	0
船宽	chuan'kuan	0
船艏	chuan'shou	0
传送带	chuan'song'dai	0
船体	chuan'ti	0
船艉	chuan'wei	0
船员不轨	chuan'yuan'bu'gui	0
大副	da'fu	0
大副收据	da'fu'shou'ju	0
大管轮	da'guan'lun	0
大连海事大学	da'lian'hai'shi'da'xue	0
代理行提单	dai'li'hang'ti'dan	0
代理人委托人	dai'li'ren'wei'tuo'ren	0
担保公司	dan'bao'gong'si	0
单螺桨船	dan'luo'jiang'chuan	0
单头锅炉	dan'tou'guo'lu	0
倒签提单	dao'qian'ti'dan	0
抵押品	di'ya'pin	0
垫底货	dian'di'huo	0
电气工程与智能控制中荷	dian'qi'gong'cheng'yu'zhi'neng'kong'zhi'zhong'he	0
电气自动化技术	dian'qi'zi'dong'hua'ji'shu	0
电子商务	dian'zi'shang'wu	0
电子信息工程	dian'zi'xin'xi'gong'cheng	0
吊杆	diao'gan	0
定期租船	ding'qi'zu'chuan	0
顶推	ding'tui	0
渡轮	du'lun	0
多式联运提单	duo'shi'lian'yun'ti'dan	0
二副	er'fu	0
二管轮	er'guan'lun	0
发货人	fa'huo'ren	0
法学海商法	fa'xue'hai'shang'fa	0
方便旗船	fang'bian'qi'chuan	0
分节锅炉	fen'jie'guo'lu	0
分摊价值	fen'tan'jia'zhi	0
浮标	fu'biao	0
浮吊	fu'diao	0
负连带责任	fu'lian'dai'ze'ren	0
釜山	fu'shan	0
浮坞	fu'wu	0
俯仰水泵	fu'yang'shui'beng	0
港口惯例	gang'kou'guan'li	0
港口航道与海岸工程	gang'kou'hang'dao'yu'hai'an'gong'cheng	0
高潮水位	gao'chao'shui'wei	0
高高潮	gao'gao'chao	0
工商管理	gong'shang'guan'li	0
工业设计	gong'ye'she'ji	0
惯常协助	guan'chang'xie'zhu	0
关单	guan'dan	0
管理科学	guan'li'ke'xue	0
滚装船	gun'zhuang'chuan	0
国际海上拖航	guo'ji'hai'shang'tuo'hang	0
国际海事委员会	guo'ji'hai'shi'wei'yuan'hui	0
国际海运危险货物规则	guo'ji'hai'yun'wei'xian'huo'wu'gui'ze	0
国际航运业务管理	guo'ji'hang'yun'ye'wu'guan'li	0
海关担保	hai'guan'dan'bao	0
海事局	hai'shi'ju	0
海牙规则	hai'ya'gui'ze	0
海运单	hai'yun'dan	0
汉堡规则	han'bao'gui'ze	0
航次期租	hang'ci'qi'zu	0
航次租船	hang'ci'zu'chuan	0
航道	hang'dao	0
航海技术	hang'hai'ji'shu	0
航运管理	hang'yun'guan'li	0
互有过失碰撞条款	hu'you'guo'shi'peng'zhuang'tiao'kuan	0
回程运费	hui'cheng'yun'fei	0
霍梅尼港	huo'mei'ni'gang	0
货物处置	huo'wu'chu'zhi	0
货物积载因数	huo'wu'ji'zai'yin'shu	0
货物污染	huo'wu'wu'ran	0
货运代理	huo'yun'dai'li	0
货主箱	huo'zhu'xiang	0
机电一体化技术	ji'dian'yi'ti'hua'ji'shu	0
记名提单	ji'ming'ti'dan	0
即使使用	ji'shi'shi'yong	0
计算机应用技术	ji'suan'ji'ying'yong'ji'shu	0
机械电子工程中荷	ji'xie'dian'zi'gong'cheng'zhong'he	0
积载图	ji'zai'tu	0
集装箱驳船	ji'zhuang'xiang'bo'chuan	0
集装箱船	ji'zhuang'xiang'chuan	0
集装箱堆场	ji'zhuang'xiang'dui'chang	0
集装箱化	ji'zhuang'xiang'hua	0
集装箱货运站	ji'zhuang'xiang'huo'yun'zhan	0
集装箱运输管理	ji'zhuang'xiang'yun'shu'guan'li	0
集装箱租赁	ji'zhuang'xiang'zu'lin	0
甲板货提单	jia'ban'huo'ti'dan	0
交通工程	jiao'tong'gong'cheng	0
交通运输	jiao'tong'yun'shu	0
结关	jie'guan	0
解约日	jie'yue'ri	0
金康合同	jin'kang'he'tong	0
近洋航区	jin'yang'hang'qu	0
净吨	jing'dun	0
经纪人佣金	jing'ji'ren'yong'jin	0
经济学类大类招生	jing'ji'xue'lei'da'lei'zhao'sheng	0
可变速泵	ke'bian'su'beng	0
克林吊	ke'lin'diao	0
可视警报	ke'shi'jing'bao	0
空载行驶	kong'zai'xing'shi	0
会计	kuai'ji	0
亏舱	kui'cang	0
亏舱费	kui'cang'fei	0
缆工	lan'gong	0
老轨	lao'gui	0
立式锅炉	li'shi'guo'lu	0
联邦海事委员会	lian'bang'hai'shi'wei'yuan'hui	0
联合国海上货物运输公约	lian'he'guo'hai'shang'huo'wu'yun'shu'gong'yue	0
连续航程	lian'xu'hang'cheng	0
联营	lian'ying	0
两进二	liang'jin'er	0
两进一	liang'jin'yi	0
零担	ling'dan	0
零担货物	ling'dan'huo'wu	0
轮机工程	lun'ji'gong'cheng	0
轮机长	lun'ji'zhang	0
螺桨护架	luo'jiang'hu'jia	0
螺桨马力	luo'jiang'ma'li	0
螺旋螺桨	luo'xuan'luo'jiang	0
旅游管理	lv'you'guan'li	0
马辰	ma'chen	0
曼谷	man'gu	0
美国船级社	mei'guo'chuan'ji'she	0
美国联邦政府行政法规汇编	mei'guo'lian'bang'zheng'fu'xing'zheng'fa'gui'hui'bian	0
美国纽约土产品交易定期租船合同	mei'guo'niu'yue'tu'chan'pin'jiao'yi'ding'qi'zu'chuan'he'tong	0
孟买	meng'mai	0
迷你大陆桥	mi'ni'da'lu'qiao	0
免责条款	mian'ze'tiao'kuan	0
欧式托盘	ou'shi'tuo'pan	0
拼箱	pin'xiang	0
拼箱货	pin'xiang'huo	0
起拖	qi'tuo	0
起运货量	qi'yun'huo'liang	0
期租	qi'zu	0
洽订舱位	qia'ding'cang'wei	0
清关	qing'guan	0
清洁提单	qing'jie'ti'dan	0
燃料涨价条款	ran'liao'zhang'jia'tiao'kuan	0
日常营运成本	ri'chang'ying'yun'cheng'ben	0
日租程拖带	ri'zu'cheng'tuo'dai	0
三副	san'fu	0
三管轮	san'guan'lun	0
散货	san'huo	0
散货船	san'huo'chuan	0
散货集装箱	san'huo'ji'zhuang'xiang	0
三螺桨船	san'luo'jiang'chuan	0
散装货	san'zhuang'huo	0
上海海事大学	shang'hai'hai'shi'da'xue	0
适拖	shi'tuo	0
适拖保证	shi'tuo'bao'zheng	0
适拖证书	shi'tuo'zheng'shu	0
收货待运提单	shou'huo'dai'yun'ti'dan	0
收货人	shou'huo'ren	0
受载期	shou'zai'qi	0
数学与应用数学	shu'xue'yu'ying'yong'shu'xue	0
双螺桨船	shuang'luo'jiang'chuan	0
双叶螺桨	shuang'ye'luo'jiang	0
水管锅炉	shui'guan'guo'lu	0
四边开槽托盘	si'bian'kai'cao'tuo'pan	0
斯里巴加湾	si'li'ba'jia'wan	0
四十英尺集装箱换算单位	si'shi'ying'chi'ji'zhuang'xiang'huan'suan'dan'wei	0
诉讼时间延长	su'song'shi'jian'yan'chang	0
损害修理条款	sun'hai'xiu'li'tiao'kuan	0
特别提款权	te'bie'ti'kuan'quan	0
提单	ti'dan	0
提单持有人	ti'dan'chi'you'ren	0
通信工程	tong'xin'gong'cheng	0
统一杂货租船合同	tong'yi'za'huo'zu'chuan'he'tong	0
桶抓	tong'zhua	0
土产格式	tu'chan'ge'shi	0
拖驳船队	tuo'bo'chuan'dui	0
拖航	tuo'hang	0
拖航合同	tuo'hang'he'tong	0
拖航责任	tuo'hang'ze'ren	0
托运	tuo'yun	0
托运单	tuo'yun'dan	0
外侧螺桨	wai'ce'luo'jiang	0
完整申报	wan'zheng'shen'bao	0
网络工程	wang'luo'gong'cheng	0
卫盛顿泵	wei'sheng'dun'beng	0
卫生水泵	wei'sheng'shui'beng	0
维斯比规则	wei'si'bi'gui'ze	0
委托书	wei'tuo'shu	0
违约赔偿金	wei'yue'pei'chang'jin	0
无船承运人	wu'chuan'cheng'yun'ren	0
乌拉湾	wu'la'wan	0
无限航区	wu'xian'hang'qu	0
细管锅炉	xi'guan'guo'lu	0
暹罗湾	xian'luo'wan	0
小陆桥	xiao'lu'qiao	0
嚣音螺桨	xiao'yin'luo'jiang	0
雅典	ya'dian	0
亚丁	ya'ding	0
亚喀巴	ya'ka'ba	0
亚历山大	ya'li'shan'da	0
亚特兰大	ya'te'lan'da	0
延长诉讼时间	yan'chang'su'song'shi'jian	0
延长租期	yan'chang'zu'qi	0
烟管锅炉	yan'guan'guo'lu	0
沿海航区	yan'hai'hang'qu	0
一旦滞期永远滞期	yi'dan'zhi'qi'yong'yuan'zhi'qi	0
一级船	yi'ji'chuan	0
艺术设计	yi'shu'she'ji	0
溢卸	yi'xie	0
异议	yi'yi	0
已装船提单	yi'zhuang'chuan'ti'dan	0
应用电子技术	ying'yong'dian'zi'ji'shu	0
拥挤	yong'ji	0
拥挤费	yong'ji'fei	0
有问题的货物	you'wen'ti'de'huo'wu	0
右旋螺桨	you'xuan'luo'jiang	0
预计到达时间	yu'ji'dao'da'shi'jian	0
预计航行时间	yu'ji'hang'xing'shi'jian	0
预计离港时间	yu'ji'li'gang'shi'jian	0
预计完成时间	yu'ji'wan'cheng'shi'jian	0
预计准备就绪时间	yu'ji'zhun'bei'jiu'xu'shi'jian	0
预借提单	yu'jie'ti'dan	0
余热锅炉	yu're'guo'lu	0
圆型船	yuan'xing'chuan	0
载货	zai'huo	0
载货清单	zai'huo'qing'dan	0
载重吨	zai'zhong'dun	0
罩筒螺桨	zhao'tong'luo'jiang	0
蒸气锅炉	zheng'qi'guo'lu	0
整体螺桨	zheng'ti'luo'jiang	0
整箱货	zheng'xiang'huo	0
直达提单	zhi'da'ti'dan	0
滞期	zhi'qi	0
滞期费	zhi'qi'fei	0
指示提单	zhi'shi'ti'dan	0
支线船	zhi'xian'chuan	0
支线运输服务	zhi'xian'yun'shu'fu'wu	0
重量货	zhong'liang'huo	0
中租期租合同	zhong'zu'qi'zu'he'tong	0
轴驱动泵	zhou'qu'dong'beng	0
煮饭汽锅	zhu'fan'qi'guo	0
转船提单	zhuan'chuan'ti'dan	0
转换提单	zhuan'huan'ti'dan	0
装卸两港	zhuang'xie'liang'gang	0
装卸欺瞒	zhuang'xie'qi'man	0
装卸事实记录	zhuang'xie'shi'shi'ji'lu	0
自动化	zi'dong'hua	0
总吨	zong'dun	0
租期延长	zu'qi'yan'chang	0
最大宽度	zui'da'kuan'du	0
最低运费提单	zui'di'yun'fei'ti'dan	0
