巴豆汁	ba'dou'zhi	0
八仙汤	ba'xian'tang	0
百合散	bai'he'san	0
白虎夺命丹	bai'hu'duo'ming'dan	0
百花腹蛇膏	bai'hua'fu'she'gao	0
百花消魂散	bai'hua'xiao'hun'san	0
百涎丸	bai'xian'wan	0
白云熊胆丸	bai'yun'xiong'dan'wan	0
豹胎易筋丸	bao'tai'yi'jin'wan	0
悲酥清风	bei'su'qing'feng	0
冰魄银针解药	bing'po'yin'zhen'jie'yao	0
参阳玉酒	can'yang'yu'jiu	0
蟾蜍毒砂	chan'chu'du'sha	0
赤蝎粉	chi'xie'fen	0
磁蛋	ci'dan	0
毒钉解药	du'ding'jie'yao	0
毒蒺藜解药	du'ji'li'jie'yao	0
毒箭解药	du'jian'jie'yao	0
毒菱解药	du'ling'jie'yao	0
毒雾	du'wu	0
毒盐	du'yan	0
毒针环解药	du'zhen'huan'jie'yao	0
毒针解药	du'zhen'jie'yao	0
断肠散	duan'chang'san	0
断筋腐骨丸	duan'jin'fu'gu'wan	0
腐骨穿心膏	fu'gu'chuan'xin'gao	0
茯苓首乌丸	fu'ling'shou'wu'wan	0
茯苓燕窝汤	fu'ling'yan'wo'tang	0
寒玉冰蟾膏	han'yu'bing'chan'gao	0
黑玉断续膏	hei'yu'duan'xu'gao	0
虎筋虎骨膏	hu'jin'hu'gu'gao	0
花斑毒蝎解药	hua'ban'du'xie'jie'yao	0
化石丹	hua'shi'dan	0
化尸粉	hua'shi'fen	0
化血腐骨粉	hua'xue'fu'gu'fen	0
回阳五龙膏	hui'yang'wu'long'gao	0
九花玉露丸	jiu'hua'yu'lu'wan	0
九九丸	jiu'jiu'wan	0
鸠砒丸	jiu'pi'wan	0
九阴白骨爪解药	jiu'yin'bai'gu'zhao'jie'yao	0
九转回春汤	jiu'zhuan'hui'chun'tang	0
九转灵宝丸	jiu'zhuan'ling'bao'wan	0
九转熊蛇丸	jiu'zhuan'xiong'she'wan	0
绝门毒针解药	jue'men'du'zhen'jie'yao	0
绝情丹	jue'qing'dan	0
腊八粥	la'ba'zhou	0
莲蓉豆泥蜜糖珍珠糊	lian'rong'dou'ni'mi'tang'zhen'zhu'hu	0
烈火丹	lie'huo'dan	0
六阳正气丹	liu'yang'zheng'qi'dan	0
绿波香露刀解药	lv'bo'xiang'lu'dao'jie'yao	0
闷香	men'xiang	0
蒙汗药	meng'han'yao	0
迷春酒	mi'chun'jiu	0
牛黄犀角散	niu'huang'xi'jiao'san	0
牛黄血竭丹	niu'huang'xue'jie'dan	0
牛毛针解药	niu'mao'zhen'jie'yao	0
砒霜	pi'shuang	0
砒鸩丸	pi'zhen'wan	0
七虫七花膏	qi'chong'qi'hua'gao	0
七虫软筋散	qi'chong'ruan'jin'san	0
七心海棠解药	qi'xin'hai'tang'jie'yao	0
千里销魂香	qian'li'xiao'hun'xiang	0
清毒复明膏药	qing'du'fu'ming'gao'yao	0
青陀罗花解药	qing'tuo'luo'hua'jie'yao	0
去腐消肌膏	qu'fu'xiao'ji'gao	0
人参养荣丸	ren'shen'yang'rong'wan	0
三虫三草毒	san'chong'san'cao'du	0
三黄宝腊丸	san'huang'bao'la'wan	0
三尸脑神丹	san'shi'nao'shen'dan	0
三蜈五蟆烟	san'wu'wu'ma'yan	0
三笑逍遥散	san'xiao'xiao'yao'san	0
桑贝丸	sang'bei'wan	0
闪电貂解药	shan'dian'diao'jie'yao	0
少阳丹	shao'yang'dan	0
蛇药	she'yao	0
参汤	shen'tang	0
生生造化丹	sheng'sheng'zao'hua'dan	0
生死符解药	sheng'si'fu'jie'yao	0
升天丸	sheng'tian'wan	0
十香迷魂散	shi'xiang'mi'hun'san	0
十香软筋散	shi'xiang'ruan'jin'san	0
醍醐香解药	ti'hu'xiang'jie'yao	0
田七鲨胆散	tian'qi'sha'dan'san	0
天王保命丹	tian'wang'bao'ming'dan	0
天香断续胶	tian'xiang'duan'xu'jiao	0
天心解毒丹	tian'xin'jie'du'dan	0
铁蝎子解药	tie'xie'zi'jie'yao	0
通犀地龙丸	tong'xi'di'long'wan	0
五宝花蜜酒	wu'bao'hua'mi'jiu	0
无常丹	wu'chang'dan	0
五毒神掌解药	wu'du'shen'zhang'jie'yao	0
五毒失心散	wu'du'shi'xin'san	0
五色彩蝎解药	wu'se'cai'xie'jie'yao	0
无形粉	wu'xing'fen	0
逍遥散	xiao'yao'san	0
雄黄蛇药	xiong'huang'she'yao	0
雄黄药酒	xiong'huang'yao'jiu	0
雄黄珠	xiong'huang'zhu	0
续命八丸	xu'ming'ba'wan	0
玄冰碧火酒	xuan'bing'bi'huo'jiu	0
雪参丸	xue'shen'wan	0
雪参玉蟾丸	xue'shen'yu'chan'wan	0
胭脂膏	yan'zhi'gao	0
药饼	yao'bing	0
阴阳和合散	yin'yang'he'he'san	0
玉洞黑石丹	yu'dong'hei'shi'dan	0
玉蜂浆	yu'feng'jiang	0
玉蜂针解药	yu'feng'zhen'jie'yao	0
玉肌丸	yu'ji'wan	0
玉灵散	yu'ling'san	0
玉龙苏合散	yu'long'su'he'san	0
玉真散	yu'zhen'san	0
杖头怪蛇解药	zhang'tou'guai'she'jie'yao	0
镇心理气丸	zhen'xin'li'qi'wan	0
止血生肌丸	zhi'xue'sheng'ji'wan	0
追命毒龙锥解药	zhui'ming'du'long'zhui'jie'yao	0
子午见骨茶	zi'wu'jian'gu'cha	0
醉仙蜜	zui'xian'mi	0
