产品经济寿命期	chan'pin'jing'ji'shou'ming'qi	0
产品自然寿命期	chan'pin'zi'ran'shou'ming'qi	0
偿债基金系数	chang'zhai'ji'jin'xi'shu	0
厂址条件评估	chang'zhi'tiao'jian'ping'gu	0
成本效果分析	cheng'ben'xiao'guo'fen'xi	0
出口替代物	chu'kou'ti'dai'wu	0
非贸易货物	fei'mao'yi'huo'wu	0
复利现值系数	fu'li'xian'zhi'xi'shu	0
复利终值系数	fu'li'zhong'zhi'xi'shu	0
国民收入现值	guo'min'shou'ru'xian'zhi	0
互补产品	hu'bu'chan'pin	0
基准收益率	ji'zhun'shou'yi'lv	0
价格换算系数	jia'ge'huan'suan'xi'shu	0
进口替代物	jin'kou'ti'dai'wu	0
贸易货物	mao'yi'huo'wu	0
年金复利现值系数	nian'jin'fu'li'xian'zhi'xi'shu	0
年金复利终值系数	nian'jin'fu'li'zhong'zhi'xi'shu	0
评估价格调整率	ping'gu'jia'ge'tiao'zheng'lv	0
评估用财务价格	ping'gu'yong'cai'wu'jia'ge	0
评估用经济价格	ping'gu'yong'jing'ji'jia'ge	0
市场均衡价格	shi'chang'jun'heng'jia'ge	0
替代产品	ti'dai'chan'pin	0
投资项目	tou'zi'xiang'mu	0
土地的影子价格	tu'di'de'ying'zi'jia'ge	0
相关产品	xiang'guan'chan'pin	0
项目财务换汇成本	xiang'mu'cai'wu'huan'hui'cheng'ben	0
项目财务节汇成本	xiang'mu'cai'wu'jie'hui'cheng'ben	0
项目财务外汇净现值	xiang'mu'cai'wu'wai'hui'jing'xian'zhi	0
项目成本	xiang'mu'cheng'ben	0
项目成本效益分析	xiang'mu'cheng'ben'xiao'yi'fen'xi	0
项目的财务成本	xiang'mu'de'cai'wu'cheng'ben	0
项目的财务效益	xiang'mu'de'cai'wu'xiao'yi	0
项目的财务效益评估	xiang'mu'de'cai'wu'xiao'yi'ping'gu	0
项目的财务预测	xiang'mu'de'cai'wu'yu'ce	0
项目的产品成本预测	xiang'mu'de'chan'pin'cheng'ben'yu'ce	0
项目的成本调整	xiang'mu'de'cheng'ben'tiao'zheng	0
项目的地质条件评估	xiang'mu'de'di'zhi'tiao'jian'ping'gu	0
项目的动态经济效益分析	xiang'mu'de'dong'tai'jing'ji'xiao'yi'fen'xi	0
项目的分配效果	xiang'mu'de'fen'pei'xiao'guo	0
项目的国民经济效益评估	xiang'mu'de'guo'min'jing'ji'xiao'yi'ping'gu	0
项目的国民收入综合能耗	xiang'mu'de'guo'min'shou'ru'zong'he'neng'hao	0
项目的环保评价	xiang'mu'de'huan'bao'ping'jia	0
项目的环境保护措施评估	xiang'mu'de'huan'jing'bao'hu'cuo'shi'ping'gu	0
项目的技术方案评估	xiang'mu'de'ji'shu'fang'an'ping'gu	0
项目的价格调整	xiang'mu'de'jia'ge'tiao'zheng	0
项目的间接成本	xiang'mu'de'jian'jie'cheng'ben	0
项目的间接效益	xiang'mu'de'jian'jie'xiao'yi	0
项目的建设实施条件评估	xiang'mu'de'jian'she'shi'shi'tiao'jian'ping'gu	0
项目的交通运输条件评估	xiang'mu'de'jiao'tong'yun'shu'tiao'jian'ping'gu	0
项目的借款偿还期	xiang'mu'de'jie'kuan'chang'huan'qi	0
项目的经济成本	xiang'mu'de'jing'ji'cheng'ben	0
项目的经济换汇成本	xiang'mu'de'jing'ji'huan'hui'cheng'ben	0
项目的经济净现值	xiang'mu'de'jing'ji'jing'xian'zhi	0
项目的经济净现值率	xiang'mu'de'jing'ji'jing'xian'zhi'lv	0
项目的经济内部收益率	xiang'mu'de'jing'ji'nei'bu'shou'yi'lv	0
项目的经济外汇净现值	xiang'mu'de'jing'ji'wai'hui'jing'xian'zhi	0
项目的经济效益	xiang'mu'de'jing'ji'xiao'yi	0
项目的静态经济效益分析	xiang'mu'de'jing'tai'jing'ji'xiao'yi'fen'xi	0
项目的净现值收益率	xiang'mu'de'jing'xian'zhi'shou'yi'lv	0
项目的就业效果	xiang'mu'de'jiu'ye'xiao'guo	0
项目的利润预测	xiang'mu'de'li'run'yu'ce	0
项目的燃料动力供应条件评估	xiang'mu'de'ran'liao'dong'li'gong'ying'tiao'jian'ping'gu	0
项目的设备选型方案评估	xiang'mu'de'she'bei'xuan'xing'fang'an'ping'gu	0
项目的社会成本	xiang'mu'de'she'hui'cheng'ben	0
项目的社会效益	xiang'mu'de'she'hui'xiao'yi	0
项目的生产工艺方案评估	xiang'mu'de'sheng'chan'gong'yi'fang'an'ping'gu	0
项目的生产规模方案评估	xiang'mu'de'sheng'chan'gui'mo'fang'an'ping'gu	0
项目的生产建设条件评估	xiang'mu'de'sheng'chan'jian'she'tiao'jian'ping'gu	0
项目的市场分析	xiang'mu'de'shi'chang'fen'xi	0
项目的收益净现值	xiang'mu'de'shou'yi'jing'xian'zhi	0
项目的投资创汇率	xiang'mu'de'tou'zi'chuang'hui'lv	0
项目的投资估算	xiang'mu'de'tou'zi'gu'suan	0
项目的投资回收期	xiang'mu'de'tou'zi'hui'shou'qi	0
项目的投资节汇率	xiang'mu'de'tou'zi'jie'hui'lv	0
项目的投资净效益率	xiang'mu'de'tou'zi'jing'xiao'yi'lv	0
项目的投资利润率	xiang'mu'de'tou'zi'li'run'lv	0
项目的投资利税率	xiang'mu'de'tou'zi'li'shui'lv	0
项目的投资新增国民收入	xiang'mu'de'tou'zi'xin'zeng'guo'min'shou'ru	0
项目的外汇遣返率	xiang'mu'de'wai'hui'qian'fan'lv	0
项目的无形成本	xiang'mu'de'wu'xing'cheng'ben	0
项目的无形效益	xiang'mu'de'wu'xing'xiao'yi	0
项目的销售收入预测	xiang'mu'de'xiao'shou'shou'ru'yu'ce	0
项目的效益调整	xiang'mu'de'xiao'yi'tiao'zheng	0
项目的有形成本	xiang'mu'de'you'xing'cheng'ben	0
项目的有形效益	xiang'mu'de'you'xing'xiao'yi	0
项目的预期收益率	xiang'mu'de'yu'qi'shou'yi'lv	0
项目的原材料供应条件评估	xiang'mu'de'yuan'cai'liao'gong'ying'tiao'jian'ping'gu	0
项目的直接成本	xiang'mu'de'zhi'jie'cheng'ben	0
项目的直接效益	xiang'mu'de'zhi'jie'xiao'yi	0
项目的转移性支付	xiang'mu'de'zhuan'yi'xing'zhi'fu	0
项目的资源条件评估	xiang'mu'de'zi'yuan'tiao'jian'ping'gu	0
项目的总结评价	xiang'mu'de'zong'jie'ping'jia	0
项目的总平面规划评估	xiang'mu'de'zong'ping'mian'gui'hua'ping'gu	0
项目技术寿命期	xiang'mu'ji'shu'shou'ming'qi	0
项目经济寿命期	xiang'mu'jing'ji'shou'ming'qi	0
项目评估	xiang'mu'ping'gu	0
项目评估报告	xiang'mu'ping'gu'bao'gao	0
项目前后对比法	xiang'mu'qian'hou'dui'bi'fa	0
项目寿命期	xiang'mu'shou'ming'qi	0
项目谈判	xiang'mu'tan'pan	0
项目效益	xiang'mu'xiao'yi	0
项目选定	xiang'mu'xuan'ding	0
项目有无对比法	xiang'mu'you'wu'dui'bi'fa	0
项目执行	xiang'mu'zhi'xing	0
项目周期	xiang'mu'zhou'qi	0
项目准备	xiang'mu'zhun'bei	0
消费者愿付价格	xiao'fei'zhe'yuan'fu'jia'ge	0
影子利率	ying'zi'li'lv	0
资本的机会成本	zi'ben'de'ji'hui'cheng'ben	0
资金回收系数	zi'jin'hui'shou'xi'shu	0
