阿蒂斯吉尔摩尔	a'di'si'ji'er'mo'er	0
埃尔文罗伯特森	ai'er'wen'luo'bo'te'sen	0
埃弗里约翰逊	ai'fu'li'yue'han'xun	0
艾米尤杜卡	ai'mi'you'du'ka	0
埃托雷梅西纳	ai'tuo'lei'mei'xi'na	0
奥斯汀马刺	ao'si'ting'ma'ci	0
邦纳	bang'na	0
保罗加索尔	bao'luo'jia'suo'er	0
贝基哈蒙	bei'ji'ha'meng	0
波波维奇	bo'bo'wei'qi	0
布福德	bu'fu'de	0
布林福布斯	bu'lin'fu'bu'si	0
布鲁斯鲍文	bu'lu'si'bao'wen	0
查德福西尔	cha'de'fu'xi'er	0
肠胃炎	chang'wei'yan	0
达拉斯灌木丛队	da'la'si'guan'mu'cong'dui	0
大卫李	da'wei'li	0
大卫罗宾逊	da'wei'luo'bin'xun	0
戴维斯贝尔坦斯	dai'wei'si'bei'er'tan'si	0
丹尼格林	dan'ni'ge'lin	0
德维恩戴德蒙	de'wei'en'dai'de'meng	0
德章泰默雷	de'zhang'tai'mo'lei	0
邓肯	deng'ken	0
蒂姆邓肯	di'mu'deng'ken	0
格雷格波波维奇	ge'lei'ge'bo'bo'wei'qi	0
霍尔特	huo'er'te	0
吉诺比利	ji'nuo'bi'li	0
奇数年冠军	ji'shu'nian'guan'jun	0
奇数年王朝	ji'shu'nian'wang'chao	0
卡哇伊莱昂纳德	ka'wa'yi'lai'ang'na'de	0
凯尔安德森	kai'er'an'de'sen	0
拉里布朗	la'li'bu'lang	0
拉里肯农	la'li'ken'nong	0
拉马库斯阿尔德里奇	la'ma'ku'si'a'er'de'li'qi	0
莱昂纳德	lai'ang'na'de	0
里奇琼斯	li'qi'qiong'si	0
罗宾逊	luo'bin'xun	0
马刺	ma'ci	0
马努吉诺比利	ma'nu'ji'nuo'bi'li	0
马特邦纳	ma'te'bang'na	0
尼古拉斯拉普罗维托拉	ni'gu'la'si'la'pu'luo'wei'tuo'la	0
帕蒂米尔斯	pa'di'mi'er'si	0
帕克	pa'ke	0
皮特霍尔特	pi'te'huo'er'te	0
奇普英格兰德	qi'pu'ying'ge'lan'de	0
乔纳森西蒙斯	qiao'na'sen'xi'meng'si	0
乔治格文	qiao'zhi'ge'wen	0
圣安东尼奥	sheng'an'dong'ni'ao	0
圣安东尼奥马刺	sheng'an'dong'ni'ao'ma'ci	0
圣安东尼奥银星	sheng'an'dong'ni'ao'yin'xing	0
斯文内特尔	si'wen'nei'te'er	0
臀部肌肉紧张	tun'bu'ji'rou'jin'zhang	0
托尼帕克	tuo'ni'pa'ke	0
肖恩埃利奥特	xiao'en'ai'li'ao'te	0
小野狼	xiao'ye'lang	0
约翰尼摩尔	yue'han'ni'mo'er	0
詹姆斯塞拉斯	zhan'mu'si'sai'la'si	0
朱莉安娜霍恩霍尔特	zhu'li'an'na'huo'en'huo'er'te	0
